,reviews_from_critics,genre,description,metascore,director,title,year,duration,country,budget,usa_gross_income,worlwide_gross_income,international_gross_income,returns,profitable
1005,120.0,"Comedy, Drama, Romance","With the aid of a wealthy erratic tippler, a dewy-eyed tramp who has fallen in love with a sightless flower girl accumulates money to be able to help her medically.",99.0,Charles Chaplin,City Lights,1931,87,USA, 1500000,19181,32609,13428,-1467391,0
2336,146.0,"Comedy, Drama, Family",The Tramp struggles to live in modern industrial society with the help of a young homeless woman.,96.0,Charles Chaplin,Modern Times,1936,87,USA, 1500000,163577,445226,281649,-1054774,0
2687,166.0,"Animation, Family, Fantasy","Exiled into the dangerous forest by her wicked stepmother, a princess is rescued by seven dwarf miners who make her part of their household.",95.0,"William Cottrell, David Hand",Snow White and the Seven Dwarfs,1937,83,USA, 1499000,184925486,184925486,0,183426486,1
3100,183.0,"Drama, History, Romance",A manipulative woman and a roguish man conduct a turbulent romance during the American Civil War and Reconstruction periods.,97.0,"Victor Fleming, George Cukor",Gone with the Wind,1939,238,USA, 3977000,200852579,402352579,201500000,398375579,1
3180,110.0,"Comedy, Drama","A naive man is appointed to fill a vacancy in the United States Senate. His plans promptly collide with political corruption, but he doesn't back down.",73.0,Frank Capra,Mr. Smith Goes to Washington,1939,129,USA, 1900000,144738,144738,0,-1755262,0
3277,160.0,"Adventure, Family, Fantasy",Dorothy Gale is swept away from a farm in Kansas to a magical land of Oz in a tornado and embarks on a quest with her new friends to see the Wizard who can help her return home to Kansas and help her friends as well.,100.0,"Victor Fleming, George Cukor",The Wizard of Oz,1939,102,USA, 2777000,24790250,26120538,1330288,23343538,1
3487,131.0,"Animation, Comedy, Family","A living puppet, with the help of a cricket as his conscience, must prove himself worthy to become a real boy.",99.0,"Norman Ferguson, T. Hee",Pinocchio,1940,88,USA, 2600000,84254167,121892045,37637878,119292045,1
3378,110.0,"Animation, Family, Fantasy",A collection of animated interpretations of great works of Western classical music.,96.0,"James Algar, Samuel Armstrong",Fantasia,1940,125,USA, 2280000,76408097,76411401,3304,74131401,1
3623,265.0,"Drama, Mystery","Following the death of publishing tycoon, Charles Foster Kane, reporters scramble to uncover the meaning of his final utterance; 'Rosebud'.",100.0,Orson Welles,Citizen Kane,1941,119,USA, 839727,1585634,1594107,8473,754380,1
3916,187.0,"Drama, Romance, War",A cynical American expatriate struggles to decide whether or not he should help his former lover and her fugitive husband escape French Morocco.,100.0,Michael Curtiz,Casablanca,1942,102,USA, 950000,4108411,4374761,266350,3424761,1
4502,119.0,"Drama, Romance, War",Three World War II veterans return home to small-town America to discover that they and their families have been irreparably changed.,92.0,William Wyler,The Best Years of Our Lives,1946,170,USA, 2100000,23650000,23656620,6620,21556620,1
6161,126.0,"Animation, Family, Fantasy","When Cinderella's cruel stepmother prevents her from attending the Royal Ball, she gets some unexpected help from the lovable mice Gus and Jaq, and from her Fairy Godmother.",85.0,"Clyde Geronimi, Wilfred Jackson",Cinderella,1950,74,USA, 2900000,93141149,95126535,1985386,92226535,1
6106,128.0,Drama,An ing√©nue insinuates herself into the lives of an established but aging stage actress and her circle of theater friends.,98.0,Joseph L. Mankiewicz,All About Eve,1950,138,USA, 1400000,63463,150438,86975,-1249562,0
7055,150.0,"Comedy, Musical, Romance",A silent film production company and cast make a difficult transition to sound.,99.0,"Stanley Donen, Gene Kelly",Singin' in the Rain,1952,103,USA, 2540800,1826108,1864182,38074,-676618,0
7368,133.0,"Animation, Adventure, Family","Wendy and her brothers are whisked away to the magical world of Neverland with the hero of their stories, Peter Pan.",76.0,"Clyde Geronimi, Wilfred Jackson",Peter Pan,1953,77,USA, 4000000,87404651,87404651,0,83404651,1
7243,116.0,"Drama, Romance, War","In Hawaii in 1941, a private is cruelly punished for not boxing on his unit's team, while his captain's wife and second-in-command are falling in love.",85.0,Fred Zinnemann,From Here to Eternity,1953,118,USA, 1650000,36416,36416,0,-1613584,0
7316,40.0,"Drama, Family","A young boy fears that he shot his older brother, who is only faking. He then runs away to Coney Island, a crowded beach area, and gets money by returning soda bottles for their deposits.",91.0,"Ray Ashley, Morris Engel",Little Fugitive,1953,80,USA, 30000,29505,162373,132868,132373,1
7560,45.0,"Drama, War","When a U.S. Naval captain shows signs of mental instability that jeopardizes the ship, the first officer relieves him of command and faces court martial for mutiny.",63.0,Edward Dmytryk,The Caine Mutiny,1954,124,USA, 2000000,21750000,21750000,0,19750000,1
7588,105.0,"Crime, Thriller",A tennis player frames his unfaithful wife for first-degree murder after she inadvertently hinders his plan to kill her.,75.0,Alfred Hitchcock,Dial M for Murder,1954,105,USA, 1400000,12562,18816,6254,-1381184,0
7738,145.0,"Mystery, Thriller",A wheelchair-bound photographer spies on his neighbors from his apartment window and becomes convinced one of them has committed murder.,100.0,Alfred Hitchcock,Rear Window,1954,112,USA, 1000000,36764313,37032034,267721,36032034,1
7781,84.0,"Drama, Musical, Romance","A film star helps a young singer and actress find fame, even as age and alcoholism send his own career on a downward spiral.",89.0,George Cukor,A Star Is Born,1954,154,USA, 5019770,4335968,4348890,12922,-670880,0
8108,157.0,Drama,"A rebellious young man with a troubled past comes to a new town, finding friends and enemies.",87.0,Nicholas Ray,Rebel Without a Cause,1955,111,USA, 1500000,199963,199963,0,-1300037,0
8005,125.0,"Animation, Adventure, Comedy",The romantic tale of a sheltered uptown Cocker Spaniel dog and a streetwise downtown Mutt.,78.0,"Clyde Geronimi, Wilfred Jackson",Lady and the Tramp,1955,76,USA, 4000000,93602326,93933394,331068,89933394,1
8329,110.0,"Drama, Western",Sprawling epic covering the life of a Texas cattle rancher and his family and associates.,84.0,George Stevens,Giant,1956,201,USA, 5400000,177909,177909,0,-5222091,0
9348,112.0,"Crime, Drama, Film-Noir","A stark, perverse story of murder, kidnapping, and police corruption in a Mexican border town.",99.0,Orson Welles,Touch of Evil,1958,95,USA, 829000,2247465,2286947,39482,1457947,1
9368,172.0,"Mystery, Romance, Thriller",A former police detective juggles wrestling with his personal demons and becoming obsessed with a hauntingly beautiful woman.,100.0,Alfred Hitchcock,Vertigo,1958,128,USA, 2479000,7705225,7779797,74572,5300797,1
9430,128.0,"Adventure, Drama, History","When a Jewish prince is betrayed and sent into slavery by a Roman friend, he regains his freedom and comes back for revenge.",90.0,William Wyler,Ben-Hur,1959,212,USA, 15000000,74422622,74427638,5016,59427638,1
9678,108.0,"Animation, Family, Fantasy","After being snubbed by the royal family, a malevolent fairy places a curse on a princess which only a prince can break, along with the help of three good fairies.",85.0,Clyde Geronimi,Sleeping Beauty,1959,75,USA, 6000000,51600000,51600000,0,45600000,1
9993,231.0,"Horror, Mystery, Thriller","A Phoenix secretary embezzles forty thousand dollars from her employer's client, goes on the run, and checks into a remote motel run by a young man under the domination of his mother.",97.0,Alfred Hitchcock,Psycho,1960,109,USA, 806947,32000000,32000000,0,31193053,1
10038,123.0,"Adventure, Biography, Drama",The slave Spartacus leads a violent revolt against the decadent Roman Republic.,87.0,Stanley Kubrick,Spartacus,1960,197,USA, 12000000,1830650,1836351,5701,-10163649,0
10050,32.0,"Adventure, Family",A Swiss family must survive being shipwrecked on a deserted island.,61.0,Ken Annakin,Swiss Family Robinson,1960,126,USA, 5000000,40356000,40356000,0,35356000,1
10351,96.0,"Animation, Adventure, Comedy","When a litter of Dalmatian puppies are abducted by the minions of Cruella de Vil, the parents must find them before she uses them for a diabolical fashion statement.",83.0,"Clyde Geronimi, Hamilton Luske",One Hundred and One Dalmatians,1961,79,USA, 4000000,144880014,216026182,71146168,212026182,1
10477,131.0,"Crime, Drama, Musical","Two youngsters from rival New York City gangs fall in love, but tensions between their respective friends build toward tragedy.",86.0,"Jerome Robbins, Robert Wise",West Side Story,1961,153,USA, 6000000,44055492,44061777,6285,38061777,1
10623,38.0,Western,"A family saga covering several decades of Westward expansion in the nineteenth century - including the Gold Rush, the Civil War, and the building of the railroads.",56.0,"John Ford, Henry Hathaway",How the West Was Won,1962,164,USA, 15000000,76729,76729,0,-14923271,0
10676,111.0,"Drama, Thriller",A former prisoner of war is brainwashed as an unwitting assassin for an international Communist conspiracy.,94.0,John Frankenheimer,The Manchurian Candidate,1962,126,USA, 2200000,2757256,2757256,0,557256,1
10806,149.0,"Crime, Drama","Atticus Finch, a lawyer in the Depression-era South, defends a black man against an undeserved rape charge, and his children against prejudice.",88.0,Robert Mulligan,To Kill a Mockingbird,1962,129,USA, 2000000,592237,599146,6909,-1400854,0
11152,69.0,"Animation, Adventure, Comedy","A poor boy named Arthur learns the power of love, kindness, knowledge and bravery with the help of a wizard called Merlin in the path to become one of the most beloved kings in English history.",61.0,Wolfgang Reitherman,The Sword in the Stone,1963,79,USA, 3000000,12000000,12000000,0,9000000,1
11014,72.0,"Action, Adventure, Comedy","A group of motorists hear about a crook's hidden stash of loot, and race against each other across the country to get to it.",59.0,Stanley Kramer,It's a Mad Mad Mad Mad World,1963,205,USA, 9400000,46332858,46332858,0,36932858,1
11447,25.0,"Drama, Romance",A black man and his school-teacher wife face discriminatory challenges in 1960s America.,87.0,Michael Roemer,Nothing But a Man,1964,95,USA, 160000,13063,13063,0,-146937,0
11434,89.0,"Drama, Family, Musical",Snobbish phonetics Professor Henry Higgins (Sir Rex Harrison) agrees to a wager that he can make flower girl Eliza Doolittle (Audrey Hepburn) presentable in high society.,95.0,George Cukor,My Fair Lady,1964,170,USA, 17000000,72560711,72661442,100731,55661442,1
11414,157.0,"Comedy, Family, Fantasy","In turn of the century London, a magical nanny employs music and adventure to help two neglected children become closer to their father.",88.0,Robert Stevenson,Mary Poppins,1964,139,USA, 6000000,102272727,103078700,805973,97078700,1
11781,58.0,"Adventure, War, Western","In 1864, due to frequent Apache raids from Mexico into the U.S., a Union officer decides to illegally cross the border and destroy the Apache, using a mixed army of Union troops, Confederate POWs, civilian mercenaries, and scouts.",62.0,Sam Peckinpah,Major Dundee,1965,123,USA, 3800000,20807,20807,0,-3779193,0
11904,131.0,"Biography, Drama, Family",A woman leaves an Austrian convent to become a governess to the children of a Naval officer widower.,63.0,Robert Wise,The Sound of Music,1965,172,USA, 8200000,159287539,159413574,126035,151213574,1
12370,91.0,Drama,"A bitter, aging couple, with the help of alcohol, use their young houseguests to fuel anguish and emotional pain towards each other over the course of a distressing night.",75.0,Mike Nichols,Who's Afraid of Virginia Woolf?,1966,131,USA, 7500000,28000000,28005068,5068,20505068,1
13125,92.0,"Comedy, Music",Producers Max Bialystock and Leo Bloom make money by producing a sure-fire flop.,96.0,Mel Brooks,The Producers,1967,88,USA, 941000,328673,375143,46470,-565857,0
12529,189.0,"Comedy, Drama, Romance",A disillusioned college graduate finds himself torn between his older lover and her daughter.,83.0,Mike Nichols,The Graduate,1967,106,USA, 3000000,104945305,104982118,36813,101982118,1
12534,67.0,"Comedy, Drama",A couple's attitudes are challenged when their daughter introduces them to her African-American fianc√©.,63.0,Stanley Kramer,Guess Who's Coming to Dinner,1967,108,USA, 4000000,56666667,56666667,0,52666667,1
12593,126.0,"Animation, Adventure, Family",Bagheera the Panther and Baloo the Bear have a difficult time trying to convince a boy to leave the jungle for human civilization.,65.0,Wolfgang Reitherman,The Jungle Book,1967,78,USA, 4000000,141843612,210310084,68466472,206310084,1
13096,68.0,Comedy,"Two friends try sharing an apartment, but their ideas of housekeeping and lifestyles are as different as night and day.",86.0,Gene Saks,The Odd Couple,1968,105,USA, 1200000,44527234,44527234,0,43327234,1
12540,41.0,"Drama, Western","When an innocent man barely survives a lynching, he returns as a lawman determined to bring the vigilantes to justice.",62.0,Ted Post,Hang 'Em High,1968,114,USA, 1600000,11000000,11000000,0,9400000,1
12872,103.0,"Action, Crime, Thriller","An all guts, no glory San Francisco cop becomes determined to find the underworld kingpin that killed the witness in his protection.",83.0,Peter Yates,Bullitt,1968,114,USA, 5500000,511350,511350,0,-4988650,0
12955,55.0,"Biography, Comedy, Drama",The life of,89.0,William Wyler,Funny Girl,1968,151,USA, 14100000,52223306,52224263,957,38124263,1
13088,231.0,Horror,"A ragtag group of Pennsylvanians barricade themselves in an old farmhouse to remain safe from a bloodthirsty, flesh-eating breed of monsters who are ravaging the East Coast of the United States.",89.0,George A. Romero,Night of the Living Dead,1968,96,USA, 114000,236452,236452,0,122452,1
13118,147.0,"Adventure, Sci-Fi","An astronaut crew crash-lands on a planet in the distant future where intelligent talking apes are the dominant species, and humans are the oppressed and enslaved.",79.0,Franklin J. Schaffner,Planet of the Apes,1968,112,USA, 5800000,32589624,32595984,6360,26795984,1
13738,118.0,"Action, Adventure, Western","An aging group of outlaws look for one last big score as the ""traditional"" American West is disappearing around them.",95.0,Sam Peckinpah,The Wild Bunch,1969,135,USA, 6244087,638641,638641,0,-5605446,0
13592,24.0,"Comedy, Drama, Musical",Two unlikely prospector partners share the same wife in a California gold rush mining town.,50.0,Joshua Logan,Paint Your Wagon,1969,164,USA, 20000000,14500000,14500000,0,-5500000,0
13545,119.0,"Drama, Western","A naive hustler travels from Texas to New York City to seek personal fortune, finding a new friend in the process.",79.0,John Schlesinger,Midnight Cowboy,1969,113,USA, 3600000,44785053,44801177,16124,41201177,1
13399,123.0,"Adventure, Drama","Through the open country and desert lands, two bikers head from L.A to New Orleans, and along the way, meet a man who bridges a counter-culture gap they are unaware of.",86.0,Dennis Hopper,Easy Rider,1969,95,USA, 360000,123276,123276,0,-236724,0
13456,32.0,"Adventure, Comedy, Musical","Matchmaker Dolly Levi travels to Yonkers to find a partner for ""half-a-millionaire"" Horace Vandergelder, convincing his niece, his niece's intended, and his two clerks to travel to New York City along the way.",51.0,Gene Kelly,"Hello, Dolly!",1969,146,USA, 25000000,400881,400881,0,-24599119,0
13337,102.0,"Biography, Crime, Drama","Wyoming, early 1900s. Butch Cassidy and The Sundance Kid are the leaders of a band of outlaws. After a train robbery goes wrong they find themselves on the run with a posse hard on their heels. Their solution - escape to Bolivia.",66.0,George Roy Hill,Butch Cassidy and the Sundance Kid,1969,110,USA, 6000000,102308889,102310639,1750,96310639,1
14008,121.0,"Comedy, Drama, War",The staff of a Korean War field hospital use humor and high jinks to keep their sanity in the face of the horror of war.,80.0,Robert Altman,MASH,1970,116,USA, 3500000,81600000,81600000,0,78100000,1
14003,50.0,"Drama, Romance",A boy and a girl from different backgrounds fall in love regardless of their upbringing - and then tragedy strikes.,84.0,Arthur Hiller,Love Story,1970,100,USA, 2200000,106397186,106397186,0,104197186,1
13993,58.0,"Adventure, Comedy, Drama","Jack Crabb, looking back from extreme old age, tells of his life being raised by Native Americans and fighting with General Custer.",63.0,Arthur Penn,Little Big Man,1970,139,USA, 15000000,31559552,31559552,0,16559552,1
14069,120.0,"Biography, Drama, War","The World War II phase of the career of the controversial American general,",91.0,Franklin J. Schaffner,Patton,1970,172,USA, 12000000,61749765,61749765,0,49749765,1
13798,64.0,"Action, Adventure, Sci-Fi",The sole survivor of an interplanetary rescue mission searches for the only survivor of the previous expedition. He discovers a planet ruled by apes and an underground city run by telepathic humans.,46.0,Ted Post,Beneath the Planet of the Apes,1970,95,USA, 3000000,18999718,18999718,0,15999718,1
13781,109.0,"Animation, Adventure, Comedy","With the help of a smooth talking tomcat, a family of Parisian felines set to inherit a fortune from their owner try to make it back home after a jealous butler kidnaps them and leaves them in the country.",66.0,Wolfgang Reitherman,The AristoCats,1970,78,USA, 4000000,35452658,35459543,6885,31459543,1
13765,71.0,"Action, Drama, Thriller","A bomber on board an airplane, an airport almost closed by snow, and various personal problems of the people involved.",42.0,"George Seaton, Henry Hathaway",Airport,1970,137,USA, 10000000,100489151,100489151,0,90489151,1
13974,43.0,"Adventure, Comedy, War",A group of U.S. soldiers sneaks across enemy lines to get their hands on a secret stash of Nazi treasure.,50.0,Brian G. Hutton,Kelly's Heroes,1970,144,USA, 4000000,5200000,5200000,0,1200000,1
14691,105.0,"Action, Crime, Thriller","During the 1970s, car delivery driver Kowalski delivers hot rods in record time but always runs into trouble with the highway cops.",61.0,Richard C. Sarafian,Vanishing Point,1971,99,USA, 1585000,12442673,12442673,0,10857673,1
14551,69.0,"Drama, Thriller","A brief fling between disc jockey Dave Garver (Clint Eastwood) and obsessed female fan Evelyn Draper (Jessica Walter) takes a frightening, and perhaps even deadly turn when another woman, Tobie Williams (Donna Mills), enters the picture.",78.0,Clint Eastwood,Play Misty for Me,1971,102,USA, 725000,10600000,10600000,0,9875000,1
14458,91.0,Drama,"In 1951, a group of high schoolers come of age in a bleak, isolated, atrophied West Texas town that is slowly dying, both culturally and economically.",93.0,Peter Bogdanovich,The Last Picture Show,1971,118,USA, 1300000,29133000,29146131,13131,27846131,1
14381,159.0,"Action, Crime, Drama",A pair of NYC cops in the Narcotics Bureau stumble onto a drug smuggling job with a French connection.,94.0,William Friedkin,The French Connection,1971,104,USA, 1800000,51700000,51700000,0,49900000,1
14363,62.0,"Action, Sci-Fi","The world is shocked by the appearance of three talking chimpanzees, who arrived mysteriously in a U.S. spacecraft. They become the toast of society, but one man believes them to be a threat to the human race.",69.0,Don Taylor,Escape from the Planet of the Apes,1971,98,USA, 2500000,12348905,12348905,0,9848905,1
14145,85.0,"Drama, Sci-Fi, Thriller","In the twenty-fifth century, a time when people have designations instead of names, a man, THX 1138, and a woman, LUH 3417, rebel against their rigidly controlled society.",75.0,George Lucas,THX 1138,1971,86,USA, 777000,2437000,2437000,0,1660000,1
14369,71.0,"Drama, Family, Musical","In prerevolutionary Russia, a Jewish peasant contends with marrying off three of his daughters while growing anti-Semitic sentiment threatens his village.",67.0,Norman Jewison,Fiddler on the Roof,1971,181,USA, 9000000,10404330,10404330,0,1404330,1
14335,136.0,"Action, Crime, Thriller","When a madman calling himself ""the Scorpio Killer"" menaces the city, tough as nails San Francisco Police Inspector ""Dirty"" Harry Callahan is assigned to track down and ferret out the crazed psychopath.",90.0,Don Siegel,Dirty Harry,1971,102,USA, 4000000,35976000,35976000,0,31976000,1
15114,84.0,"Action, Adventure, Drama",Nine people explore a cruise ship at sea in a manner that turns their whole lives upside down.,70.0,Ronald Neame,The Poseidon Adventure,1972,117,USA, 5000000,84563118,84563118,0,79563118,1
14943,241.0,"Crime, Drama",The aging patriarch of an organized crime dynasty transfers control of his clandestine empire to his reluctant son.,100.0,Francis Ford Coppola,The Godfather,1972,175,USA, 6000000,134966411,246120974,111154563,240120974,1
14849,66.0,"Action, Sci-Fi","In a futuristic world that has embraced ape slavery, Caesar, the son of the late simians Cornelius and Zira, surfaces after almost twenty years of hiding out from the authorities, and prepares for a slave revolt against humanity.",49.0,J. Lee Thompson,Conquest of the Planet of the Apes,1972,88,USA, 1700000,9043472,9043472,0,7343472,1
14910,59.0,Comedy,Seven stories are trying to answer the question: what is sex? Or maybe they are not trying.,66.0,Woody Allen,Everything You Always Wanted to Know About Sex * But Were Afraid to Ask,1972,88,USA, 2000000,18016290,18090065,73775,16090065,1
15675,82.0,"Comedy, Sci-Fi",A nerdish store owner is revived out of cryostasis into a future world to fight an oppressive government.,77.0,Woody Allen,Sleeper,1973,89,USA, 2000000,18344729,18344729,0,16344729,1
15684,133.0,"Comedy, Crime, Drama",Two grifters team up to pull off the ultimate con.,83.0,George Roy Hill,The Sting,1973,129,USA, 5500000,156000000,156000000,0,150500000,1
15554,128.0,"Crime, Drama, Thriller",A small-time hood aspires to work his way up the ranks of a local mob.,96.0,Martin Scorsese,Mean Streets,1973,112,USA, 500000,32645,41131,8486,-458869,0
15425,275.0,Horror,"When a teenage girl is possessed by a mysterious entity, her mother seeks the help of two priests to save her daughter.",81.0,William Friedkin,The Exorcist,1973,122,USA, 11000000,232906145,441306145,208400000,430306145,1
15311,52.0,"Action, Sci-Fi","Ten years after a worldwide series of ape revolutions and a brutal nuclear war among humans, Caesar must protect survivors of both species from an insidious human cult and a militant ape faction alike.",40.0,J. Lee Thompson,Battle for the Planet of the Apes,1973,93,USA, 1800000,8844595,8844595,0,7044595,1
15289,119.0,"Comedy, Drama",A couple of high school grads spend one final night cruising the strip with their buddies before they go off to college.,97.0,George Lucas,American Graffiti,1973,110,USA, 777000,115000000,115000000,0,114223000,1
14963,89.0,"Drama, Mystery, Western",A gunfighting stranger (Clint Eastwood) comes to the small settlement of Lago and is hired to bring the townsfolk together in an attempt to hold off three outlaws who are on their way.,69.0,Clint Eastwood,High Plains Drifter,1973,105,USA, 5500000,15700000,15706540,6540,10206540,1
16245,114.0,Comedy,"An American grandson of the infamous scientist, struggling to prove that his grandfather was not as insane as people believe, is invited to Transylvania, where he discovers the process that reanimates a dead body.",80.0,Mel Brooks,Young Frankenstein,1974,106,USA, 2800000,86273333,86273333,0,83473333,1
16204,87.0,"Comedy, Crime, Drama","With the help of an irreverent young sidekick, a bank robber gets his old gang back together to organize a daring new heist.",62.0,Michael Cimino,Thunderbolt and Lightfoot,1974,115,USA, 2200000,21700000,21700000,0,19500000,1
16198,243.0,Horror,Two siblings and three of their friends en route to visit their grandfather's grave in Texas end up falling victim to a family of cannibalistic psychopaths And must survive the terrors of leatherface and his family.,75.0,Tobe Hooper,The Texas Chain Saw Massacre,1974,83,USA, 300000,30859000,30859000,0,30559000,1
16178,64.0,"Crime, Drama",A woman attempts to reunite her family by helping her husband escape prison and together kidnapping their son. But things don't go as planned when they are forced to take a police hostage on the road.,65.0,Steven Spielberg,The Sugarland Express,1974,110,USA, 3000000,7500000,7504841,4841,4504841,1
16030,59.0,"Comedy, Crime, Drama","A sadistic warden asks a former pro quarterback, now serving time in his prison, to put together a team of inmates to take on (and get pummeled by) the guards.",61.0,Robert Aldrich,The Longest Yard,1974,121,USA, 2900000,43008075,43008075,0,40108075,1
15963,45.0,"Drama, Romance","A Midwesterner becomes fascinated with his nouveau riche neighbor, who obsesses over his lost love.",43.0,Jack Clayton,The Great Gatsby,1974,144,USA, 6500000,20563273,20563273,0,14063273,1
15954,172.0,"Crime, Drama","The early life and career of Vito Corleone in 1920s New York City is portrayed, while his son, Michael, expands and tightens his grip on the family crime syndicate.",90.0,Francis Ford Coppola,The Godfather: Part II,1974,202,USA, 13000000,47834595,48020957,186362,35020957,1
16209,106.0,"Action, Drama, Thriller","At the opening party of a colossal, but poorly constructed, office building, a massive fire breaks out that threatens to destroy the tower and everyone in it.",69.0,John Guillermin,The Towering Inferno,1974,165,USA, 14000000,116000000,116000000,0,102000000,1
15882,165.0,"Drama, Mystery, Thriller","A paranoid, secretive surveillance expert has a crisis of conscience when he suspects that a couple, on whom he is spying, will be murdered.",85.0,Francis Ford Coppola,The Conversation,1974,113,USA, 1600000,4420000,4432180,12180,2832180,1
15868,255.0,"Drama, Mystery, Thriller","A private detective hired to expose an adulterer finds himself caught up in a web of deceit, corruption, and murder.",92.0,Roman Polanski,Chinatown,1974,130,USA, 6000000,29200000,29225935,25935,23225935,1
15835,113.0,"Comedy, Western","In order to ruin a western town, a corrupt politician appoints a black Sheriff, who promptly becomes his most formidable adversary.",73.0,Mel Brooks,Blazing Saddles,1974,93,USA, 2600000,119601481,119601481,0,117001481,1
15822,13.0,"Adventure, Family, Romance",A stray dog saves two kidnapped children.,35.0,Joe Camp,Benji,1974,86,USA, 500000,39552000,39552000,0,39052000,1
15788,57.0,"Drama, Romance","A recently widowed woman is on the road with her precocious young son, determined to make a new life for herself as a singer.",78.0,Martin Scorsese,Alice Doesn't Live Here Anymore,1974,112,USA, 1800000,18600000,18600000,0,16800000,1
15916,72.0,"Action, Drama, Thriller","Various interconnected people struggle to survive when an earthquake of unimaginable magnitude hits Los Angeles, California.",56.0,Mark Robson,Earthquake,1974,122,USA, 7000000,79666653,79666653,0,72666653,1
16605,58.0,"Comedy, Drama",Lovers undo a hairdresser from Beverly Hills around Election Eve in 1968.,65.0,Hal Ashby,Shampoo,1975,109,USA, 4000000,49407734,49407734,0,45407734,1
16534,164.0,Drama,"A criminal pleads insanity and is admitted to a mental institution, where he rebels against the oppressive nurse and rallies up the scared patients.",83.0,Milos Forman,One Flew Over the Cuckoo's Nest,1975,133,USA, 3000000,108981275,108997629,16354,105997629,1
16522,103.0,"Comedy, Drama, Music","Over the course of a few hectic days, numerous interrelated people prepare for a political convention as secrets and lies are surfaced and revealed.",96.0,Robert Altman,Nashville,1975,160,USA, 2200000,9984123,9984123,0,7784123,1
16493,65.0,"Comedy, War","In czarist Russia, a neurotic soldier and his distant cousin formulate a plot to assassinate Napoleon.",89.0,Woody Allen,Love and Death,1975,85,USA, 3000000,20123742,20123742,0,17123742,1
16457,282.0,"Adventure, Drama, Thriller","When a killer shark unleashes chaos on a beach community, it's up to a local sheriff, a marine biologist, and an old seafarer to hunt the beast down.",87.0,Steven Spielberg,Jaws,1975,124,USA, 7000000,260000000,471203004,211203004,464203004,1
16403,54.0,"Action, Crime, Drama","""Popeye"" Doyle travels to Marseille to find Alain Charnier, the drug smuggler who eluded him in New York.",68.0,John Frankenheimer,French Connection II,1975,119,USA, 4340000,12484444,12484444,0,8144444,1
16366,51.0,"Action, Crime, Thriller","Classical art professor and collector Dr. Jonathan Hemlock, who doubles as a professional assassin, is coerced out of retirement to avenge the murder of an old friend.",61.0,Clint Eastwood,The Eiger Sanction,1975,129,USA, 9000000,14200000,14200000,0,5200000,1
16355,82.0,"Biography, Crime, Drama","A man robs a bank to pay for his lover's operation, which turns into a hostage situation and a media circus.",86.0,Sidney Lumet,Dog Day Afternoon,1975,125,USA, 1800000,50000000,50000000,0,48200000,1
16648,115.0,"Mystery, Thriller","A bookish CIA researcher finds all his co-workers dead, and must outwit those responsible until he figures out who he can really trust.",63.0,Sydney Pollack,Three Days of the Condor,1975,117,USA, 20000000,27476252,27476252,0,7476252,1
17070,176.0,"Drama, Sport",A small-time boxer gets a supremely rare chance to fight a heavy-weight champion in a bout in which he strives to go the distance for his self-respect.,70.0,John G. Avildsen,Rocky,1976,120,USA, 960000,117235147,117235147,0,116275147,1
17025,50.0,Western,Missouri farmer Josey Wales (Clint Eastwood) joins a Confederate guerrilla unit and winds up on the run from the Union soldiers who murdered his family.,69.0,Clint Eastwood,The Outlaw Josey Wales,1976,135,USA, 3700000,31800000,31800000,0,28100000,1
17118,47.0,"Drama, Music, Romance","A has-been rock star falls in love with a young, up-and-coming songstress.",59.0,Frank Pierson,A Star Is Born,1976,139,USA, 6000000,80000000,80000000,0,74000000,1
17132,283.0,"Crime, Drama","A mentally unstable veteran works as a nighttime taxi driver in New York City, where the perceived decadence and sleaze fuels his urge for violent action by attempting to liberate a presidential campaign worker and an underage prostitute.",94.0,Martin Scorsese,Taxi Driver,1976,114,USA, 1300000,28262574,28441292,178718,27141292,1
17102,46.0,"Action, Comedy, Crime","On a long-distance train trip, a man finds romance but also finds himself in danger of being killed, or at least pushed off the train.",41.0,Arthur Hiller,Silver Streak,1976,114,USA, 6500000,51079064,51079064,0,44579064,1
17001,167.0,Drama,A television network cynically exploits a deranged former anchor's ravings and revelations about the news media for its own profit.,83.0,Sidney Lumet,Network,1976,121,USA, 3800000,23689877,23689877,0,19889877,1
16837,64.0,"Action, Crime, Thriller","San Francisco Inspector ""Dirty"" Harry Callahan (Clint Eastwood) must foil a terrorist organization made up of disgruntled Vietnam veterans. But this time, he's teamed with female partner Inspector Kate Moore (Tyne Daly), with whom he's not too excited to be working.",58.0,James Fargo,The Enforcer,1976,96,USA, 9000000,46236000,46236000,0,37236000,1
16931,100.0,"Adventure, Horror",A petroleum exploration expedition comes to an isolated island and encounters a colossal giant gorilla.,61.0,John Guillermin,King Kong,1976,134,USA, 24000000,52614445,52614445,0,28614445,1
16966,91.0,"Crime, Thriller","A graduate history student is unwittingly caught in the middle of an international conspiracy involving stolen diamonds, an exiled Nazi war criminal, and a rogue government agent.",64.0,John Schlesinger,Marathon Man,1976,125,USA, 6500000,21709020,21709020,0,15209020,1
16761,179.0,Horror,"Carrie White, a shy, friendless teenage girl who is sheltered by her domineering, religious mother, unleashes her telekinetic powers after being humiliated by her classmates at her senior prom.",85.0,Brian De Palma,Carrie,1976,98,USA, 1800000,33800000,33800000,0,32000000,1
16702,147.0,"Biography, Drama, History","""The Washington Post"" reporters",80.0,Alan J. Pakula,All the President's Men,1976,138,USA, 8500000,70600000,70600000,0,62100000,1
17583,172.0,"Action, Adventure, Fantasy","Luke Skywalker joins forces with a Jedi Knight, a cocky pilot, a Wookiee and two droids to save the galaxy from the Empire's world-destroying battle station, while also attempting to rescue Princess Leia from the mysterious Darth Vader.",90.0,George Lucas,Star Wars,1977,121,USA, 11000000,460998507,775512064,314513557,764512064,1
17569,77.0,"Action, Comedy","The Bandit is hired on to run a tractor trailer full of beer over state lines, in hot pursuit by a pesky sheriff.",50.0,Hal Needham,Smokey and the Bandit,1977,96,USA, 4300000,126737428,126737428,0,122437428,1
17559,23.0,Drama,A child molester sent to prison finds that criminals exact harsher justice than society.,53.0,Robert M. Young,Short Eyes,1977,100,USA, 300000,3456,3456,0,-296544,0
17545,97.0,"Drama, Music","Anxious about his future after high school, a 19-year-old Italian-American from Brooklyn tries to escape the harsh reality of his bleak family life by dominating the dance floor at the local disco.",77.0,John Badham,Saturday Night Fever,1977,118,USA, 3000000,94213184,237113184,142900000,234113184,1
17527,65.0,"Animation, Adventure, Comedy",Two mice of the Rescue Aid Society search for a little girl kidnapped by unscrupulous treasure hunters.,74.0,"John Lounsbery, Wolfgang Reitherman",The Rescuers,1977,78,USA, 7500000,71215869,71215869,0,63715869,1
17481,68.0,"Drama, Music, Musical","An egotistical saxophonist and a young singer meet on V-J Day and embark upon a strained and rocky romance, even as their careers begin a long, up-hill climb.",62.0,Martin Scorsese,"New York, New York",1977,155,USA, 14000000,16400000,16400000,0,2400000,1
17418,38.0,Drama,"At the behest of an old and dear friend, playwright",58.0,Fred Zinnemann,Julia,1977,117,USA, 7840000,20714400,20714400,0,12874400,1
17504,53.0,"Animation, Adventure, Comedy",An orphan boy and his magical dragon come to town with his abusive adoptive parents in pursuit.,46.0,Don Chaffey,Pete's Dragon,1977,128,USA, 10000000,39588000,39588000,0,29588000,1
17375,9.0,"Comedy, Drama",A Vietnam veteran suffering from post traumatic stress disorder breaks out of a VA hospital and goes on a road trip with a sympathetic traveler to start a worm farm in California with his fellow veterans.,35.0,Jeremy Kagan,Heroes,1977,112,USA, 3200000,33500000,33500000,0,30300000,1
17346,46.0,"Action, Crime, Thriller","A hard but mediocre cop is assigned to escort a prostitute into custody from Las Vegas to Phoenix, so that she can testify in a mob trial. But a lot of people are literally betting that they won't make it into town alive.",59.0,Clint Eastwood,The Gauntlet,1977,109,USA, 5500000,26414658,26414658,0,20914658,1
17325,120.0,Horror,"A teenage girl once possessed by a demon finds that it still lurks within her. Meanwhile, a priest investigates the death of the girl's exorcist.",39.0,John Boorman,Exorcist II: The Heretic,1977,117,USA, 14000000,30749142,30749142,0,16749142,1
17274,220.0,"Drama, Sci-Fi","Roy Neary, an electric lineman, watches how his quiet and ordinary daily life turns upside down after a close encounter with a UFO.",90.0,Steven Spielberg,Close Encounters of the Third Kind,1977,138,USA, 20000000,135189114,306898466,171709352,286898466,1
17212,143.0,"Comedy, Romance",Neurotic New York comedian Alvy Singer falls in love with the ditzy Annie Hall.,92.0,Woody Allen,Annie Hall,1977,93,USA, 4000000,38251425,38287178,35753,34287178,1
17377,58.0,"Comedy, Mystery, Thriller","A psychiatrist with intense acrophobia (fear of heights) goes to work for a mental institution run by doctors who appear to be crazier than their patients, and have secrets that they are willing to commit murder to keep.",55.0,Mel Brooks,High Anxiety,1977,94,USA, 4015000,31063038,31063038,0,27048038,1
17831,406.0,"Horror, Thriller","Fifteen years after murdering his sister on Halloween night 1963, Michael Myers escapes from a mental hospital and returns to the small town of Haddonfield, Illinois to kill again.",81.0,John Carpenter,Halloween,1978,91,USA, 325000,47000000,47000000,0,46675000,1
17843,32.0,"Action, Comedy",Hollywood aging stuntman Sonny Hooper wants to prove that he's still got what it takes to be a great professional in this risky and under-recognized line of work.,70.0,Hal Needham,Hooper,1978,99,USA, 6000000,78000000,78000000,0,72000000,1
17867,51.0,Drama,"Three sisters find their lives spinning out of control in the wake of their parents' sudden, unexpected divorce.",67.0,Woody Allen,Interiors,1978,92,USA, 10000000,10432366,10432366,0,432366,1
17869,192.0,"Horror, Sci-Fi","When seeds drift to earth from space, mysterious pods begin to grow and invade a small town, replicating the residents one body at a time.",75.0,Philip Kaufman,Invasion of the Body Snatchers,1978,115,USA, 3500000,24946533,24946533,0,21446533,1
17874,101.0,"Adventure, Drama, Horror",Police chief Brody must protect the citizens of Amity after a second monstrous shark begins terrorizing the waters.,51.0,Jeannot Szwarc,Jaws 2,1978,116,USA, 20000000,81766007,187884007,106118000,167884007,1
17934,98.0,Comedy,"At a 1962 college, Dean Vernon Wormer is determined to expel the entire Delta Tau Chi Fraternity, but those troublemakers have other plans for him.",79.0,John Landis,National Lampoon's Animal House,1978,109,USA, 3000000,141600000,141600000,0,138600000,1
18047,49.0,"Crime, Drama","After being released on parole, a career burglar assaults his former probation officer, returns to a life of crime, and goes on the run.",64.0,"Ulu Grosbard, Dustin Hoffman",Straight Time,1978,114,USA, 4000000,9900000,9900000,0,5900000,1
17826,99.0,"Musical, Romance","Good girl Sandy and greaser Danny fell in love over the summer. When they unexpectedly discover they're now in the same high school, will they be able to rekindle their romance?",70.0,Randal Kleiser,Grease,1978,110,USA, 6000000,189969103,396961563,206992460,390961563,1
18085,28.0,"Comedy, Music","Two stoners unknowingly smuggle a van - made entirely of marijuana - from Mexico to L.A., with incompetent Sgt. Stedenko on their trail.",57.0,"Lou Adler, Tommy Chong",Up in Smoke,1978,86,USA, 2000000,44364244,44364244,0,42364244,1
17766,157.0,"Drama, War",An in-depth examination of the ways in which the U.S. Vietnam War impacts and disrupts the lives of people in a small industrial town in Pennsylvania.,86.0,Michael Cimino,The Deer Hunter,1978,183,USA, 15000000,48979328,49074243,94915,34074243,1
17792,83.0,"Mystery, Thriller",A famous fashion photographer develops a disturbing ability to see through the eyes of a killer.,49.0,Irvin Kershner,Eyes of Laura Mars,1978,104,USA, 7000000,20000000,20000000,0,13000000,1
17789,29.0,"Action, Comedy",The San Fernando Valley adventures of trucker turned prize-fighter Philo Beddoe (Clint Eastwood) and his pet orangutan Clyde (Manis the Orangutan).,41.0,James Fargo,Every Which Way but Loose,1978,114,USA, 5000000,85196485,85196485,0,80196485,1
17786,19.0,"Comedy, Drama",Slapstick black comedy about a man (Reynolds) who finds that he hasn't much longer to live and has bungled his attempts at suicide.,46.0,Burt Reynolds,The End,1978,100,USA, 3000000,44917151,44917151,0,41917151,1
17761,122.0,"Drama, Romance",A hot-tempered farm laborer convinces the woman he loves to marry their rich but dying boss so that they can have a claim to his fortune.,93.0,Terrence Malick,Days of Heaven,1978,94,USA, 3000000,3446749,3475702,28953,475702,1
17747,71.0,"Action, Drama","Truckers form a mile long ""convoy"" in support of a trucker's vendetta with an abusive sheriff...Based on the country song of same title by C.W. McCall.",47.0,Sam Peckinpah,Convoy,1978,110,USA, 12000000,22765081,22765081,0,10765081,1
17745,49.0,"Drama, Romance, War",A woman whose husband is fighting in Vietnam falls in love with another man who suffered a paralyzing combat injury there.,61.0,Hal Ashby,Coming Home,1978,127,USA, 3000000,32653905,32653905,0,29653905,1
17712,33.0,"Biography, Drama, Music","The story of the life and career of the early rock and roll singer, from his meteoric rise to stardom, to his marriage and untimely death.",78.0,Steve Rash,The Buddy Holly Story,1978,114,USA, 1200000,14363400,14363400,0,13163400,1
17700,56.0,"Crime, Drama","When three workers try to steal from the local union, they discover the corruption of the union instead and decide to blackmail them.",77.0,Paul Schrader,Blue Collar,1978,114,USA, 1700000,6521083,6521083,0,4821083,1
17425,92.0,Drama,"Set in the Watts area of Los Angeles, a slaughterhouse worker must suspend his emotions to continue working at a job he finds repugnant, and then he finds he has little sensitivity for the family he works so hard to support.",95.0,Charles Burnett,Killer of Sheep,1978,80,USA, 100000,404508,468460,63952,368460,1
17793,26.0,"Crime, Drama, Thriller",A rebellious Cleveland warehouse worker rises through the ranks of a trucking industry union to become union president but his organized crime links cause his eventual downfall.,54.0,Norman Jewison,F.I.S.T,1978,145,USA, 11000000,20388920,20388920,0,9388920,1
18434,21.0,"Crime, Drama","An LA police officer is murdered in the onion fields outside of Bakersfield. However, legal loopholes could keep his kidnappers from receiving justice, and his partner is haunted by overwhelming survivor's guilt.",57.0,Harold Becker,The Onion Field,1979,122,USA, 2000000,9890597,9890597,0,7890597,1
18383,160.0,"Comedy, Drama, Romance",The life of a divorced television writer dating a teenage girl is further complicated when he falls in love with his best friend's mistress.,83.0,Woody Allen,Manhattan,1979,96,USA, 9000000,39946780,40177318,230538,31177318,1
18348,91.0,Drama,"Ted Kramer's wife leaves him, allowing for a lost bond to be rediscovered between Ted and his son, Billy. But a heated custody battle ensues over the divorced couple's son, deepening the wounds left by the separation.",77.0,Robert Benton,Kramer vs. Kramer,1979,105,USA, 8000000,106260000,106260000,0,98260000,1
18583,71.0,"Horror, Mystery, Thriller","A psychopathic killer terrorizes a babysitter, then returns seven years later to menace her again.",58.0,Fred Walton,When a Stranger Calls,1979,97,USA, 1500000,21411158,21411158,0,19911158,1
18486,86.0,"Drama, Sport","Rocky struggles in family life after his bout with Apollo Creed, while the embarrassed champ insistently goads him to accept a challenge for a rematch.",61.0,Sylvester Stallone,Rocky II,1979,119,USA, 7000000,85182160,85182160,0,78182160,1
18489,33.0,"Drama, Music, Romance",The tragic life of a self-destructive female rock star who struggles to deal with the constant pressures of her career and the demands of her ruthless business manager.,67.0,Mark Rydell,The Rose,1979,125,USA, 8500000,29174648,29174648,0,20674648,1
18531,95.0,"Adventure, Mystery, Sci-Fi","When an alien spacecraft of enormous power is spotted approaching Earth, Admiral James T. Kirk resumes command of the overhauled USS Enterprise in order to intercept it.",48.0,Robert Wise,Star Trek: The Motion Picture,1979,132,USA, 35000000,82604699,82604699,0,47604699,1
18581,136.0,"Action, Crime, Thriller","In the near future, a charismatic leader summons the street gangs of New York City in a bid to take it over. When he is killed, The Warriors are falsely blamed and now must fight their way home while every other gang is hunting them down.",65.0,Walter Hill,The Warriors,1979,92,USA, 4000000,22490039,22490039,0,18490039,1
18277,22.0,"Comedy, Drama, Western",A Polish rabbi wanders through the Old West on his way to lead a synagogue in San Francisco. On the way he is nearly burnt at the stake by Indians and almost killed by outlaws.,38.0,Robert Aldrich,The Frisco Kid,1979,119,USA, 9000000,9346177,9346177,0,346177,1
18448,220.0,"Horror, Sci-Fi","A teenage boy and his friends face off against a mysterious grave robber known only as the Tall Man, who keeps a lethal arsenal of terrible weapons with him.",72.0,Don Coscarelli,Phantasm,1979,88,USA, 300000,11988469,11988469,0,11688469,1
18249,31.0,"Comedy, Drama, Romance","A rodeo star past his prime steals his company's horse and rides into the desert, with a feisty reporter accompanying him.",64.0,Sydney Pollack,The Electric Horseman,1979,121,USA, 12500000,61801971,61801971,0,49301971,1
18254,68.0,"Biography, Crime, Drama","Alcatraz is the most secure prison of its time. It is believed that no one can ever escape from it, until three daring men make a possible successful attempt at escaping from one of the most infamous prisons in the world.",76.0,Don Siegel,Escape from Alcatraz,1979,112,USA, 8000000,43000000,43004381,4381,35004381,1
18116,68.0,"Action, Comedy, War",Hysterical Californians prepare for a Japanese invasion in the days after Pearl Harbor.,34.0,Steven Spielberg,1941,1979,118,USA, 35000000,31755742,92455742,60700000,57455742,1
18131,125.0,Horror,"Newlyweds move into a large house where a mass murder was committed, and experience strange manifestations which drive them away.",28.0,Stuart Rosenberg,The Amityville Horror,1979,117,USA, 4700000,86432000,86432000,0,81732000,1
18136,312.0,"Drama, Mystery, War",A U.S. Army officer serving in Vietnam is tasked with assassinating a renegade Special Forces Colonel who sees himself as a god.,94.0,"Francis Ford Coppola, Francis Ford Coppola",Apocalypse Now,1979,147,USA, 31500000,83471511,91880647,8409136,60380647,1
18137,7.0,"Comedy, Family, Western","The adventures of two idiotic outlaw wannabees, Amos and Theodore.",37.0,Vincent McEveety,The Apple Dumpling Gang Rides Again,1979,88,USA, 5450000,20931111,20931111,0,15481111,1
18164,39.0,"Adventure, Family, Sport","While traveling with his father, young Alec becomes fascinated by a mysterious Arabian stallion who is brought on board and stabled in the ship he is sailing on. When it tragically sinks ...",84.0,Carroll Ballard,The Black Stallion,1979,118,USA, 2700000,37799643,37799643,0,35099643,1
18176,70.0,"Comedy, Drama, Romance",A small-town boy obsessed with the Italian cycling team vies for the affections of a college girl.,91.0,Peter Yates,Breaking Away,1979,101,USA, 2300000,16424918,16424918,0,14124918,1
18204,77.0,"Drama, Thriller",A reporter finds what appears to be a cover-up of safety hazards at a nuclear power plant.,81.0,James Bridges,The China Syndrome,1979,122,USA, 6000000,51718367,51718367,0,45718367,1
18161,107.0,"Action, Sci-Fi","A research vessel finds a missing ship, commanded by a mysterious scientist, on the edge of a black hole.",52.0,Gary Nelson,The Black Hole,1979,98,USA, 20000000,35841901,35841901,0,15841901,1
18921,64.0,Drama,"The accidental death of the older son of an affluent family deeply strains the relationships among the bitter mother, the good-natured father, and the guilt-ridden younger son.",87.0,Robert Redford,Ordinary People,1980,124,USA, 6000000,54766923,54766923,0,48766923,1
18894,168.0,"Comedy, Horror, Thriller","A seemingly friendly farmer and his sister kidnap unsuspecting travelers and bury them alive, using them to create the ""special meat"" they are famous for.",64.0,Kevin Connor,Motel Hell,1980,101,USA, 3000000,6342668,6342668,0,3342668,1
18917,8.0,"Comedy, Crime, Fantasy",A murdered detective must avenge his murder after he is reincarnated as a dog.,41.0,Joe Camp,Oh Heavenly Dog,1980,103,USA, 6000000,6216067,6216067,0,216067,1
18938,67.0,"Adventure, Comedy, Family",The adventures of the famous sailor man and his friends in the seaside town of Sweethaven.,64.0,Robert Altman,Popeye,1980,114,USA, 20000000,49823037,49823037,0,29823037,1
19005,79.0,"Action, Comedy, Drama","A fugitive stumbles on a movie set just when they need a new stunt man, takes the job as a way to hide out and falls for the leading lady.",77.0,Richard Rush,The Stunt Man,1980,131,USA, 3500000,7063886,7063886,0,3563886,1
18948,185.0,"Biography, Drama, Sport",The life of boxer,89.0,Martin Scorsese,Raging Bull,1980,129,USA, 18000000,23383987,23402117,18130,5402117,1
18962,7.0,"Adventure, Comedy, Crime",Two sophisticated jewel thieves join forces to steal $30 million in uncut jewels. Despite a continuous exchange of quips they eventually become romantically involved.,58.0,"Don Siegel, Peter R. Hunt",Rough Cut,1980,112,USA, 14000000,16656125,16656125,0,2656125,1
18991,47.0,"Drama, Fantasy, Romance",A Chicago playwright uses self-hypnosis to travel back in time and meet the actress whose vintage portrait hangs in a grand hotel.,29.0,Jeannot Szwarc,Somewhere in Time,1980,103,USA, 5100000,9709597,9709597,0,4609597,1
19050,64.0,Comedy,"When the owner of a struggling used car lot is killed, it's up to the lot's hot-shot salesman to save the property from falling into the hands of the owner's ruthless brother and used-car rival.",68.0,Robert Zemeckis,Used Cars,1980,113,USA, 8000000,11715321,11715321,0,3715321,1
19072,53.0,"Fantasy, Musical, Romance",A struggling artist living in Los Angeles meets a girl who may hold the key to his happiness.,35.0,Robert Greenwald,Xanadu,1980,96,USA, 20000000,22762571,22762571,0,2762571,1
18941,28.0,"Comedy, War",A sheltered young high society woman joins the United States Army on a whim and finds herself in a more difficult situation than she ever expected.,59.0,Howard Zieff,Private Benjamin,1980,109,USA, 10000000,69847348,69847348,0,59847348,1
18808,11.0,"Action, Biography, Comedy","The story of professional bounty hunter Ralph ""Papa"" Thorson.",31.0,Buzz Kulik,The Hunter,1980,97,USA, 8000000,16274150,16274150,0,8274150,1
18862,57.0,"Biography, Crime, Western","The origins, exploits and the ultimate fate of the Jesse James gang is told in a sympathetic portrayal of the bank robbers made up of brothers who begin their legendary bank raids because of revenge.",64.0,Walter Hill,The Long Riders,1980,100,USA, 10000000,15795189,15795189,0,5795189,1
18789,130.0,"Adventure, Drama, Western","A dramatization of the real-life Johnson County War in 1890 Wyoming, in which a Sheriff born into wealth, attempts to protect immigrant farmers from rich cattle interests.",57.0,Michael Cimino,Heaven's Gate,1980,219,USA, 44000000,3484331,3484523,192,-40515477,0
18608,43.0,Comedy,"Three female employees of a sexist, egotistical, lying, hypocritical bigot find a way to turn the tables on him.",58.0,Colin Higgins,Nine to Five,1980,109,USA, 10000000,103290500,103300143,9643,93300143,1
18611,158.0,Comedy,A man afraid to fly must ensure that a plane lands safely after the pilots become sick.,78.0,"Jim Abrahams, David Zucker",Airplane!,1980,88,USA, 3500000,83453539,83453539,0,79953539,1
18620,49.0,"Crime, Drama, Mystery","A Los Angeles male escort, who mostly caters to an older female client√®le, is accused of a murder which he did not commit.",57.0,Paul Schrader,American Gigolo,1980,117,USA, 4800000,22743674,22743674,0,17943674,1
18646,79.0,"Drama, War",A hardened sergeant and the four core members of his infantry unit try to survive World War II as they move from battle to battle throughout Europe.,77.0,Samuel Fuller,The Big Red One,1980,113,USA, 4500000,7206220,7206823,603,2706823,1
18652,41.0,"Adventure, Drama, Romance","In the Victorian period, two children are shipwrecked on a tropical island in the South Pacific. With no adults to guide them, the two make a simple life together, unaware that sexual maturity will eventually intervene.",31.0,Randal Kleiser,The Blue Lagoon,1980,104,USA, 4500000,58853106,58853106,0,54353106,1
18653,143.0,"Adventure, Comedy, Crime","Jake Blues, just released from prison, puts together his old band to save the Catholic home where he and his brother Elwood were raised.",60.0,John Landis,The Blues Brothers,1980,133,USA, 27000000,57229890,115229890,58000000,88229890,1
18658,33.0,"Action, Adventure, Comedy","An idealistic, modern-day cowboy struggles to keep his Wild West show afloat in the face of hard luck and waning interest.",66.0,Clint Eastwood,Bronco Billy,1980,116,USA, 6500000,24265659,24265659,0,17765659,1
18623,32.0,"Action, Comedy","A trucker turned prize fighter, his brother and their pet orangutan have a series of misadventures involving the mob, corrupt cops, motorcycle gangs and pretty dames.",51.0,Buddy Van Horn,Any Which Way You Can,1980,116,USA, 15000000,70687344,70687344,0,55687344,1
18665,79.0,"Comedy, Sport",An exclusive golf course has to deal with a brash new member and a destructive dancing gopher.,48.0,Harold Ramis,Caddyshack,1980,98,USA, 6000000,39846344,39846344,0,33846344,1
18673,26.0,Drama,"Tired of her dull job as a waitress, Donna decides to join two carnival hustlers and see what life in their field is like.",68.0,Robert Kaylor,Carny,1980,107,USA, 5500000,1817720,1817720,0,-3682280,0
18728,142.0,"Mystery, Thriller","A mysterious blonde woman kills one of a psychiatrist's patients, and then goes after the high-class call girl who witnessed the murder.",74.0,Brian De Palma,Dressed to Kill,1980,104,USA, 6500000,31899000,31899000,0,25399000,1
18733,204.0,"Action, Adventure, Fantasy","After the Rebels are brutally overpowered by the Empire on the ice planet Hoth, Luke Skywalker begins Jedi training with Yoda, while his friends are pursued by Darth Vader.",82.0,Irvin Kershner,Star Wars: Episode V - The Empire Strikes Back,1980,124,USA, 18000000,290271960,547879454,257607494,529879454,1
18750,56.0,"Action, Sci-Fi","A modern aircraft carrier is thrown back in time to 1941 near Hawaii, just hours before the Japanese attack on Pearl Harbor.",51.0,Don Taylor,The Final Countdown,1980,103,USA, 12000000,16647800,16647800,0,4647800,1
18756,251.0,"Horror, Thriller",An unearthly fog rolls into a small coastal town exactly 100 years after a ship mysteriously sank in its waters.,55.0,John Carpenter,The Fog,1980,89,USA, 1000000,21448782,21448782,0,20448782,1
18659,36.0,"Crime, Drama",The new warden of a small prison farm in Arkansas tries to clean it up of corruption after initially posing as an inmate.,54.0,Stuart Rosenberg,Brubaker,1980,131,USA, 9000000,37121708,37121708,0,28121708,1
18761,197.0,"Horror, Mystery, Thriller","A group of camp counselors are stalked and murdered by an unknown assailant while trying to reopen a summer camp where, years before, it was the site of a child's drowning and a grisly double murder.",22.0,Sean S. Cunningham,Friday the 13th,1980,95,USA, 550000,39754601,39754601,0,39204601,1
19456,67.0,"Adventure, Thriller",A family goes to Africa to meet their father who lives with wild lions.,65.0,Noel Marshall,Roar,1981,102,USA, 17000000,110048,110048,0,-16889952,0
19447,59.0,"Biography, Drama, History","A radical American journalist becomes involved with the Communist revolution in Russia, and hopes to bring its spirit and idealism to the United States.",76.0,Warren Beatty,Reds,1981,195,USA, 32000000,40382659,40382659,0,8382659,1
19445,243.0,"Action, Adventure","In 1936, archaeologist and adventurer Indiana Jones is hired by the U.S. government to find the Ark of the Covenant before",85.0,Steven Spielberg,Raiders of the Lost Ark,1981,115,USA, 18000000,248159971,390133212,141973241,372133212,1
19432,39.0,"Crime, Drama","A New York City narcotics detective reluctantly agrees to cooperate with a special commission investigating police corruption. However, he soon discovers that he's in over his head, and nobody can be trusted.",80.0,Sidney Lumet,Prince of the City,1981,167,USA, 8600000,8124257,8124257,0,-475743,0
19391,55.0,"Action, Crime, Thriller","Conservative street cop DaSilva reluctantly agrees to terminate an international terrorist who has demanded media attention. But DaSilva's ""at-home"" tactics are very much put to the challenge.",56.0,"Bruce Malmuth, Gary Nelson",Nighthawks,1981,99,USA, 5000000,14905359,19905359,5000000,14905359,1
19499,60.0,"Comedy, War",Two friends who are dissatisfied with their jobs decide to join the army for a bit of fun.,68.0,Ivan Reitman,Stripes,1981,106,USA, 10000000,85297000,85297000,0,75297000,1
19433,20.0,Comedy,An immigrant housemaid seduces a 15-year-old boy and later fakes her own death as part of his chauffeur's blackmail plot. Troubles arise when the two start to fall in love.,34.0,Alan Myerson,Private Lessons,1981,87,USA, 2800000,26279000,26279000,0,23479000,1
19702,349.0,Horror,"Five friends travel to a cabin in the woods, where they unknowingly release flesh-possessing demons.",71.0,Sam Raimi,The Evil Dead,1981,85,USA, 350000,2400000,2893091,493091,2543091,1
19513,27.0,"Adventure, Drama","While on an African expedition with her father, Jane Parker meets Tarzan, and the two become fascinated by each other.",24.0,John Derek,Tarzan the Ape Man,1981,115,USA, 6500000,36565280,36565280,0,30065280,1
19519,125.0,"Action, Crime, Drama","Coming closer to his dream of leading a normal life, a professional safecracker agrees to do a job for the Mafia, who has other plans for him.",78.0,Michael Mann,Thief,1981,123,USA, 5500000,11492915,11492915,0,5992915,1
19530,24.0,"Crime, Drama","A worldly ambitious monsignor clashes with his older brother, a cynical Los Angeles homicide detective who is investigating the brutal murder of a young prostitute.",68.0,Ulu Grosbard,True Confessions,1981,108,USA, 10000000,12850276,12850276,0,2850276,1
19560,100.0,"Horror, Thriller",A New York cop investigates a series of brutal deaths that resemble animal attacks.,64.0,Michael Wadleigh,Wolfen,1981,115,USA, 17000000,10626725,10626725,0,-6373275,0
19864,58.0,"Drama, Musical, Romance","A couple has a fight after living together 5 years in Las Vegas. They go out and celebrate 4th of July, each with a new partner. Breakup?",57.0,Francis Ford Coppola,One from the Heart,1981,107,USA, 26000000,636796,636796,0,-25363204,0
19383,25.0,Comedy,"A quiet man's peaceful suburban lifestyle is threatened by the new, obnoxious couple that moves in next door.",47.0,John G. Avildsen,Neighbors,1981,94,USA, 8500000,29916207,29916207,0,21416207,1
19512,26.0,Drama,Military cadets take extreme measures to insure the future of their academy when its existence is threatened by local condo developers.,49.0,Harold Becker,Taps,1981,126,USA, 14000000,35856053,35856053,0,21856053,1
19373,71.0,"Biography, Drama",The abusive and traumatic adoptive upbringing of,55.0,Frank Perry,Mommie Dearest,1981,129,USA, 5000000,19032261,19032261,0,14032261,1
19290,47.0,"Comedy, History",Mel Brooks brings his one-of-a-kind comic touch to the history of mankind covering events from the Old Testament to the French Revolution in a series of episodic comedy vignettes.,47.0,Mel Brooks,History of the World: Part I,1981,92,USA, 11000000,31672907,31672907,0,20672907,1
19090,26.0,"Drama, Romance, Thriller","When a prosecutor leaks a false story that a liquor warehouse owner is involved in the murder of a union head, the man's life begins to unravel.",64.0,Sydney Pollack,Absence of Malice,1981,116,USA, 12000000,40716963,40716963,0,28716963,1
19371,15.0,"Comedy, Fantasy, Sci-Fi","Jealous, harried air traffic controller Max Fiedler, recently dumped by his girlfriend, comes into contact with nuclear waste and is granted the power of telekinesis, which he uses not only to win her back, but to gain a little revenge.",27.0,Ken Shapiro,Modern Problems,1981,93,USA, 8000000,26154211,26154211,0,18154211,1
19104,42.0,"Comedy, Romance","Arthur spends his time with booze and whores. His dad has a wife lined up for him that he keeps rejecting - until it's her or being cut off from $750,000,000. Then he goes shopping where he falls in love with a shoplifter.",69.0,Steve Gordon,Arthur,1981,97,USA, 7000000,95461682,95461682,0,88461682,1
19120,121.0,"Mystery, Thriller",A movie sound recordist accidentally records the evidence that proves that a car accident was actually murder and consequently finds himself in danger.,85.0,Brian De Palma,Blow Out,1981,108,USA, 18000000,12000000,12000000,0,-6000000,0
19175,112.0,Horror,"After her husband dies under mysterious circumstances, a widow becomes increasingly paranoid of the neighboring religious community that may have diabolical plans for her.",56.0,Wes Craven,Deadly Blessing,1981,100,USA, 2500000,8279042,8279042,0,5779042,1
19211,242.0,"Action, Adventure, Sci-Fi","In 1997, when the U.S. president crashes into Manhattan, now a giant maximum security prison, a convicted bank robber is sent in to rescue him.",76.0,John Carpenter,Escape from New York,1981,99,USA, 6000000,25244626,25244626,0,19244626,1
19165,42.0,"Crime, Drama, Mystery","Richard spots a man dumping a body, and decides to expose the man he thinks is the culprit with his friend Alex Cutter.",70.0,Ivan Passer,Cutter's Way,1981,109,USA, 3000000,1729274,1752634,23360,-1247366,0
19239,80.0,"Animation, Adventure, Drama",Two childhood friends find themselves forced to become enemies.,65.0,"Ted Berman, Richard Rich",The Fox and the Hound,1981,83,USA, 12000000,63456988,63456988,0,51456988,1
19321,2.0,Drama,"A group of friends race their high-powered cars up and down a dangerous and deadly mountain road known as Mulholland Drive to see who can claim the title of ""King of the Hill.""",48.0,Noel Nosseck,King of the Mountain,1981,90,USA, 2000000,1791147,1791147,0,-208853,0
19277,52.0,"Drama, Horror, Thriller","A comic book artist loses his hand, which in turn takes on a murderous life of its own.",59.0,Oliver Stone,The Hand,1981,104,USA,6500000,2447576,2447576,0,-4052424,0
19299,133.0,Horror,"After a bizarre and near deadly encounter with a serial killer, a television newswoman is sent to a remote mountain resort whose residents may not be what they seem.",68.0,Joe Dante,The Howling,1981,91,USA, 1000000,17985893,17985893,0,16985893,1
19245,163.0,"Horror, Mystery, Thriller","Mrs. Voorhees is dead, and Camp Crystal Lake is shut down, but a camp next to the infamous place is stalked by an unknown assailant.",26.0,Steve Miner,Friday the 13th: Part 2,1981,87,USA, 1250000,21722776,21722776,0,20472776,1
19276,191.0,Horror,"While Sheriff Brackett and Dr. Loomis hunt for Michael Myers, a traumatized Laurie is rushed to hospital, and the serial killer is not far behind her.",40.0,Rick Rosenthal,Halloween II,1981,92,USA, 2500000,25533818,25533818,0,23033818,1
19882,17.0,"Drama, Sport","The intertwined lives and loves of three highly-ranked athletes striving for the national team; Chris bounces between the beds of male coach Terry and her female friend, competitor, and role model Tory.",71.0,Robert Towne,Personal Best,1982,124,USA, 16000000,5672311,5672311,0,-10327689,0
19916,86.0,"Drama, Sport","After winning the ultimate title and being the world champion, Rocky falls into a hole and finds himself picked up by a former enemy.",57.0,Sylvester Stallone,Rocky III,1982,99,USA, 17000000,125049125,125049125,0,108049125,1
19929,52.0,"Animation, Adventure, Drama","To save her ill son, a field mouse must seek the aid of a colony of rats, with whom she has a deeper link than she ever suspected.",76.0,Don Bluth,The Secret of NIMH,1982,82,USA, 7000000,14665733,14665733,0,7665733,1
19940,65.0,"Action, Crime, Horror","A sheriff tries to stop the killing spree of a silent maniacal murderer who, as the result of secret genetic experimentation by an unethical scientist, has the ability to self-heal.",31.0,Michael Miller,Silent Rage,1982,103,USA, 4500000,10490791,10490791,0,5990791,1
19889,250.0,"Horror, Thriller",A family's home is haunted by a host of demonic ghosts.,79.0,Tobe Hooper,Poltergeist,1982,114,USA, 20,77142388,77142388,0,77142368,1
19960,105.0,"Action, Adventure, Sci-Fi","With the assistance of the Enterprise crew, Admiral Kirk must stop an old nemesis, Khan Noonien Singh, from using the life-generating Genesis Device as the ultimate weapon.",67.0,Nicholas Meyer,Star Trek II: The Wrath of Khan,1982,113,USA, 11200000,78912963,78912963,0,67712963,1
19983,5.0,"Action, Comedy","Cheech and Chong are hired to drive a limo from Chicago to Las Vegas by two shady Arabs - Mr. Slyman (Cheech) and Prince Habib (Chong). Unbeknownst to them, five million dollars of dirty money has been stuffed throughout the car.",40.0,Thomas K. Avildsen,Things Are Tough All Over,1982,90,USA, 7000000,21134374,21134374,0,14134374,1
19986,88.0,"Comedy, Drama, Romance","Michael Dorsey, an unsuccessful actor, disguises himself as a woman in order to get a role on a trashy hospital soap.",88.0,Sydney Pollack,Tootsie,1982,116,USA, 21000000,177200000,177200000,0,156200000,1
19989,12.0,Comedy,An underemployed reporter finds himself literally purchased as a toy for a rich spoiled brat.,16.0,Richard Donner,The Toy,1982,102,USA, 17000000,47118057,47118057,0,30118057,1
19998,167.0,"Action, Adventure, Sci-Fi",A computer hacker is abducted into the digital world and forced to participate in gladiatorial games where his only chance of escape is with the help of a heroic security program.,58.0,Steven Lisberger,TRON,1982,96,USA, 17000000,33000000,33000000,0,16000000,1
20010,86.0,Drama,A lawyer sees the chance to salvage his career and self-respect by taking a medical malpractice case to trial rather than settling.,77.0,Sidney Lumet,The Verdict,1982,129,USA, 16000000,53977250,53993738,16488,37993738,1
20030,30.0,"Comedy, Drama","A struggling young writer finds his life and work dominated by his unfaithful wife and his radical feminist mother, whose best-selling manifesto turns her into a cultural icon.",63.0,George Roy Hill,The World According to Garp,1982,136,USA, 17000000,29712172,29712172,0,12712172,1
20275,101.0,"Comedy, Crime, Drama","Rupert Pupkin is a passionate yet unsuccessful comic who craves nothing more than to be in the spotlight and to achieve this, he stalks and kidnaps his idol to take the spotlight for himself.",73.0,Martin Scorsese,The King of Comedy,1982,109,USA, 20000000,2536242,2536242,0,-17463758,0
20232,206.0,"Horror, Mystery, Sci-Fi",Kids all over America want Silver Shamrock masks for Halloween. Doctor Daniel Challis seeks to uncover a plot by Silver Shamrock owner Conal Cochran.,50.0,Tommy Lee Wallace,Halloween III: Season of the Witch,1982,98,USA, 2500000,14400000,14400000,0,11900000,1
19982,338.0,"Horror, Mystery, Sci-Fi",A research team in Antarctica is hunted by a shape-shifting alien that assumes the appearance of its victims.,57.0,John Carpenter,The Thing,1982,109,USA, 15000000,19629760,19629760,0,4629760,1
19863,49.0,"Drama, Romance","A young man must complete his work at a Navy Officer Candidate School to become an aviator, with the help of a tough Gunnery Sergeant and his new girlfriend.",75.0,Taylor Hackford,An Officer and a Gentleman,1982,124,USA, 7500000,129795554,129795554,0,122295554,1
19727,257.0,"Horror, Thriller","Having revived from his wounds, Jason Voorhees takes refuge at a cabin near Crystal Lake. As a group of co-eds arrive for their vacation, Jason continues his killing spree.",30.0,Steve Miner,Friday the 13th: Part III,1982,95,USA, 2300000,36690067,36690067,0,34390067,1
19208,116.0,"Drama, Horror",A woman is tormented and sexually molested by an invisible demon.,35.0,Sidney J. Furie,The Entity,1982,125,USA, 9000000,13277558,13277558,0,4277558,1
19574,88.0,"Action, Comedy, Crime","A hard-nosed cop reluctantly teams up with a wise-cracking criminal temporarily paroled to him, in order to track down a killer.",71.0,Walter Hill,48 Hrs.,1982,96,USA, 12000000,78868508,78868508,0,66868508,1
19579,33.0,"Comedy, Sci-Fi",A faulty computer causes a passenger space shuttle to head straight for the Sun. Can Ted Striker save the day and get the shuttle back on track - again?,48.0,Ken Finkleman,Airplane II: The Sequel,1982,85,USA, 15000000,27150534,27150534,0,12150534,1
19591,41.0,"Comedy, Drama, Family",A young orphan girl's adventures in finding a family that will take her.,39.0,John Huston,Annie,1982,126,USA, 50000000,57059003,57059003,0,7059003,1
19619,9.0,"Comedy, Drama, Romance","When a professional couple who have lived & worked together for many years finally decide to marry, their sudden betrothal causes many unexpectedly funny and awkward difficulties. They soon...",70.0,Norman Jewison,Best Friends,1982,116,USA, 15000000,36821203,36821203,0,21821203,1
19620,14.0,"Comedy, Musical",A town's Sheriff and regular patron of a historical whorehouse fights to keep it running when a television reporter targets it as the Devil's playhouse.,40.0,Colin Higgins,The Best Little Whorehouse in Texas,1982,114,USA, 35000000,69701637,69701637,0,34701637,1
19634,32.0,"Crime, Drama, Western",A corrupt border Agent decides to clean up his act when an impoverished woman's baby is put up for sale on the black market.,66.0,Tony Richardson,The Border,1982,108,USA, 22000000,6118683,6118683,0,-15881317,0
19814,22.0,Comedy,"Two gamblers must leave New York City after one loses a lot of money. Doing what all gamblers in trouble would do, they hurry to the gambling capital Las Vegas to turn their luck around.",44.0,Hal Ashby,Lookin' to Get Out,1982,105,USA, 17000000,946461,946461,0,-16053539,0
19648,140.0,"Fantasy, Horror, Thriller",A young woman's sexual awakening brings horror when she discovers her urges transform her into a monstrous black leopard.,62.0,Paul Schrader,Cat People,1982,118,USA, 18000000,7000000,7000000,0,-11000000,0
19666,168.0,"Comedy, Fantasy, Horror",An anthology which tells five terrifying tales based on the E.C. horror comic books of the 1950s.,59.0,George A. Romero,Creepshow,1982,120,USA, 8000000,21028755,21028755,0,13028755,1
19647,9.0,"Comedy, Drama, Romance","Monterey, California in the 1940's. Cannery Row - the section of town where the now closed fish canneries are located - is inhabited primarily by the down and out, although many would not ...",52.0,David S. Ward,Cannery Row,1982,120,USA, 11300000,5301539,5301539,0,-5998461,0
19684,49.0,"Comedy, Drama",A group of college-age buddies struggle with their imminent passage into adulthood in 1959 Baltimore.,82.0,Barry Levinson,Diner,1982,110,USA, 5000000,14099953,14099953,0,9099953,1
19761,19.0,"Comedy, Drama, Music",A boy with a music talent goes on a journey with his uncle for a stage concert.,50.0,Clint Eastwood,Honkytonk Man,1982,122,USA, 2000000,4484991,4484991,0,2484991,1
19740,33.0,"Comedy, Drama, Musical",An English student at a 1960s American high school has to prove himself to the leader of a girls' gang whose members can only date greasers.,52.0,Patricia Birch,Grease 2,1982,115,USA, 13200000,15171476,15171476,0,1971476,1
19717,49.0,"Action, Adventure, Thriller",A pilot is sent into the Soviet Union on a mission to steal a prototype jet fighter that can be partially controlled by a neuralink.,44.0,Clint Eastwood,Firefox,1982,136,USA, 18000000,46708276,46708276,0,28708276,1
19709,135.0,"Comedy, Drama","A group of Southern California high school students are enjoying their most important subjects: sex, drugs, and rock n' roll.",67.0,Amy Heckerling,Fast Times at Ridgemont High,1982,90,USA, 4500000,27092880,27092880,0,22592880,1
19692,246.0,"Family, Sci-Fi",A troubled child summons the courage to help a friendly alien escape Earth and return to his home world.,91.0,Steven Spielberg,E.T. the Extra-Terrestrial,1982,115,USA, 10500000,435110554,792910554,357800000,782410554,1
19718,194.0,"Action, Adventure",A formidable but unstable veteran Green Beret is forced by a cruel Sheriff and his deputies to flee into the mountains and wage an escalating one-man war against his pursuers.,61.0,Ted Kotcheff,First Blood,1982,93,USA, 15000000,47212904,125212904,78000000,110212904,1
20393,86.0,"Adventure, Biography, Drama","The story of the original Mercury 7 astronauts and their macho, seat-of-the-pants approach to the space program.",91.0,Philip Kaufman,The Right Stuff,1983,193,USA, 27000000,21192102,21192102,0,-5807898,0
20395,65.0,"Comedy, Crime, Drama","A Chicago teenager is looking for fun at home while his parents are away, but the situation quickly gets out of hand.",75.0,Paul Brickman,Risky Business,1983,99,USA, 6200000,63541777,63541777,0,57341777,1
20391,186.0,"Action, Adventure, Fantasy","After a daring mission to rescue Han Solo from Jabba the Hutt, the Rebels dispatch to Endor to destroy the second Death Star. Meanwhile, Luke struggles to help Darth Vader back from the dark side without falling into the Emperor's trap.",58.0,Richard Marquand,Star Wars: Episode VI - Return of the Jedi,1983,131,USA, 32500000,309306177,475347111,166040934,442847111,1
20402,78.0,"Crime, Drama, Romance","Rusty James, an absent-minded street thug struggles to live up to his legendary older brother's reputation, and longs for the days when gang warfare was going on.",63.0,Francis Ford Coppola,Rumble Fish,1983,94,USA, 10000000,2494480,2494480,0,-7505520,0
20416,173.0,"Crime, Drama","In 1980 Miami, a determined Cuban immigrant takes over a drug cartel and succumbs to greed.",65.0,Brian De Palma,Scarface,1983,170,USA, 25000000,45408703,66023329,20614626,41023329,1
20436,40.0,"Biography, Drama, History","A worker at a plutonium processing plant is purposefully contaminated, psychologically tortured and possibly murdered to prevent her from exposing worker safety violations at the plant.",64.0,Mike Nichols,Silkwood,1983,131,USA, 10000000,35615609,35615609,0,25615609,1
20376,20.0,"Comedy, Romance","Christine (Phoebe Cates), a student at an exclusive all-girls private school, is in love with Jim, who attends an academy for boys nearby. Christine's arch rival Jordan also has her eye on ...",25.0,Noel Black,Private School,1983,89,USA, 3500000,14049540,14049540,0,10549540,1
20456,22.0,"Drama, Music, Romance",It's five years later and Tony Manero's Saturday Night Fever is still burning. Now he's strutting toward his biggest challenge yet - succeeding as a dancer on the Broadway stage.,23.0,Sylvester Stallone,Staying Alive,1983,93,USA, 22000000,64892670,64892670,0,42892670,1
20479,54.0,"Comedy, Drama","Follows hard-to-please Aurora looking for love, and her daughter's family problems.",79.0,James L. Brooks,Terms of Endearment,1983,132,USA, 8000000,108423489,108423489,0,100423489,1
20488,28.0,Comedy,"At the onset of WW2, a Polish actor's family and the Polish Resistance help the troupe of a theatre escape Poland and the invading Nazis.",61.0,Alan Johnson,To Be or Not to Be,1983,107,USA, 9000000,13030214,13030214,0,4030214,1
20493,98.0,Comedy,A snobbish investor and a wily street con artist find their positions reversed as part of a bet by two callous millionaires.,69.0,John Landis,Trading Places,1983,116,USA, 15000000,90404800,90404800,0,75404800,1
20505,89.0,"Horror, Sci-Fi","Four horror and science fiction segments, directed by four famous directors, each of them being a new version of a classic story from",44.0,"Joe Dante, John Landis",Twilight Zone: The Movie,1983,101,USA, 10000000,29450919,29450919,0,19450919,1
20510,13.0,"Action, Drama, Thriller","Ten years after his son went M.I.A. in Vietnam, U.S. Marine retired Colonel Jason Rhodes assembles a private rescue team to find Americans held in P.O.W. camps in Laos.",38.0,Ted Kotcheff,Uncommon Valor,1983,105,USA, 14500000,30503151,30503151,0,16003151,1
20515,52.0,"Comedy, Romance","Julie, a girl from the valley, meets Randy, a punk from the city. They are from different worlds and find love. Somehow they need to stay together in spite of her trendy, shallow friends.",66.0,Martha Coolidge,Valley Girl,1983,99,USA, 350000,17343596,17343596,0,16993596,1
20529,79.0,"Sci-Fi, Thriller","A young man finds a back door into a military central computer in which reality is confused with game-playing, possibly starting World War III.",77.0,John Badham,WarGames,1983,114,USA, 12000000,79567667,79567667,0,67567667,1
20466,71.0,"Action, Crime, Thriller","A rape victim is exacting revenge on her aggressors in a small town outside San Francisco. ""Dirty"" Harry Callahan, on suspension for angering his superiors (again), is assigned to the case.",52.0,Clint Eastwood,Sudden Impact,1983,117,USA, 22000000,67642693,67642693,0,45642693,1
20342,50.0,"Horror, Sci-Fi",Anthology of four horror tales with a supernatural twist based on urban legends.,39.0,Joseph Sargent,Nightmares,1983,99,USA, 6000000,6670680,6670680,0,670680,1
20109,42.0,"Sci-Fi, Thriller","Researchers develop a system where they can jump into people's minds. But when people involved bring their personal problems into the equation, it becomes dangerous - perhaps deadly.",57.0,Douglas Trumbull,Brainstorm,1983,106,USA, 15000000,10219460,10219460,0,-4780540,0
20049,61.0,"Crime, Drama, Thriller",An LAPD detective and his rookie partner are on the trail of a psychopathic young man who is murdering young women.,12.0,J. Lee Thompson,10 to Midnight,1983,101,USA, 4520000,7175592,7175592,0,2655592,1
20336,67.0,"Adventure, Comedy",The Griswold family's cross-country drive to the Walley World theme park proves to be much more arduous than they ever anticipated.,55.0,Harold Ramis,National Lampoon's Vacation,1983,98,USA, 15000000,61399552,61399552,0,46399552,1
20060,26.0,"Drama, Romance, Sport",A high school football player desperate for a scholarship and his headstrong coach clash in a dying Pennsylvania steel town.,62.0,Michael Chapman,All the Right Moves,1983,91,USA, 5600000,17233166,17233166,0,11633166,1
20096,62.0,"Comedy, Drama",A group of seven former college friends gather for a week-end reunion at a South Carolina vacation home after the funeral of another of their college friends.,61.0,Lawrence Kasdan,The Big Chill,1983,105,USA, 8000000,56399659,56399659,0,48399659,1
20130,170.0,"Horror, Thriller",A nerdish boy buys a strange car with an evil mind of its own and his nature starts to change to reflect it.,57.0,John Carpenter,Christine,1983,110,USA, 9700000,21017849,21017849,0,11317849,1
20148,121.0,"Horror, Thriller","Cujo, a friendly St. Bernard, contracts rabies and conducts a reign of terror on a small American town.",57.0,Lewis Teague,Cujo,1983,93,USA, 5000000,21156152,21156152,0,16156152,1
20203,55.0,"Animation, Fantasy, Adventure","At the end of the ice age, an evil queen and her son are set on conquering the world using magic and warriors. The lone survivor of a crushed village fights back as does the king of Fire Keep.",45.0,"Ralph Bakshi, Tom Tataranowicz",Fire and Ice,1983,81,USA, 1200000,760883,760883,0,-439117,0
20206,55.0,"Drama, Music, Romance",A Pittsburgh woman with two jobs as a welder and an exotic dancer wants to get into ballet school.,39.0,Adrian Lyne,Flashdance,1983,95,USA, 4000000,92921203,92921203,0,88921203,1
20104,77.0,"Action, Crime, Drama",The cop test pilot for an experimental police helicopter learns the sinister implications of the new vehicle.,66.0,John Badham,Blue Thunder,1983,109,USA, 22000000,42313354,42313354,0,20313354,1
20246,116.0,"Horror, Mystery, Thriller","After a seemingly innocent prank goes horribly wrong, a group of sorority sisters are stalked and murdered one by one in their sorority house while throwing a party to celebrate their graduation.",50.0,Mark Rosman,The House on Sorority Row,1983,91,USA, 425000,10604986,10604986,0,10179986,1
20260,83.0,"Adventure, Horror, Thriller",The sons of police chief Brody must protect customers at a SeaWorld theme park after a thirty-five-foot shark becomes trapped in the park with them.,27.0,Joe Alves,Jaws 3-D,1983,99,USA, 20500000,45517055,87987055,42470000,67487055,1
20290,40.0,"Action, Crime, Drama","After helping the local police with some horse thieves, a Texas Ranger aims at a drug lord with arms trade as well. They're interested in the same woman and they're both into martial arts.",65.0,Steve Carver,Lone Wolf McQuade,1983,107,USA, 5000000,12232628,12232628,0,7232628,1
20910,82.0,"Drama, Music, Musical","A young musician, tormented by an abusive situation at home, must contend with a rival singer, a burgeoning romance, and his own dissatisfied band, as his star begins to rise.",55.0,Albert Magnoli,Purple Rain,1984,111,USA, 7200000,70261052,70261906,854,63061906,1
20904,25.0,"Action, Comedy, Crime",Two cousins unknowingly rob the mob and face the dangerous consequences.,58.0,Stuart Rosenberg,The Pope of Greenwich Village,1984,121,USA, 8000000,6836201,6836201,0,-1163799,0
20903,55.0,Comedy,"A group of good-hearted, but incompetent misfits enter the police academy, but the instructors there are not going to put up with their pranks.",41.0,Hugh Wilson,Police Academy,1984,96,USA, 4500000,81198894,81198894,0,76698894,1
20896,28.0,"Adventure, Drama, Romance","A United States Navy destroyer escort participates in a Navy ""invisibility"" experiment that inadvertently sends two sailors forty years into the future.",44.0,Stewart Raffill,The Philadelphia Experiment,1984,102,USA, 21000000,8103330,8103330,0,-12896670,0
20860,205.0,Horror,The monstrous spirit of a slain child murderer seeks revenge by invading the dreams of teenagers whose parents were responsible for his untimely death.,76.0,Wes Craven,A Nightmare on Elm Street,1984,91,USA, 1800000,25504513,25504513,0,23704513,1
20851,64.0,"Drama, Sport",An unknown comes seemingly out of nowhere to become a legendary player with almost divine talent.,61.0,Barry Levinson,The Natural,1984,138,USA, 28000000,47951979,47951979,0,19951979,1
20844,14.0,"Comedy, Drama, Romance","When a Russian musician defects in Bloomingdale's department store in New York, he finds adjusting to American life more difficult than he imagined.",67.0,Paul Mazursky,Moscow on the Hudson,1984,115,USA, 13000000,25068724,25068724,0,12068724,1
20920,111.0,"Action, Drama","It is the dawn of World War III. In mid-western America, a group of teenagers band together to defend their town, and their country, from invading Soviet forces.",55.0,John Milius,Red Dawn,1984,114,USA, 4200000,38376497,38376497,0,34176497,1
20994,106.0,"Action, Crime, Drama","A mercenary is hired to rescue his ex-girlfriend, a singer who has been kidnapped by a motorcycle gang.",59.0,Walter Hill,Streets of Fire,1984,93,USA, 14500000,8089290,8089290,0,-6410710,0
20924,67.0,Comedy,"At Adams College, a group of bullied outcasts and misfits resolve to fight back for their peace and self-respect.",44.0,Jeff Kanew,Revenge of the Nerds,1984,90,USA, 8000000,40874452,40874452,0,32874452,1
20971,228.0,"Horror, Thriller","Little Billy witness his parents getting killed by Santa after being warned by his senile grandpa that Santa punishes those who are naughty. Now Billy is 18, and out of the orphanage, and he has just become Santa, himself.",31.0,Charles E. Sellier Jr.,"Silent Night, Deadly Night",1984,79,USA, 1065000,2491460,2491460,0,1426460,1
20974,83.0,"Comedy, Romance","A girl's ""sweet"" sixteenth birthday becomes anything but special, as she suffers from every embarrassment possible.",61.0,John Hughes,Sixteen Candles,1984,93,USA, 6500000,23686027,23686027,0,17186027,1
20984,43.0,"Comedy, Fantasy, Romance","A young man is reunited with a mermaid who saved him from drowning as a boy. He falls in love with her, not knowing who or what she is.",71.0,Ron Howard,Splash,1984,111,USA, 8000000,69821334,69821334,0,61821334,1
20987,79.0,"Action, Adventure, Sci-Fi",Admiral Kirk and his bridge crew risk their careers stealing the decommissioned Enterprise to return to the restricted Genesis Planet to recover Spock's body.,56.0,Leonard Nimoy,Star Trek III: The Search for Spock,1984,105,USA, 17000000,76471046,76471046,0,59471046,1
20988,98.0,"Romance, Sci-Fi",An alien takes the form of a young widow's husband and asks her to drive him from Wisconsin to Arizona. The government tries to stop them.,71.0,John Carpenter,Starman,1984,115,USA, 22000000,28744356,28744356,0,6744356,1
21014,84.0,"Comedy, Music","Spinal Tap, one of England's loudest bands, is chronicled by film director Marty DiBergi on what proves to be a fateful tour.",92.0,Rob Reiner,This Is Spinal Tap,1984,82,USA, 2500000,4736202,4736202,0,2236202,1
20922,142.0,"Comedy, Crime, Sci-Fi","Young punk Otto becomes a repo man after helping to steal a car, and stumbles into a world of wackiness as a result.",75.0,Alex Cox,Repo Man,1984,92,USA, 1500000,129000,129000,0,-1371000,0
20711,191.0,"Horror, Thriller","After being mortally wounded and taken to the morgue, murderer Jason Voorhees spontaneously revives and embarks on a killing spree as he makes his way back to his home at Camp Crystal Lake.",33.0,Joseph Zito,Friday the 13th: The Final Chapter,1984,91,USA, 2600000,32980880,32980880,0,30380880,1
20794,83.0,"Action, Adventure, Sci-Fi",Video game expert Alex Rogan finds himself transported to another planet after conquering The Last Starfighter video game only to find out it was just a test. He was recruited to join the team of best starfighters to defend their world from the attack.,67.0,Nick Castle,The Last Starfighter,1984,101,USA, 15000000,28733290,28733290,0,13733290,1
20567,35.0,"Action, Adventure, Crime","A gangster hires an ex-football player to find his girlfriend. When he finds her, they fall in love, and the twists start to appear.",42.0,Taylor Hackford,Against All Odds,1984,128,USA, 13000000,21689062,21689062,0,8689062,1
20596,18.0,"Drama, Music","An aspiring DJ, from the South Bronx, and his best friend, a promoter, try to get into show business by exposing people to hip-hop music and culture.",68.0,Stan Lathan,Beat Street,1984,105,USA, 9500000,16595791,16595791,0,7095791,1
20600,6.0,"Comedy, War","A military weapons engineer struggles to do his job responsibly, while a hapless tank commander has to live with the consequences in combat years later.",29.0,Willard Huyck,Best Defense,1984,94,USA, 18000000,19265302,19265302,0,1265302,1
20601,123.0,"Action, Comedy, Crime",A freewheeling Detroit cop pursuing a murder investigation finds himself dealing with the very different culture of Beverly Hills.,64.0,Martin Brest,Beverly Hills Cop,1984,105,USA, 14000000,234760478,316360478,81600000,302360478,1
20611,145.0,"Crime, Drama, Thriller","A rich but jealous man hires a private investigator to kill his cheating wife and her new man. But, when blood is involved, nothing is simple.",81.0,"Joel Coen, Ethan Coen",Blood Simple,1984,99,USA, 1500000,3851855,4227849,375994,2727849,1
20614,109.0,"Crime, Drama, Mystery",A young actor's obsession with spying on a beautiful woman who lives nearby leads to a baffling series of events with drastic consequences.,69.0,Brian De Palma,Body Double,1984,114,USA, 10000000,8801940,8801940,0,-1198060,0
20625,77.0,Comedy,"In his attempts to reconcile a lounge singer with his mistress, a hapless talent agent is mistaken as her lover by a jealous gangster.",80.0,Woody Allen,Broadway Danny Rose,1984,84,USA, 8000000,10600497,10600497,0,2600497,1
20630,116.0,"Horror, Sci-Fi",A bizarre series of sudden disappearances on the streets of New York City seems to point toward something unsavory living in the sewers.,57.0,Douglas Cheek,C.H.U.D.,1984,88,USA, 1250000,4654423,4654423,0,3404423,1
20560,88.0,"Adventure, Mystery, Sci-Fi",A joint U.S.-Soviet expedition is sent to Jupiter to learn what happened to the Discovery... and HAL.,53.0,Peter Hyams,2010: The Year We Make Contact,1984,116,USA, 28000000,40400657,40400657,0,12400657,1
20643,138.0,"Horror, Thriller",A young couple is trapped in a remote town where a dangerous religious cult of children believe everyone over the age of 18 must be killed.,45.0,Fritz Kiersch,Children of the Corn,1984,92,USA, 800000,14568989,14568989,0,13768989,1
20768,24.0,"Comedy, Crime","Set in the 1930s, an honest, goodhearted man is forced to turn to a life of crime to finance his neurotic mother's skyrocketing medical bills.",54.0,Amy Heckerling,Johnny Dangerously,1984,90,USA, 9000000,17124395,17124395,0,8124395,1
20778,101.0,"Action, Drama, Family","A boy and his mother move to California for a new job. He struggles to fit in, as a group of karate students starts to bully him for dating a rich girl from their clique. It's up to the Japanese landlord, Miyagi, to teach him karate.",60.0,John G. Avildsen,The Karate Kid,1984,126,USA, 8000000,91077276,91077276,0,83077276,1
20728,226.0,"Comedy, Fantasy, Horror",A boy inadvertently breaks three important rules concerning his new pet and unleashes a horde of malevolently mischievous monsters on a small town.,70.0,Joe Dante,Gremlins,1984,106,USA, 11000000,153083102,153120458,37356,142120458,1
20759,154.0,"Action, Adventure","In 1935, Indiana Jones arrives in India, still part of the British Empire, and is asked to find a mystical stone. He then stumbles upon a secret cult committing enslavement and human sacrifices in the catacombs of an ancient palace.",57.0,Steven Spielberg,Indiana Jones and the Temple of Doom,1984,118,USA, 28000000,179870271,333107271,153237000,305107271,1
20704,62.0,"Drama, Music, Romance","A city teenager moves to a small town where rock music and dancing have been banned, and his rebellious spirit shakes up the populace.",42.0,Herbert Ross,Footloose,1984,107,USA, 8200000,80035402,80035402,0,71835402,1
20699,75.0,"Action, Horror, Sci-Fi",A couple who participated in a potent medical experiment gain telekinetic ability and then have a child who is pyrokinetic.,50.0,Mark L. Lester,Firestarter,1984,114,USA, 15000000,17080167,17080167,0,2080167,1
20655,34.0,"Crime, Drama, Music","The Cotton Club was a famous night club in Harlem. The story follows the people who visited the club, those who ran it, and is peppered with the Jazz music that made it so famous.",68.0,Francis Ford Coppola,The Cotton Club,1984,127,USA, 58000000,25928721,25928721,0,-32071279,0
20719,250.0,"Action, Comedy, Fantasy",Three former parapsychology professors set up shop as a unique ghost removal service.,71.0,Ivan Reitman,Ghostbusters,1984,105,USA, 30000000,242582079,295743767,53161688,265743767,1
21432,56.0,"Adventure, Comedy, Family","When eccentric man-child Pee-wee Herman gets his beloved bike stolen in broad daylight, he sets out across the U.S. on the adventure of his life.",47.0,Tim Burton,Pee-wee's Big Adventure,1985,91,USA, 6000000,40940662,40940662,0,34940662,1
21457,87.0,"Comedy, Fantasy, Romance","In New Jersey in 1935, a movie character walks off the screen and into the real world.",75.0,Woody Allen,The Purple Rose of Cairo,1985,82,USA, 15000000,10631333,10631333,0,-4368667,0
21445,29.0,Comedy,When a new gang moves into town it's up to the screwball police team to stop them.,39.0,"Jerry Paris, James Signorelli",Police Academy 2: Their First Assignment,1985,87,USA, 7600000,55600000,55600000,0,48000000,1
21435,16.0,"Drama, Romance","A female aerobics instructor meets a male reporter doing a story on health clubs, but it isn't love at first sight.",46.0,James Bridges,Perfect,1985,115,USA, 19000000,12918858,12918858,0,-6081142,0
21426,50.0,"Drama, Western",A mysterious preacher (Clint Eastwood) protects a humble prospector village from a greedy mining company trying to encroach on their land.,61.0,Clint Eastwood,Pale Rider,1985,115,USA, 6900000,41410568,41410568,0,34510568,1
21394,129.0,Horror,"A teenage boy is haunted in his dreams by deceased child murderer Freddy Krueger, who is out to possess him in order to continue his reign of terror in the real world.",43.0,Jack Sholder,A Nightmare on Elm Street Part 2: Freddy's Revenge,1985,87,USA, 3000000,29999213,29999213,0,26999213,1
21388,40.0,"Adventure, Comedy",The Griswolds win a vacation tour across Europe where the usual havoc ensues.,47.0,Amy Heckerling,National Lampoon's European Vacation,1985,95,USA, 17000000,49364621,49364621,0,32364621,1
21411,45.0,"Comedy, Fantasy, Horror","A vampire Countess needs to drink the blood of a virgin in order to keep her eternal beauty. It seems that all is hopeless, until she bumps into Mark Kendall.",64.0,Howard Storm,Once Bitten,1985,94,USA, 3200000,10000000,10000000,0,6800000,1
21468,184.0,"Comedy, Horror, Sci-Fi","After an odd new medical student arrives on campus, a dedicated local and his girlfriend become involved in bizarre experiments centering around the re-animation of dead tissue.",73.0,Stuart Gordon,Re-Animator,1985,105,USA, 900000,2023414,2023414,0,1123414,1
21525,45.0,"Drama, Romance","A group of friends, just out of college, struggle with adulthood.",35.0,Joel Schumacher,St. Elmo's Fire,1985,110,USA, 10000000,37803872,37803872,0,27803872,1
21477,231.0,"Comedy, Horror, Sci-Fi","When two bumbling employees at a medical supply warehouse accidentally release a deadly gas into the air, the vapors cause the dead to rise again as zombies.",66.0,Dan O'Bannon,The Return of the Living Dead,1985,91,USA, 4000000,14237880,14237880,0,10237880,1
21484,106.0,"Drama, Sport","Rocky Balboa proudly holds the world heavyweight boxing championship, but a new challenger has stepped forward: Drago, a six-foot-four, 261-pound fighter who has the backing of the Soviet Union.",40.0,Sylvester Stallone,Rocky IV,1985,91,USA, 30000000,127873716,300473716,172600000,270473716,1
21489,70.0,"Action, Adventure, Drama",Two escaped convicts and a female railway worker find themselves trapped on a train with no brakes and nobody driving.,67.0,Andrey Konchalovskiy,Runaway Train,1985,111,USA, 9000000,7683620,7683620,0,-1316380,0
21512,54.0,"Action, Crime, Drama",A misfit bunch of friends come together to right the injustices which exist in a small town.,64.0,Lawrence Kasdan,Silverado,1985,133,USA, 26000000,32192570,32192570,0,6192570,1
21522,34.0,"Adventure, Comedy","Two bumbling government employees think they are U.S. spies, only to discover that they are actually decoys for Nuclear War.",22.0,John Landis,Spies Like Us,1985,102,USA, 22000000,60088980,60088980,0,38088980,1
21541,52.0,"Comedy, Drama, Romance","A college student plans a cross-country trip to get laid, but ends up traveling with a young woman. They hate each other, so naturally...",76.0,Rob Reiner,The Sure Thing,1985,100,USA, 4500000,18135531,18135531,0,13635531,1
21566,111.0,"Action, Crime, Drama",A fearless Secret Service agent will stop at nothing to bring down the counterfeiter who killed his partner.,81.0,William Friedkin,To Live and Die in L.A.,1985,116,USA, 6000000,17307019,17307019,0,11307019,1
21621,84.0,"Comedy, Romance, Sci-Fi","Two high school nerds use a computer program to literally create the perfect woman, but she turns their lives upside down.",46.0,John Hughes,Weird Science,1985,94,USA, 7500000,23834048,38934048,15100000,31434048,1
21632,99.0,"Crime, Drama, Romance","When a young Amish boy is sole witness to a murder, policeman John Book goes into hiding in Amish country to protect him until the trial.",76.0,Peter Weir,Witness,1985,112,USA, 12000000,68706993,68706993,0,56706993,1
21355,23.0,"Biography, Drama",A teenager with a massive facial skull deformity and biker gang mother attempt to live as normal a life as possible under the circumstances.,73.0,Peter Bogdanovich,Mask,1985,120,USA, 8000000,48230162,48230162,0,40230162,1
21469,55.0,"Comedy, Romance, Sci-Fi","Teenage geniuses deal with their abilities while developing a high-powered laser for a university project. When their professor intends to turn their work into a military weapon, they decide to ruin his plans.",71.0,Martha Coolidge,Real Genius,1985,108,USA, 8000000,12952019,12952019,0,4952019,1
21886,113.0,"Comedy, Fantasy, Horror",A troubled writer moves into a haunted house after inheriting it from his aunt.,44.0,Steve Miner,House,1985,93,USA, 3000000,19444631,19444631,0,16444631,1
21074,107.0,"Comedy, Crime, Drama",An ordinary word processor has the worst night of his life after he agrees to visit a girl in Soho who he met that evening at a coffee shop.,90.0,Martin Scorsese,After Hours,1985,97,USA, 4500000,10609321,10609321,0,6109321,1
21101,233.0,"Adventure, Comedy, Sci-Fi","Marty McFly, a 17-year-old high school student, is accidentally sent thirty years into the past in a time-traveling DeLorean invented by his close friend, the maverick scientist Doc Brown.",87.0,Robert Zemeckis,Back to the Future,1985,116,USA, 19000000,211159762,388355305,177195543,369355305,1
21128,148.0,"Comedy, Drama",Five high school students meet in Saturday detention and discover how they have a lot more in common than they thought.,62.0,John Hughes,The Breakfast Club,1985,97,USA, 1000000,45875171,51525171,5650000,50525171,1
21131,45.0,Comedy,"A minor league baseball player has to spend thirty million dollars in thirty days, in order to inherit three hundred million dollars. However, he's not allowed to tell anyone about the deal.",37.0,Walter Hill,Brewster's Millions,1985,102,USA, 20000000,40833132,45833132,5000000,25833132,1
21150,32.0,"Drama, Music, Musical",Hopefuls try out before a demanding director for a part in a new musical.,46.0,Richard Attenborough,A Chorus Line,1985,113,USA, 27000000,14202899,14202899,0,-12797101,0
21154,82.0,"Comedy, Crime, Mystery","Six guests are anonymously invited to a strange mansion for dinner, but after their host is killed, they must cooperate with the staff to identify the murderer as the bodies pile up.",36.0,Jonathan Lynn,Clue,1985,94,USA, 15000000,14643997,14643997,0,-356003,0
21158,43.0,"Action, Crime, Drama",A Chicago cop is caught in a middle of a gang war while his own comrades shun him because he wants to take an irresponsible cop down.,64.0,Andrew Davis,Code of Silence,1985,101,USA, 7000000,20345361,20345361,0,13345361,1
21160,79.0,Drama,A black Southern woman struggles to find her identity after suffering abuse from her father and others over four decades.,78.0,Steven Spielberg,The Color Purple,1985,154,USA, 15000000,98467863,98467863,0,83467863,1
21162,141.0,"Action, Adventure, Thriller","A retired Special Forces colonel tries to save his daughter, who was abducted by his former subordinate.",51.0,Mark L. Lester,Commando,1985,90,USA, 10000000,35100000,57491000,22391000,47491000,1
21170,36.0,"Comedy, Crime, Horror","A pair of whacked-out cartoon-like exterminator/hitmen kill the owner of a burglar-alarm company, and stalk the partner who hired them, his wife, and a nerd framed for the murder, who tells the story in flashback from the electric chair.",34.0,Sam Raimi,Crimewave,1985,83,USA, 3000000,5101,5101,0,-2994899,0
21178,200.0,"Horror, Thriller",A small group of military officers and scientists dwell in an underground bunker as the world above is overrun by zombies.,60.0,George A. Romero,Day of the Dead,1985,96,USA, 3500000,5000000,5000000,0,1500000,1
21187,35.0,"Comedy, Drama","A bored suburban housewife, seeking escape from her life, suffers amnesia after an accident, wakes up, and is mistaken for a free-spirited New York City drifter named Susan.",71.0,Susan Seidelman,Desperately Seeking Susan,1985,104,USA, 4500000,27398584,27398584,0,22898584,1
21156,55.0,"Comedy, Drama, Sci-Fi","When a group of trespassing seniors swim in a pool containing alien cocoons, they find themselves energized with youthful vigor.",65.0,Ron Howard,Cocoon,1985,117,USA, 17500000,76113124,85313124,9200000,67813124,1
21328,121.0,"Adventure, Fantasy, Romance",A young man must stop the Lord of Darkness from both destroying daylight and marrying the woman he loves.,30.0,Ridley Scott,Legend,1985,94,USA, 24500000,15502112,15502112,0,-8997888,0
21219,53.0,"Adventure, Comedy, Family","A boy obsessed with 50s sci-fi movies about aliens has a recurring dream about a blueprint of some kind, which he draws for his inventor friend. With the help of a third kid, they follow it and build themselves a spaceship. Now what?",58.0,Joe Dante,Explorers,1985,109,USA, 25000000,9873044,9873044,0,-15126956,0
21324,6.0,"Comedy, Drama, Music","In this movie based on the early days of Def Jam Recordings, up-and-coming manager Russell Walker manages all the hottest acts on the record label Krush Groove Records, which include ...",37.0,Michael Schultz,Krush Groove,1985,97,USA, 3000000,11052713,11052713,0,8052713,1
21297,67.0,"Action, Thriller",A one-man army comes to the rescue of the United States when a spy attempts an invasion.,29.0,Joseph Zito,Invasion U.S.A.,1985,107,USA, 10000000,17536256,17536256,0,7536256,1
21253,108.0,"Adventure, Comedy, Family",A group of young misfits who call themselves The Goonies discover an ancient map and set out on a quest to find a legendary pirate's long-lost treasure.,62.0,Richard Donner,The Goonies,1985,114,USA, 19000000,61503218,61749191,245973,42749191,1
21241,157.0,"Horror, Thriller","A teenager discovers that the newcomer in his neighborhood is a vampire, so he turns to an actor in a television horror show for help dealing with the undead.",62.0,Tom Holland,Fright Night,1985,106,USA, 9000000,24922237,24922237,0,15922237,1
21240,145.0,"Horror, Mystery, Thriller","Still haunted by his past, Tommy Jarvis - who, as a child, killed Jason Voorhees - wonders if the serial killer is connected to a series of brutal murders occurring in and around the secluded halfway house where he now lives.",16.0,Danny Steinmann,Friday the 13th: A New Beginning,1985,92,USA, 2200000,21930418,21930418,0,19730418,1
21232,66.0,"Comedy, Crime, Mystery","Irwin M. ""Fletch"" Fletcher is a newspaper reporter being offered a large sum to off a cancerous millionaire, but is on the run, risking his job and finding clues when it's clear the man is healthy.",68.0,Michael Ritchie,Fletch,1985,98,USA, 8000000,50612888,59612888,9000000,51612888,1
22007,36.0,"Adventure, Drama, Thriller",An inventor spurns his city life and moves his family into the jungles of Central America to make a utopia.,49.0,Peter Weir,The Mosquito Coast,1986,117,USA, 25000000,14302779,14302779,0,-10697221,0
22031,48.0,"Drama, Romance",A woman becomes involved with a man she barely knows. Complications develop during their sexual escapades.,50.0,Adrian Lyne,Nine 1/2 Weeks,1986,117,USA, 17000000,6735922,6735922,0,-10264078,0
22029,173.0,"Comedy, Horror, Sci-Fi","Alien brain parasites, entering humans through the mouth, turn their host into a killing zombie. Some teenagers start to fight against them.",62.0,Fred Dekker,Night of the Creeps,1986,88,USA, 5000000,591366,591366,0,-4408634,0
22067,46.0,"Comedy, Drama, Fantasy","Peggy Sue faints at a high school reunion. When she wakes up, she finds herself in her own past, just before she finished school.",74.0,Francis Ford Coppola,Peggy Sue Got Married,1986,103,USA, 18000000,41382841,41382841,0,23382841,1
21999,37.0,Comedy,A young couple struggles to repair a hopelessly dilapidated house.,49.0,Richard Benjamin,The Money Pit,1986,91,USA, 10000000,37499651,54999651,17500000,44999651,1
21975,147.0,"Crime, Horror, Mystery","Former F.B.I. profiler Will Graham (William Petersen) returns to service to pursue a deranged serial killer named ""the Tooth Fairy"" (Tom Noonan) by the media.",75.0,Michael Mann,Manhunter,1986,120,USA, 15000000,8620929,8620929,0,-6379071,0
21974,22.0,"Sci-Fi, Thriller",A high school prodigy builds an atomic bomb with stolen plutonium to win the 45th National Science Fair and expose a nuclear weapons lab posing as nuclear medicine in Ithaca NY.,61.0,Marshall Brickman,The Manhattan Project,1986,117,USA, 18000000,3900000,3900000,0,-14100000,0
21963,22.0,"Comedy, Drama, Romance","A socially inept fourteen-year-old experiences heartbreak for the first time when his two best friends - Cappie, an older-brother figure, and Maggie, the new girl with whom he is in love - fall for each other.",75.0,David Seltzer,Lucas,1986,100,USA, 6000000,8200000,8200000,0,2200000,1
21953,81.0,"Comedy, Horror, Musical",A nerdy florist finds his chance for success and romance with the help of a giant man-eating plant who demands to be fed.,81.0,Frank Oz,Little Shop of Horrors,1986,94,USA, 25000000,38982260,38982260,0,13982260,1
21929,45.0,"Action, Adventure","Kong falls from the twin towers and he appears to be alive. However, his heart is failing, so it's replaced with an artificial one. All is well until he senses that there's a female Kong somewhere out there and escapes wreaking havoc.",32.0,John Guillermin,King Kong Lives,1986,105,USA, 10000000,4711220,4711220,0,-5288780,0
22079,90.0,Horror,"The Freeling family have a new house, but their troubles with supernatural forces don't seem to be over.",49.0,Brian Gibson,Poltergeist II: The Other Side,1986,91,USA, 19000000,40996665,40996665,0,21996665,1
21981,103.0,"Action, Comedy, Horror",A group of people try to survive when machines start to come alive and become homicidal.,24.0,Stephen King,Maximum Overdrive,1986,98,USA, 10000000,7433663,7433663,0,-2566337,0
22106,51.0,"Crime, Drama","A high school slacker commits a shocking act and proceeds to let his friends in on the secret. However, the friends' reaction is almost as ambiguous and perplexing as the crime itself.",73.0,Tim Hunter,River's Edge,1986,99,USA, 1900000,4600000,4600000,0,2700000,1
24552,163.0,"Biography, Crime, Drama","Henry, a drifter, commits a series of brutal murders, supposedly operating with impunity.",80.0,John McNaughton,Henry: Portrait of a Serial Killer,1986,83,USA, 111000,609939,609939,0,498939,1
22225,22.0,"Comedy, Crime","Harry Valentini and Moe Dickstein are both errand boys for the Mob. When they lose two hundred fifty thousand dollars, they are set up to kill each other. But they run off to Atlantic City, and comedy follows.",62.0,Brian De Palma,Wise Guys,1986,100,USA, 13000000,8475466,8475466,0,-4524534,0
22181,181.0,"Action, Drama","As students at the United States Navy's elite fighter weapons school compete to be best in the class, one daring young pilot learns a few things from a civilian instructor that are not taught in the classroom.",50.0,Tony Scott,Top Gun,1986,110,USA, 15000000,179800601,356830601,177030000,341830601,1
22178,54.0,"Comedy, Western","Three actors accept an invitation to a Mexican village to perform their onscreen bandit fighter roles, unaware that it is the real thing.",52.0,John Landis,¬°Three Amigos!,1986,104,USA, 25000000,39246734,39246734,0,14246734,1
22083,81.0,"Comedy, Drama, Romance",A poor girl must choose between the affections of dating her childhood sweetheart or a rich but sensitive playboy.,57.0,Howard Deutch,Pretty in Pink,1986,97,USA, 9000000,40471663,40471663,0,31471663,1
22175,148.0,"Comedy, Horror",A radio host is victimized by the cannibal family as a former Texas Marshall hunts them.,42.0,Tobe Hooper,The Texas Chainsaw Massacre 2,1986,101,USA, 4700000,8025872,8025872,0,3325872,1
22159,85.0,"Adventure, Comedy, Sci-Fi","To save Earth from an alien probe, Admiral James T. Kirk and his fugitive crew go back in time to San Francisco in 1986 to retrieve the only beings who can communicate with it: humpback whales.",71.0,Leonard Nimoy,Star Trek IV: The Voyage Home,1986,119,USA, 25000000,109713132,109713132,0,84713132,1
22157,127.0,"Adventure, Drama","After the death of one of his friends, a writer recounts a boyhood journey with his friends to find the body of a missing boy.",75.0,Rob Reiner,Stand by Me,1986,89,USA, 8000000,52287414,52287414,0,44287414,1
22154,23.0,"Adventure, Family, Sci-Fi",The young attendees of a space camp find themselves in space for real when their shuttle is accidentally launched into orbit.,40.0,Harry Winer,SpaceCamp,1986,107,USA, 18000000,9697739,9697739,0,-8302261,0
22138,48.0,"Comedy, Family, Sci-Fi","Number 5 of a group of experimental robots in a lab is electrocuted, suddenly becomes intelligent, and escapes.",50.0,John Badham,Short Circuit,1986,98,USA, 9000000,40697761,40697761,0,31697761,1
22135,43.0,"Comedy, Romance",Story of a woman and her three lovers.,79.0,Spike Lee,She's Gotta Have It,1986,84,USA, 175000,7137502,7137502,0,6962502,1
22113,29.0,"Comedy, Crime","A couple, cheated by a vile businessman, kidnap his wife in retaliation, without knowing that their enemy is delighted they did.",78.0,"Jim Abrahams, David Zucker",Ruthless People,1986,93,USA, 13000000,71624879,71624879,0,58624879,1
21880,108.0,"Action, Thriller",A young man who escapes the clutches of a murderous hitch-hiker is subsequently stalked by the hitcher and framed for his crimes.,32.0,Robert Harmon,The Hitcher,1986,97,USA, 6000000,5844868,5844868,0,-155132,0
21747,29.0,"Drama, Romance","A new speech teacher at a school for the deaf falls in love with the janitor, a deaf woman speechless by choice.",80.0,Randa Haines,Children of a Lesser God,1986,119,USA, 10500000,31853080,31853080,0,21353080,1
21722,221.0,"Drama, Mystery, Thriller","The discovery of a severed human ear found in a field leads a young man on an investigation related to a beautiful, mysterious nightclub singer and a group of psychopathic criminals who have kidnapped her child.",76.0,David Lynch,Blue Velvet,1986,120,USA, 6000000,8551228,8617408,66180,2617408,1
21705,29.0,"Comedy, Romance, Sport","To help his discouraged son get through college, a funloving and obnoxious rich businessman decides to enter the school as a student himself.",68.0,Alan Metter,Back to School,1986,96,USA, 11000000,91258000,91258000,0,80258000,1
21698,43.0,"Crime, Drama","In 1978 Pennsylvania, an absentee father is reacquainted with his estranged teenage sons who become intrigued with his romanticized life of crime.",67.0,James Foley,At Close Range,1986,111,USA, 6500000,2347000,2347000,0,-4153000,0
21695,13.0,"Action, Comedy, Crime",A fired cop and useless lawyer sign up as security guards and find they've joined a corrupt union.,17.0,Mark L. Lester,Armed and Dangerous,1986,88,USA, 12000000,15945534,15945534,0,3945534,1
21673,42.0,"Comedy, Drama, Romance","A man and woman meet and try to have a romantic affair, despite their personal problems and the interference of their disapproving friends.",70.0,Edward Zwick,About Last Night...,1986,113,USA, 8500000,38702310,38702310,0,30202310,1
21666,42.0,"Action, Crime, Drama",Scudder is a detective with the Sheriff's Department who is forced to shoot a violent suspect during a narcotics raid. The ensuing psychological aftermath of this shooting worsens his ...,29.0,Hal Ashby,8 Million Ways to Die,1986,115,USA, 18000000,1305114,1305114,0,-16694886,0
21221,37.0,"Action, Thriller","A movie special effects man is hired to fake a real-life mob killing for a witness protection plan, but finds his own life in danger.",71.0,Robert Mandel,F/X,1986,109,USA, 10000000,20603715,20603715,0,10603715,1
21756,12.0,Comedy,"A retired Chicago fireman partners with a reggae singer to turn a seedy Caribbean nightclub into a resort for affluent tourists. A crazy comedy co-starring Rick Moranis, Peter O'Toole, Eugene Levy, more.",40.0,Harold Ramis,Club Paradise,1986,96,USA, 15000000,12308521,12308521,0,-2691479,0
21759,67.0,"Drama, Sport","Fast Eddie Felson teaches a cocky but immensely talented prot√©g√© the ropes of pool hustling, which in turn inspires him to make an unlikely comeback.",77.0,Martin Scorsese,The Color of Money,1986,119,USA, 13800000,52293982,52293982,0,38493982,1
21713,207.0,"Action, Adventure, Comedy",A rough-and-tumble trucker helps rescue his friend's fianc√©e from an ancient sorcerer in a supernatural battle beneath Chinatown.,53.0,John Carpenter,Big Trouble in Little China,1986,99,USA, 25000000,11100000,11100000,0,-13900000,0
21767,95.0,"Comedy, Horror, Sci-Fi","A group of small, furry aliens makes lunch out of the locals in a farming town.",52.0,Stephen Herek,Critters,1986,86,USA, 2000000,13167232,13167232,0,11167232,1
21874,38.0,"Drama, War","Hard-nosed, hard-living Marine Gunnery Sergeant Tom Highway (Clint Eastwood) clashes with his superiors and his ex-wife as he takes command of a spoiled recon platoon with a bad attitude.",53.0,Clint Eastwood,Heartbreak Ridge,1986,130,USA, 15000000,42724017,42724017,0,27724017,1
21868,79.0,"Comedy, Drama","Between two Thanksgivings two years apart, Hannah's husband falls in love with her sister Lee, while her hypochondriac ex-husband rekindles his relationship with her sister Holly.",90.0,Woody Allen,Hannah and Her Sisters,1986,107,USA, 6400000,40084041,40084041,0,33684041,1
21864,12.0,"Comedy, Drama","When a Japanese car company buys an American plant, the American liaison must mediate the clash of work attitudes between the foreign management and native labor.",48.0,Ron Howard,Gung Ho,1986,112,USA, 18000000,36611610,36611610,0,18611610,1
21861,67.0,"Animation, Adventure, Family","Basil, the rodent Sherlock Holmes, investigates the kidnapping of a toy-maker and uncovers its link to his arch-enemy, Professor Ratigan.",73.0,"Ron Clements, Burny Mattinson",The Great Mouse Detective,1986,74,USA, 14000000,38625550,38625550,0,24625550,1
21834,182.0,"Horror, Thriller","Tommy Jarvis goes to the graveyard to get rid of Jason Voorhees' body once and for all, but inadvertently brings him back to life instead. The newly revived killer once again seeks revenge, and Tommy may be the only one who can defeat him.",30.0,Tom McLoughlin,Friday the 13th Part VI: Jason Lives,1986,86,USA, 3000000,19472057,19472057,0,16472057,1
21856,35.0,"Action, Adventure, Comedy",A private detective specializing in missing children is charged with the task of finding a special child whom dark forces want to eliminate.,37.0,Michael Ritchie,The Golden Child,1986,94,USA, 25000000,79817937,79817937,0,54817937,1
21875,18.0,"Comedy, Drama",A food writer pregnant with her second baby finds out her husband is having an affair.,49.0,Mike Nichols,Heartburn,1986,108,USA, 20000000,25314189,25314189,0,5314189,1
21887,100.0,"Action, Adventure, Comedy",A sarcastic humanoid duck is pulled from his homeworld to Earth where he must stop a hellish alien invasion with the help of a nerdy scientist and a cute struggling female rock singer who fancies him.,28.0,Willard Huyck,Howard the Duck,1986,110,USA, 37000000,16295774,37962774,21667000,962774,1
21818,145.0,Comedy,"A high school wise guy is determined to have a day off from school, despite what the Principal thinks of that.",61.0,John Hughes,Ferris Bueller's Day Off,1986,103,USA, 6000000,70136369,70136369,0,64136369,1
21794,24.0,Comedy,A rich but troubled family find their lives altered by the arrival of a vagrant who tries to drown himself in their swimming pool.,82.0,Paul Mazursky,Down and Out in Beverly Hills,1986,103,USA, 14000000,62134225,62134225,0,48134225,1
21825,52.0,"Adventure, Comedy, Family","In 1978, a boy travels 8 years into the future and has an adventure with an intelligent, wisecracking alien ship.",64.0,Randal Kleiser,Flight of the Navigator,1986,90,USA, 9000000,18564613,18564613,0,9564613,1
22743,17.0,"Comedy, Drama, Sci-Fi","An Air Force pilot joins a top secret military experiment involving chimps, but begins to suspect there might be something more to the mysterious ""Project X"".",61.0,Jonathan Kaplan,Project X,1987,108,USA, 18000000,18532286,21589395,3057109,3589395,1
22769,56.0,"Comedy, Romance",The large-nosed C.D. Bales is in love with the beautiful Roxanne; she falls for his personality but another man's looks.,73.0,Fred Schepisi,Roxanne,1987,107,USA, 12000000,40050884,40050884,0,28050884,1
22771,155.0,"Action, Sci-Fi, Thriller",A wrongly convicted man must try to survive a public execution gauntlet staged as a game show.,45.0,Paul Michael Glaser,The Running Man,1987,101,USA, 27000000,38122105,38122105,0,11122105,1
22781,32.0,"Comedy, Romance","A talented young man can't get an executive position without rising through the ranks, so he comes up with a shortcut, which also benefits his love life.",36.0,Herbert Ross,The Secret of My Success,1987,111,USA, 12000000,66995879,110996879,44001000,98996879,1
22764,245.0,"Action, Crime, Sci-Fi","In a dystopic and crime-ridden Detroit, a terminally wounded cop returns to the force as a powerful cyborg haunted by submerged memories.",67.0,Paul Verhoeven,RoboCop,1987,102,USA, 13000000,53424681,53424681,0,40424681,1
22750,67.0,"Comedy, Crime","When a childless couple of an ex-con and an ex-cop decide to help themselves to one of another family's quintuplets, their lives become more complicated than they anticipated.",68.0,"Joel Coen, Ethan Coen",Raising Arizona,1987,94,USA, 6000000,22847564,29180280,6332716,23180280,1
22747,71.0,Comedy,A nostalgic look at radio's golden age focusing on one ordinary family and the various performers in the medium.,74.0,Woody Allen,Radio Days,1987,88,USA, 16000000,14792779,14792779,0,-1207221,0
22736,208.0,"Adventure, Family, Fantasy","While home sick in bed, a young boy's grandfather reads him the story of a farmboy-turned-pirate who encounters numerous obstacles, enemies and allies in his quest to be reunited with his true love.",77.0,Rob Reiner,The Princess Bride,1987,98,USA, 16000000,30857814,30877156,19342,14877156,1
22722,132.0,Comedy,A man must struggle to travel home for Thanksgiving with an obnoxious slob of a shower curtain ring salesman as his only companion.,72.0,John Hughes,"Planes, Trains & Automobiles",1987,93,USA, 30000000,49530280,49530280,0,19530280,1
22717,12.0,"Comedy, Crime, Drama",A womanizer meets his match when he falls for a woman in debt to the mafia.,47.0,James Toback,The Pick-up Artist,1987,81,USA, 15000000,13290368,13290368,0,-1709632,0
22706,57.0,"Action, Drama, Sport",Tough trucker Lincoln Hawk is determined to win back his son and triumph at the world arm wrestling championships.,40.0,Menahem Golan,Over the Top,1987,93,USA, 25000000,16057580,16057580,0,-8942420,0
22679,116.0,"Fantasy, Horror",A psychiatrist familiar with knife-wielding dream demon Freddy Krueger helps teens at a mental hospital battle the killer who is invading their dreams.,49.0,Chuck Russell,A Nightmare on Elm Street 3: Dream Warriors,1987,96,USA, 4500000,44793222,44793222,0,40293222,1
22734,185.0,Horror,"A research team finds a mysterious cylinder in a deserted church. If opened, it could mean the end of the world.",50.0,John Carpenter,Prince of Darkness,1987,102,USA, 3000000,14182492,14182492,0,11182492,1
22917,59.0,"Comedy, Fantasy, Horror","Three single women in a picturesque village have their wishes granted, at a cost, when a mysterious and flamboyant man arrives in their lives.",67.0,George Miller,The Witches of Eastwick,1987,118,USA, 22000000,63766510,63766510,0,41766510,1
22811,111.0,"Adventure, Comedy, Sci-Fi",A rogue star pilot and his trusty sidekick must come to the rescue of a Princess and save the galaxy from a ruthless race of beings known as Spaceballs.,46.0,Mel Brooks,Spaceballs,1987,96,USA, 22700000,38119483,38119483,0,15419483,1
23416,79.0,"Crime, Drama, Horror","The spirit of a long-dead prisoner returns for revenge, haunting the prison's new governor.",47.0,Renny Harlin,Prison,1987,102,USA, 4000000,345704,345704,0,-3654296,0
22670,195.0,"Action, Crime, Drama",A small-town farmer's son reluctantly joins a traveling group of vampires after he is bitten by a beautiful drifter.,76.0,Kathryn Bigelow,Near Dark,1987,94,USA, 5000000,3369307,3369307,0,-1630693,0
22903,114.0,"Crime, Drama","A young and impatient stockbroker is willing to do anything to get to the top, including trading on illegal inside information taken through a ruthless and greedy corporate raider who takes the youth under his wing.",56.0,Oliver Stone,Wall Street,1987,126,USA, 15000000,43848069,43848069,0,28848069,1
22885,146.0,"Crime, Drama, Thriller","During the era of Prohibition in the United States, Federal Agent",79.0,Brian De Palma,The Untouchables,1987,119,USA, 25000000,76270454,76270454,0,51270454,1
22870,25.0,"Comedy, Drama",A minor car accident drives two rival aluminum-siding salesmen to the ridiculous extremes of man versus man in 1963 Baltimore.,75.0,Barry Levinson,Tin Men,1987,112,USA, 11000000,25411386,25411386,0,14411386,1
22864,35.0,"Comedy, Crime, Thriller",A bitter ex-husband wants his former spouse dead. A put-upon momma's boy wants his mother dead. Who will pull it off?,56.0,Danny DeVito,Throw Momma from the Train,1987,88,USA, 14000000,57915972,57915972,0,43915972,1
22862,43.0,Comedy,"A nerd gets himself in hot water with the new bully, a quiet bad boy who challenges him to fight on the grounds of their high school after the day's end.",36.0,Phil Joanou,Three O'Clock High,1987,97,USA, 6000000,3685862,3685862,0,-2314138,0
22861,25.0,"Comedy, Drama, Family",Three bachelors find themselves forced to take care of a baby left by one of the guys' girlfriends.,61.0,Leonard Nimoy,3 Men and a Baby,1987,102,USA, 11000000,167780960,167780960,0,156780960,1
22853,43.0,"Comedy, Fantasy","Todd Howard is a struggling teenager. Nothing seems to be going very well for him, until he turns into a wolf.",8.0,Christopher Leitch,Teen Wolf Too,1987,95,USA, 3000000,7888703,7888703,0,4888703,1
22684,71.0,"Action, Crime, Drama",A coverup and witchhunt occur after a politician accidentally kills his mistress.,77.0,Roger Donaldson,No Way Out,1987,114,USA, 15000000,35509515,35509515,0,20509515,1
22653,104.0,"Action, Comedy, Fantasy",A young group of monster fanatics attempt to save their hometown from Count Dracula and his monsters.,61.0,Fred Dekker,The Monster Squad,1987,79,USA, 12000000,3769990,3769990,0,-8230010,0
22439,283.0,"Comedy, Horror",The lone survivor of an onslaught of flesh-possessing spirits holes up in a cabin with a group of strangers while the demons continue their attack.,69.0,Sam Raimi,Evil Dead II,1987,84,USA, 3600000,5923044,5923044,0,2323044,1
22435,12.0,"Comedy, Family","Ernest, a lovable loser who works as a summer camp handyman and dreams of becoming a guidance councilor, must find a way to inspire a group of juvenile delinquents as well as stop a shady strip mining company from closing the camp.",24.0,John R. Cherry III,Ernest Goes to Camp,1987,92,USA, 3000000,23509382,23509382,0,20509382,1
22430,58.0,"Drama, History, War",A young English boy struggles to survive under Japanese occupation during World War II.,62.0,Steven Spielberg,Empire of the Sun,1987,153,USA, 35000000,22238696,22238696,0,-12761304,0
22418,44.0,"Comedy, Crime","The equally-straight-laced and ""by the book"" nephew of Joe Friday must work with his more laid-back partner to solve a mystery.",62.0,Tom Mankiewicz,Dragnet,1987,106,USA, 20000000,57387516,66673516,9286000,46673516,1
22405,104.0,"Drama, Music, Romance","Spending the summer at a Catskills resort with her family, Frances ""Baby"" Houseman falls in love with the camp's dance instructor, Johnny Castle.",65.0,Emile Ardolino,Dirty Dancing,1987,100,USA, 6000000,64577242,217688008,153110766,211688008,1
22393,60.0,"Action, Crime, Drama",Architect/vigilante Paul Kersey takes on the members of a vicious Los Angeles drug cartel to stop the flow of drugs after his girlfriend's daughter dies from an overdose.,46.0,J. Lee Thompson,Death Wish 4: The Crackdown,1987,99,USA, 5000000,6880310,6880310,0,1880310,1
22366,121.0,"Comedy, Fantasy, Horror","Three more bone-chilling tales that include a vengeful wooden Native American, a monstrous blob in a lake, and a hitchhiker who wants revenge and will not die.",39.0,Michael Gornick,Creepshow 2,1987,92,USA, 3500000,14000000,14000000,0,10500000,1
22442,41.0,"Action, Crime, Drama","A Texas Ranger and a ruthless narcotics kingpin - they were childhood friends, now they are adversaries...",51.0,Walter Hill,Extreme Prejudice,1987,96,USA, 22000000,11307844,11307844,0,-10692156,0
22331,60.0,"Comedy, Drama, Romance","Take two rival television reporters: one handsome, one talented, both male. Add one Producer, female. Mix well, and watch the sparks fly.",84.0,James L. Brooks,Broadcast News,1987,133,USA, 20000000,51249404,67331309,16081905,47331309,1
22304,51.0,"Action, Comedy, Crime","Axel Foley returns to Beverly Hills to help Taggart and Rosewood investigate Chief Bogomil's near-fatal shooting and the series of ""alphabet crimes"" associated with it.",48.0,Tony Scott,Beverly Hills Cop II,1987,100,USA, 28000000,153665036,299965036,146300000,271965036,1
22292,68.0,"Comedy, Drama, Romance","Based on the life of successful poet Charles Bukowski and his exploits in Hollywood during the 60s, 70s, and 80s.",70.0,Barbet Schroeder,Barfly,1987,100,USA, 3000000,3221568,3221568,0,221568,1
22657,76.0,"Comedy, Drama, Romance","Loretta Castorini, a bookkeeper from Brooklyn, New York, finds herself in a difficult situation when she falls for the brother of the man she has agreed to marry.",83.0,Norman Jewison,Moonstruck,1987,102,USA, 15000000,80640528,80640528,0,65640528,1
22313,40.0,"Comedy, Romance","A workaholic needs a date for a dinner with new important clientele, but who his brother sets him up with could lead to disaster.",49.0,Blake Edwards,Blind Date,1987,95,USA, 18000000,39321715,39337581,15866,21337581,1
22446,108.0,"Drama, Thriller",A married man's one-night stand comes back to haunt him when that lover begins to stalk him and his family.,67.0,Adrian Lyne,Fatal Attraction,1987,119,USA, 14000000,156645693,320145693,163500000,306145693,1
22481,66.0,"Biography, Comedy, Drama","In 1965, an unorthodox and irreverent DJ named",67.0,Barry Levinson,"Good Morning, Vietnam",1987,121,USA, 13000000,123922370,123922370,0,110922370,1
22637,35.0,"Drama, History",A labor union organizer comes to an embattled mining community brutally and violently dominated and harassed by the mining company.,73.0,John Sayles,Matewan,1987,135,USA, 4000000,1680358,1680358,0,-2319642,0
22630,37.0,"Comedy, Fantasy, Romance","A young artist, searching for his vocation, makes a mannequin so perfect he falls in love with it. Finding the mannequin in a store window, he gets a job there and his creation comes to life.",21.0,Michael Gottlieb,Mannequin,1987,90,USA, 6000000,42721196,42721196,0,36721196,1
22467,43.0,"Adventure, Comedy, Family",Dodger must confront the struggles of life as he is visited by the Garbage Pail Kids and intimidated by some older bullies.,1.0,Rod Amateau,The Garbage Pail Kids Movie,1987,100,USA, 1000000,1576615,1576615,0,576615,1
22598,132.0,"Action, Crime, Thriller",Two newly paired cops who are complete opposites must put aside their differences in order to catch a gang of drug smugglers.,68.0,Richard Donner,Lethal Weapon,1987,109,USA, 15000000,65207127,120207127,55000000,105207127,1
22255,53.0,"Adventure, Comedy, Crime",A babysitter must battle her way through the big city after being stranded there with the kids she's looking after.,45.0,Chris Columbus,Adventures in Babysitting,1987,102,USA, 7000000,34368475,34368475,0,27368475,1
22588,24.0,"Biography, Drama, Music",Biographical story of the rise from nowhere of early rock and roll singer Ritchie Valens who died at age 17 in a plane crash with Buddy Holly and the Big Bopper.,65.0,Luis Valdez,La Bamba,1987,108,USA, 6500000,54215416,54215416,0,47715416,1
22562,93.0,"Adventure, Horror, Thriller",Chief Brody's widow believes that her family is deliberately being targeted by another shark in search of revenge.,15.0,Joseph Sargent,Jaws: The Revenge,1987,89,USA, 23000000,20763013,51881013,31118000,28881013,1
22554,50.0,"Action, Adventure, Comedy","Two terrible lounge singers get booked to play a gig in a Moroccan hotel but somehow become pawns in an international power play between the C.I.A., the Emir of Ishtar, and the rebels trying to overthrow his regime.",52.0,Elaine May,Ishtar,1987,107,USA, 55000000,14375181,14375181,0,-40624819,0
22520,21.0,Comedy,"An actor limited to stereotypical roles because of his ethnicity, dreams of making it big as a highly respected performer. As he makes his rounds, the film takes a satiric look at African American actors in Hollywood.",74.0,Robert Townsend,Hollywood Shuffle,1987,78,USA, 100000,5228617,5228617,0,5128617,1
22516,14.0,"Comedy, Drama, Romance",A stockbroker on the run from the mob decides to hide out from them by enrolling as a student in high school.,47.0,Bob Giraldi,Hiding Out,1987,98,USA, 7000000,7019441,7019441,0,19441,1
22544,77.0,"Action, Adventure, Comedy","A hapless store clerk must foil criminals to save the life of the man who, miniaturized in a secret experiment, was accidentally injected into him.",66.0,Joe Dante,Innerspace,1987,120,USA, 27000000,25893810,25893810,0,-1106190,0
22501,28.0,"Comedy, Family, Fantasy",The Henderson family adopt a friendly Sasquatch but have a hard time trying to keep the legend of 'Bigfoot' a secret.,42.0,William Dear,Harry and the Hendersons,1987,110,USA, 10000000,29760613,49998613,20238000,39998613,1
23410,78.0,"Horror, Thriller","Carol Anne is staying with her aunt in a high-rise building, where the supernatural forces haunting her make their return.",40.0,Gary Sherman,Poltergeist III,1988,98,USA, 10500000,14114488,14114488,0,3614488,1
23421,111.0,"Fantasy, Horror","After a tragic accident, a man conjures up a towering, vengeful demon called Pumpkinhead to destroy a group of unsuspecting teenagers.",47.0,Stan Winston,Pumpkinhead,1988,86,USA, 3500000,4385516,4385516,0,885516,1
23422,16.0,"Comedy, Drama, Romance",A medical school dropout and a housewife/mom try to make it as stand-up comedians. They become friends and help each other out at an NYC comedy club.,52.0,David Seltzer,Punchline,1988,128,USA, 15000000,21042667,21042667,0,6042667,1
23434,107.0,Drama,Selfish yuppie Charlie Babbitt's father left a fortune to his savant brother Raymond and a pittance to Charlie; they travel cross-country.,65.0,Barry Levinson,Rain Man,1988,133,USA, 25000000,172825435,354825435,182000000,329825435,1
23395,111.0,"Action, Fantasy, Horror","Mike, now released from a psychiatric hospital, continues his journey to stop the evil Tall Man from his grim work.",42.0,Don Coscarelli,Phantasm II,1988,97,USA, 3000000,7282851,7282851,0,4282851,1
23345,87.0,"Comedy, Crime",Incompetent police Detective Frank Drebin must foil an attempt to assassinate,76.0,David Zucker,The Naked Gun: From the Files of Police Squad!,1988,85,USA, 12000000,78756177,78756177,0,66756177,1
23363,129.0,Horror,"Freddy Krueger returns once again to terrorize the dreams of the remaining Dream Warriors, as well as those of a young woman who may be able to defeat him for good.",56.0,Renny Harlin,A Nightmare on Elm Street 4: The Dream Master,1988,93,USA, 13000000,49369899,49369899,0,36369899,1
23344,34.0,"Comedy, Drama, Romance",Three teenage girls come of age while working at a pizza parlor in the Connecticut town of Mystic.,60.0,Donald Petrie,Mystic Pizza,1988,104,USA, 6000000,12793213,12793213,0,6793213,1
23322,82.0,"Action, Comedy, Crime","An accountant is chased by bounty hunters, the F.B.I., and the Mafia after jumping bail.",78.0,Martin Brest,Midnight Run,1988,126,USA, 30000000,38413606,81613606,43200000,51613606,1
23329,62.0,"Crime, Drama, History",Two F.B.I. Agents with wildly different styles arrive in Mississippi to investigate the disappearance of some civil rights activists.,65.0,Alan Parker,Mississippi Burning,1988,128,USA, 15000000,34603943,34603943,0,19603943,1
23436,114.0,"Action, Adventure, Thriller",Rambo mounts a one-man mission to rescue his friend Colonel Trautman from the clutches of the formidable invading Soviet forces in Afghanistan.,36.0,Peter MacDonald,Rambo III,1988,102,USA, 63000000,53715611,189015611,135300000,126015611,1
23371,75.0,"Animation, Adventure, Comedy",A lost and alone kitten joins a gang of dogs engaged in petty larceny in New York City.,58.0,George Scribner,Oliver & Company,1988,74,USA, 31000000,74151346,74151346,0,43151346,1
23332,68.0,"Drama, Horror, Sci-Fi","A quadriplegic man has a trained monkey help him with his paralysis, until the little monkey begins to develop feelings, and rage, against its new master.",71.0,George A. Romero,Monkey Shines,1988,113,USA, 7000000,5344577,5344577,0,-1655423,0
23453,45.0,"Crime, Drama, Music",The eldest son of a fugitive family comes of age and wants to live a life of his own.,67.0,Sidney Lumet,Running on Empty,1988,116,USA, 7000000,2835116,2847941,12825,-4152059,0
23309,37.0,"Comedy, Crime, Romance","An undercover FBI agent falls in love with a recently widowed mafia wife, who is trying to restart her life following her husband's murder while being pursued by a libidinous mafia kingpin seeking to claim her for himself.",71.0,Jonathan Demme,Married to the Mob,1988,104,USA, 10000000,21486757,21486757,0,11486757,1
23872,124.0,"Comedy, Crime","In order to get out of the snobby clique that is destroying her good-girl reputation, an intelligent teen teams up with a dark sociopath in a plot to kill the cool kids.",72.0,Michael Lehmann,Heathers,1988,103,USA, 3000000,1108462,1163969,55507,-1836031,0
24242,51.0,"Comedy, Horror","After an encounter with a neck-biter, a publishing executive thinks that he's turning into a vampire.",31.0,Robert Bierman,Vampire's Kiss,1988,103,USA, 2000000,725131,725131,0,-1274869,0
23605,42.0,"Action, Western","A group of young gunmen, led by Billy the Kid, become deputies to avenge the murder of the rancher who became their benefactor. But when Billy takes their authority too far, they become the hunted.",50.0,Christopher Cain,Young Guns,1988,107,USA, 13000000,45661556,45661556,0,32661556,1
23594,52.0,"Comedy, Drama, Romance","When a secretary's idea is stolen by her boss, she seizes an opportunity to steal it back by pretending she has her boss' job.",73.0,Mike Nichols,Working Girl,1988,113,USA, 28000000,63779477,102956984,39177507,74956984,1
23588,107.0,"Action, Adventure, Drama",A reluctant dwarf must play a critical role in protecting a special baby from an evil queen.,47.0,Ron Howard,Willow,1988,126,USA, 35000000,57269863,57269863,0,22269863,1
23586,131.0,"Animation, Adventure, Comedy",A toon-hating detective is a cartoon rabbit's only hope to prove his innocence when he is accused of murder.,83.0,Robert Zemeckis,Who Framed Roger Rabbit,1988,104,USA, 70000000,156452370,329803958,173351588,259803958,1
23553,58.0,"Drama, Romance","In 1968, a Czech doctor with an active sex life meets a woman who wants monogamy, and then the Soviet invasion further disrupts their lives.",73.0,Philip Kaufman,The Unbearable Lightness of Being,1988,171,USA, 17000000,10006806,10006806,0,-6993194,0
23549,38.0,"Comedy, Crime","A physically perfect but innocent man goes in search of his long-lost twin brother, who is short, a womanizer, and small-time crook.",53.0,Ivan Reitman,Twins,1988,107,USA, 15000000,111938388,216614388,104676000,201614388,1
23447,80.0,"Comedy, Horror, Sci-Fi","Curious kids unearth the barrels that previously helped revive the dead, which proves the second time's an undead charm.",45.0,Ken Wiederhorn,Return of the Living Dead: Part II,1988,89,USA, 6200000,9205924,9205924,0,3005924,1
23546,32.0,"Biography, Drama","The story of Preston Tucker, the maverick car designer and his ill-fated challenge to the auto industry with his revolutionary car concept.",74.0,Francis Ford Coppola,Tucker: The Man and His Dream,1988,110,USA, 23000000,19652638,19652638,0,-3347362,0
23523,34.0,"Crime, Drama, Romance","A former L.A. drug dealer tries to go straight but his past and his underworld connections bring him into the focus of the DEA, the Mexican feds and the Mexican drug cartels.",62.0,Robert Towne,Tequila Sunrise,1988,115,USA, 23000000,41292551,41292551,0,18292551,1
23474,19.0,"Comedy, Drama, Romance",Young newlyweds find out just how unprepared they are for their future together.,41.0,John Hughes,She's Having a Baby,1988,106,USA, 20000000,16031707,16031707,0,-3968293,0
23467,116.0,"Fantasy, Horror",An anthropologist goes to Haiti after hearing rumors about a drug used by black magic practitioners to turn people into zombies.,64.0,Wes Craven,The Serpent and the Rainbow,1988,98,USA, 7000000,19595031,19595031,0,12595031,1
23466,115.0,"Comedy, Drama, Fantasy","A selfish, cynical television executive is haunted by three spirits bearing lessons on Christmas Eve.",38.0,Richard Donner,Scrooged,1988,101,USA, 32000000,60328558,60328558,0,28328558,1
23463,23.0,"Comedy, Drama, Musical",A not so popular young man wants to pledge to a popular fraternity at his historically black college.,49.0,Spike Lee,School Daze,1988,121,USA, 6500000,14545844,14545844,0,8045844,1
23528,196.0,"Action, Horror, Sci-Fi",A drifter discovers a pair of sunglasses that allow him to wake up to the fact that aliens have taken over the Earth.,54.0,John Carpenter,They Live,1988,94,USA, 4000000,13008928,13008928,0,9008928,1
23307,203.0,"Action, Crime, Horror",A killer dressed in a police uniform begins murdering innocent people on the streets of New York City.,40.0,William Lustig,Maniac Cop,1988,85,USA, 1100000,671382,671382,0,-428618,0
23025,85.0,"Comedy, Romance, Sport",A fan who has an affair with one minor-league baseball player each season meets an up-and-coming pitcher and the experienced catcher assigned to him.,73.0,Ron Shelton,Bull Durham,1988,108,USA, 7000000,50888729,50888729,0,43888729,1
23060,44.0,"Action, Crime, Drama",An experienced cop and his rookie partner patrol the streets of East Los Angeles while trying to keep the gang violence under control.,66.0,Dennis Hopper,Colors,1988,120,USA, 6000000,46616067,46616067,0,40616067,1
23059,12.0,"Adventure, Comedy, Mystery","The old age pensioners that left at the end of the first film come back to Earth to visit their relatives. Will they all decide to go back to the planet where no one grows old, or will they be tempted to stay back on Earth?",45.0,Daniel Petrie,Cocoon: The Return,1988,116,USA, 17500000,18924919,25024919,6100000,7524919,1
23058,58.0,"Comedy, Drama, Romance",A talented New York City bartender takes a job at a bar in Jamaica and falls in love.,12.0,Roger Donaldson,Cocktail,1988,104,USA, 20000000,78222753,171504781,93282028,151504781,1
23049,121.0,"Horror, Thriller","A single mother gives her son a much sought-after doll for his birthday, only to discover that it is possessed by the soul of a serial killer.",58.0,Tom Holland,Child's Play,1988,87,USA, 9000000,33244684,44196684,10952000,35196684,1
23031,10.0,"Comedy, Sport","When a crass new-money tycoon's membership application is turned down at a snooty country club, he retaliates by buying the club and turning it into a tacky amusement park.",7.0,Allan Arkush,Caddyshack II,1988,98,USA, 20000000,11798302,11798302,0,-8201698,0
23003,31.0,"Biography, Drama, Music","The troubled life and career of jazz musician Charlie ""Bird"" Parker (Forest Whitaker).",78.0,Clint Eastwood,Bird,1988,161,USA, 9000000,2181286,2181286,0,-6818714,0
23002,27.0,"Comedy, Drama","A group of young recruits go through boot camp during the Second World War in Biloxi, Mississippi. From the play by Neil Simon.",61.0,Mike Nichols,Biloxi Blues,1988,106,USA, 20000000,43184798,51684798,8500000,31684798,1
22998,105.0,"Comedy, Drama, Fantasy","After wishing to be made big, a teenage boy wakes the next morning to find himself mysteriously in the body of an adult.",73.0,Penny Marshall,Big,1988,104,USA, 18000000,114968774,151668774,36700000,133668774,1
23062,67.0,"Comedy, Romance","An extremely pampered African Prince travels to Queens, New York, and goes undercover to find a wife that he can respect for her intelligence and will.",47.0,John Landis,Coming to America,1988,116,USA, 39000000,128152301,288752301,160600000,249752301,1
22994,120.0,"Comedy, Fantasy","The spirits of a deceased couple are harassed by an unbearable family that has moved into their home, and hire a malicious spirit to drive them out.",70.0,Tim Burton,Beetlejuice,1988,92,USA, 15000000,74220408,74270074,49666,59270074,1
22959,50.0,"Action, Sci-Fi","In 1988, Earth makes the first contact with an alien civilization. In 1991, these aliens, known as Newcomers, slowly begin to be integrated into human society after three years of quarantine.",45.0,Graham Baker,Alien Nation,1988,91,USA, 16000000,25216243,32155047,6938804,16155047,1
22953,46.0,"Action, Comedy, Crime",Vengence drives a tough Detroit cop to stay on the trail of a power hungry auto magnate who's systematically eliminating his competition.,36.0,Craig R. Baxley,Action Jackson,1988,96,USA, 7000000,20256975,20256975,0,13256975,1
22319,84.0,"Action, Biography, Drama","Follows Frank Dux, an American martial artist serving in the military, who decides to leave the army to compete in a martial arts tournament in Hong Kong where fights to the death can occur.",29.0,Newt Arnold,Bloodsport,1988,92,USA, 1100000,11806119,11806119,0,10706119,1
22949,49.0,"Action, Crime, Drama","A former Special Operations Vietnam vet works as a Chicago cop, and uncovers C.I.A. wrongdoing.",45.0,Andrew Davis,Above the Law,1988,99,USA, 7500000,18869631,18869631,0,11369631,1
22990,37.0,"Comedy, Drama, Music","A privileged rich debutante and a cynical struggling entertainer share a turbulent, but strong childhood friendship over the years.",46.0,Garry Marshall,Beaches,1988,123,USA, 20000000,57041866,57041866,0,37041866,1
23024,33.0,Drama,A disillusioned young writer living in New York City turns to drugs and drinking to block out the memories of his dead mother and estranged wife.,51.0,James Bridges,"Bright Lights, Big City",1988,107,USA, 25000000,16118077,16118077,0,-8881923,0
23287,34.0,Comedy,A teen decides to go for a night on the town with his friends despite flunking his driver's test.,36.0,Greg Beeman,License to Drive,1988,88,USA, 8000000,22433275,22433275,0,14433275,1
23278,175.0,"Fantasy, Horror, Mystery","An author tells the story of how, as a young boy growing up in a 1960s small town, he was haunted after witnessing the murder of a little girl.",70.0,Frank LaLoggia,Lady in White,1988,113,USA, 4700000,1705139,1705139,0,-2994861,0
23250,13.0,"Comedy, Sport","Johnny's the top high school football player and many colleges want him. His girlfriend, coach and BFF want him in the college serving themselves most.",10.0,Bud S. Smith,Johnny Be Good,1988,91,USA, 22000000,17550399,17550399,0,-4449601,0
23070,49.0,"Comedy, Horror, Sci-Fi","Eggs of the small, furry alien carnivores are left behind on Earth and, after hatching, again set their appetites on the town of Grover's Bend.",48.0,Mick Garris,Critters 2,1988,86,USA, 4500000,3813293,3813293,0,-686707,0
23195,160.0,"Horror, Thriller","Ten years after his original massacre, the invalid Michael Myers awakens on Halloween Eve and returns to Haddonfield to kill his seven-year-old niece. Can Dr. Loomis stop him?",34.0,Dwight H. Little,Halloween 4: The Return of Michael Myers,1988,88,USA, 5000000,17768757,17768757,0,12768757,1
23194,47.0,"Comedy, Drama, Family",A 'pleasantly plump' teenager teaches 1962 Baltimore a thing or two about integration after landing a spot on a local TV dance show.,77.0,John Waters,Hairspray,1988,92,USA, 2000000,6671108,6671108,0,4671108,1
23189,23.0,Comedy,A Chicago man's hope for a peaceful family vacation in the woods is shattered when the annoying in-laws drop in.,24.0,Howard Deutch,The Great Outdoors,1988,91,USA, 24000000,41455230,43455230,2000000,19455230,1
23227,32.0,"Action, Comedy, Crime","In this parody of blaxploitation movies, a black hero wannabe reunites former black heroes from the 70s to help him get revenge on Mr. Big.",48.0,Keenen Ivory Wayans,I'm Gonna Git You Sucka,1988,88,USA, 3000000,13030057,13030057,0,10030057,1
23165,141.0,"Horror, Thriller","Years after Tommy Jarvis chained him underwater at Camp Crystal Lake, the dormant Jason Voorhees is accidentally released from his prison by a telekinetic teenager. Now, only she can stop him.",13.0,John Carl Buechler,Friday the 13th Part VII: The New Blood,1988,88,USA, 2800000,19170001,19170001,0,16370001,1
23095,51.0,"Action, Crime, Mystery","Inspector ""Dirty"" Harry Callahan must stop a sick secret contest to murder local celebrities, which includes himself as a target.",46.0,Buddy Van Horn,The Dead Pool,1988,91,USA, 31000000,37903295,37903295,0,6903295,1
23171,25.0,"Comedy, Drama","A couple swap city life for the country, but their picturesque new hometown turns out to be just a little bit different to what they were expecting.",50.0,George Roy Hill,Funny Farm,1988,101,USA, 19000000,25537221,25537221,0,6537221,1
23129,45.0,"Drama, History, Sport",A dramatization of the Black Sox scandal when the underpaid Chicago White Sox accepted bribes to deliberately lose the 1919 World Series.,71.0,John Sayles,Eight Men Out,1988,119,USA, 6000000,5680515,5680515,0,-319485,0
23132,60.0,"Comedy, Horror","Upon arriving in a small town where she has inherited a rundown mansion, a famous horror hostess battles an evil uncle, and townspeople who want her burned at the stake.",43.0,James Signorelli,Elvira: Mistress of the Dark,1988,96,USA, 7500000,5596267,5596267,0,-1903733,0
23110,283.0,"Action, Thriller",An NYPD officer tries to save his wife and several others taken hostage by German terrorists during a Christmas party at the Nakatomi Plaza in Los Angeles.,72.0,John McTiernan,Die Hard,1988,132,USA, 28000000,83519093,141482154,57963061,113482154,1
23138,22.0,"Comedy, Family, Fantasy",Ernest helps Santa Claus as he searches for his successor.,44.0,John R. Cherry III,Ernest Saves Christmas,1988,95,USA, 6000000,28202109,28202109,0,22202109,1
24069,113.0,"Horror, Thriller","After tragedy strikes, a grieving father discovers an ancient burial ground behind his home with the power to raise the dead.",38.0,Mary Lambert,Pet Sematary,1989,103,USA, 11500000,57469467,57469467,0,45969467,1
24064,47.0,"Comedy, Drama","The Buckmans are a midwestern family all dealing with their lives: estranged relatives, raising children, pressures of the job, and learning to be a good parent and spouse.",82.0,Ron Howard,Parenthood,1989,124,USA, 20000000,100047830,126297830,26250000,106297830,1
24055,22.0,"Action, Crime, Drama","Experienced Green Beret sergeant Johnny Gallagher is escorting a prisoner, Airborne Ranger Thomas Boyette, back to the US, but Boyette escapes and Gallagher must risk life and limb to catch him.",55.0,Andrew Davis,The Package,1989,108,USA, 18000000,10647219,10647219,0,-7352781,0
24037,40.0,"Action, Sport","Rip is the World Wrestling Federation champion who is faithful to his fans and the network he wrestles for. Brell, the new head of the World Television Network, wants Rip to wrestle for his...",31.0,Thomas J. Wright,No Holds Barred,1989,93,USA, 8000000,16093651,16093651,0,8093651,1
24034,104.0,"Fantasy, Horror","The pregnant Alice finds Freddy Krueger striking through the sleeping mind of her unborn child, hoping to be reborn into the real world.",54.0,Stephen Hopkins,A Nightmare on Elm Street: The Dream Child,1989,89,USA, 6000000,22168359,22168359,0,16168359,1
24030,27.0,"Action, Crime, Thriller","Truman, a Chicago cop, sets out to find the killer of his brother. Meanwhile, another of his brothers, Briar (a hillbilly) decides to find the killer himself.",53.0,John Irvin,Next of Kin,1989,108,USA, 12000000,15942628,15942628,0,3942628,1
24027,106.0,Comedy,The Griswold family's plans for a big family Christmas predictably turn into a big disaster.,49.0,Jeremiah S. Chechik,National Lampoon's Christmas Vacation,1989,97,USA, 27000000,71319526,71319526,0,44319526,1
23982,65.0,"Comedy, Sport","The new owner of the Cleveland Indians puts together a purposely horrible team so they'll lose and she can move the team. But when the plot is uncovered, they start winning just to spite her.",62.0,David S. Ward,Major League,1989,107,USA, 11000000,49797148,49797148,0,38797148,1
24077,22.0,"Comedy, Crime",Those bumbling cadets take to the streets when three inept goons successfully orchestrate a metropolitan crime wave.,16.0,Peter Bonerz,Police Academy 6: City Under Siege,1989,84,USA, 12000000,11567217,11567217,0,-432783,0
23971,24.0,Comedy,"After a single, career-minded woman is left on her own to give birth to the child of a married man, she finds a new romantic chance in a cab driver. Meanwhile, the point-of-view of the newborn boy is narrated through voice-over.",51.0,Amy Heckerling,Look Who's Talking,1989,93,USA, 7500000,140088813,296999813,156911000,289499813,1
23969,65.0,"Action, Crime, Drama","With only six months left of his sentence, inmate Frank Leone is transferred from a minimum security prison to a maximum security prison by a vindictive warden.",52.0,John Flynn,Lock Up,1989,109,USA, 24000000,22099847,22099847,0,-1900153,0
23956,11.0,"Comedy, Action","A nosy cab driver gets a hot tip on a race horse and wins big, but he can't seem to stop gambling. Will he go broke or walk home with a pretty penny?",33.0,Joe Pytka,Let It Ride,1989,90,USA, 18000000,4973285,4973285,0,-13026715,0
23964,145.0,"Animation, Family, Fantasy",A mermaid princess makes a Faustian bargain in an attempt to become human and win a prince's love.,88.0,"Ron Clements, John Musker",The Little Mermaid,1989,83,USA, 40000000,111543479,274176364,162632885,234176364,1
23957,91.0,"Action, Crime, Thriller",Riggs and Murtaugh are on the trail of South African diplomats who are using their immunity to engage in criminal activities.,70.0,Richard Donner,Lethal Weapon 2,1989,114,USA, 28000000,147253986,227853986,80600000,199853986,1
24110,78.0,"Action, Thriller",A tough bouncer is hired to tame a dirty bar.,36.0,Rowdy Herrington,Road House,1989,114,USA, 17000000,30050028,30050028,0,13050028,1
23952,15.0,Drama,The dedicated but tyrannical Joe Clark is appointed the principal of a decaying inner-city school and he is determined to improve by any and all means.,58.0,John G. Avildsen,Lean on Me,1989,108,USA, 10000000,31906454,31906454,0,21906454,1
24287,68.0,Drama,A sexually repressed woman's husband is having an affair with her sister. The arrival of a visitor with a rather unusual fetish changes everything.,86.0,Steven Soderbergh,"Sex, Lies, and Videotape",1989,100,USA, 1200000,24741667,24741667,0,23541667,1
24262,139.0,"Comedy, Drama, Romance","Harry and Sally have known each other for years, and are very good friends, but they fear sex would ruin the friendship.",76.0,Rob Reiner,When Harry Met Sally...,1989,95,USA, 16000000,92823546,92831124,7578,76831124,1
24256,45.0,"Comedy, Romance",A married couple try everything to get each other to leave the house in a vicious divorce battle.,79.0,Danny DeVito,The War of the Roses,1989,116,USA, 26000000,86888546,160188546,73300000,134188546,1
24237,51.0,Comedy,Bachelor and all-round slob Buck babysits his brother's rebellious teenage daughter and her cute younger brother and sister.,51.0,John Hughes,Uncle Buck,1989,100,USA, 15000000,66758538,79258538,12500000,64258538,1
24235,64.0,"Comedy, Drama","An unemployed visionary becomes the manager of a local public station. The station becomes a success, with all sorts of hilarious sight gags and wacky humor.",32.0,Jay Levey,UHF,1989,97,USA, 5000000,6157157,6157157,0,1157157,1
24104,80.0,"Action, Adventure, Comedy","The Swamp Thing returns to battle the evil Dr. Arcane, who has a new science lab full of creatures transformed by genetic mutation, and chooses Heather Locklear as his new object of ...",39.0,Jim Wynorski,The Return of Swamp Thing,1989,88,USA, 4000000,192816,192816,0,-3807184,0
24233,30.0,"Comedy, Crime, Drama",A detective must adopt the dog of a dead man to help him find the murderer.,36.0,Roger Spottiswoode,Turner & Hooch,1989,97,USA, 13000000,71079915,71079915,0,58079915,1
24212,16.0,"Action, Comedy","A reformed bank robber is taken hostage by a desperate man during a bank hold up, but is forced to go on the run with his captor when they're both mistakenly thought to be in cahoots.",40.0,Francis Veber,Three Fugitives,1989,96,USA, 15000000,40586886,40586886,0,25586886,1
24202,59.0,"Action, Comedy, Crime","Framed by their ruthless arch-nemesis, a mismatched LAPD crime-fighting duo has to put its differences aside to even the score with the evil kingpin who put them behind bars once and for all.",41.0,"Andrey Konchalovskiy, Albert Magnoli",Tango & Cash,1989,104,USA, 55000000,63408614,63408614,0,8408614,1
24181,39.0,"Comedy, Drama, Romance","A young beautician, newly arrived in a small Louisiana town, finds work at the local salon, where a small group of women share a close bond of friendship, and welcome her into the fold.",56.0,Herbert Ross,Steel Magnolias,1989,117,USA, 15000000,84614512,96759512,12145000,81759512,1
24179,74.0,"Action, Adventure, Fantasy",Captain Kirk and his crew must deal with Mr. Spock's long-lost half-brother who hijacks the Enterprise for an obsessive search for God at the center of the galaxy.,43.0,William Shatner,Star Trek V: The Final Frontier,1989,107,USA, 27800000,52210049,52210049,0,24410049,1
24152,100.0,"Comedy, Horror, Thriller","After being sent to the electric chair, a serial killer uses electricity to come back from the dead and carry out his vengeance on the football player who turned him in to the police.",51.0,Wes Craven,Shocker,1989,109,USA, 5000000,16554699,16554699,0,11554699,1
24140,35.0,"Comedy, Crime","Dave is deaf, and Wally is blind. They witness a murder, but it was Dave who was looking at her, and Wally who was listening.",44.0,Arthur Hiller,"See No Evil, Hear No Evil",1989,103,USA, 18000000,46908987,46908987,0,28908987,1
24225,11.0,"Adventure, Comedy","A soon to be divorced Beverly Hills socialite is determined to prove to her husband and herself that she can finish what she starts out to do, by becoming a den mother to a troop of Beverly Hills Girl Scouts.",32.0,Jeff Kanew,Troop Beverly Hills,1989,105,USA, 18000000,8508843,8508843,0,-9491157,0
23927,18.0,"Action, Crime, Drama",A young detective becomes involved with a beautiful woman on the run from the mob and her psychopath boyfriend.,61.0,John Dahl,Kill Me Again,1989,94,USA, 4000000,283694,283694,0,-3716306,0
23898,160.0,"Action, Adventure","In 1938, after his father Professor Henry Jones, Sr. goes missing while pursuing the Holy Grail, Professor Henry ""Indiana"" Jones, Jr. finds himself up against",65.0,Steven Spielberg,Indiana Jones and the Last Crusade,1989,127,USA, 48000000,197171806,474310887,277139081,426310887,1
23917,13.0,"Action, Comedy, Crime","To stop an elusive criminal, a maverick detective enlists the aid of a police dog who's an unusually intelligent smart alec.",44.0,Rod Daniel,K-9,1989,101,USA, 17000000,43247647,78247647,35000000,61247647,1
23752,101.0,"Comedy, Drama",An ophthalmologist's mistress threatens to reveal their affair to his wife while a married documentary filmmaker is infatuated with another woman.,77.0,Woody Allen,Crimes and Misdemeanors,1989,104,USA, 19000000,18254702,18254702,0,-745298,0
23726,19.0,"Comedy, Fantasy, Romance","A reincarnated man unknowingly falls in love with his own daughter from his previous life. Once he realizes this, he tries to end their relationship before angels erase his memory.",62.0,Emile Ardolino,Chances Are,1989,108,USA, 16000000,16278590,16278590,0,278590,1
23720,83.0,"Crime, Drama, War","During the Vietnam War, a soldier finds himself the outsider of his own squad when they unnecessarily kidnap a female villager.",75.0,Brian De Palma,Casualties of War,1989,113,USA, 22500000,18671317,18671317,0,-3828683,0
23705,74.0,"Biography, Drama, War","The biography of Ron Kovic. Paralyzed in the Vietnam war, he becomes an anti-war and pro-human rights political activist after feeling betrayed by the country he fought for.",75.0,Oliver Stone,Born on the Fourth of July,1989,145,USA, 14000000,70001698,161001698,91000000,147001698,1
23688,73.0,"Action, Crime, Thriller",Two NYC cops arrest a Yakuza member and must escort him when he's extradited to Japan.,56.0,Ridley Scott,Black Rain,1989,125,USA, 30000000,46212055,134212055,88000000,104212055,1
23686,99.0,"Adventure, Comedy, Music",Two seemingly dumb teens set off on a quest to prepare the ultimate historical presentation with the help of a time machine.,44.0,Stephen Herek,Bill & Ted's Excellent Adventure,1989,90,USA, 10000000,40485039,40485039,0,30485039,1
23685,28.0,"Comedy, Drama, Romance","Film school grad Nick Chapman thought his career was made after his award winning short film, but discovered Hollywood wasn't as easy as it seems.",64.0,Christopher Guest,The Big Picture,1989,100,USA, 5000000,117463,117463,0,-4882537,0
23665,144.0,"Adventure, Comedy, Sci-Fi","After visiting 2015, Marty McFly must repeat his visit to 1955 to prevent disastrous changes to 1985...without interfering with his first trip.",57.0,Robert Zemeckis,Back to the Future Part II,1989,108,USA, 40000000,119000002,335881828,216881826,295881828,1
23926,51.0,"Action, Sport, Thriller",Kurt Sloane must learn the ancient kick boxing art of Muay Thai in order to avenge his brother.,33.0,"Mark DiSalle, David Worth",Kickboxer,1989,97,USA, 1500000,14697005,14697005,0,13197005,1
23623,110.0,"Comedy, Mystery, Thriller",An overstressed suburbanite and his fellow neighbors are convinced that the new family on the block are part of a murderous Satanic cult.,45.0,Joe Dante,The 'Burbs,1989,102,USA, 18000000,36601993,49101993,12500000,31101993,1
23631,99.0,"Adventure, Drama, Mystery",A civilian diving team is enlisted to search for a lost nuclear submarine and face danger while encountering an alien aquatic species.,62.0,James Cameron,The Abyss,1989,145,USA, 70000000,54461047,90000098,35539051,20000098,1
23642,43.0,"Fantasy, Romance",The spirit of a recently deceased expert pilot mentors a newer pilot while watching him fall in love with the girlfriend that he left behind.,50.0,Steven Spielberg,Always,1989,122,USA, 31000000,43858790,74134790,30276000,43134790,1
23766,103.0,"Comedy, Drama",English teacher John Keating inspires his students to look at poetry with a different perspective of authentic knowledge and feelings.,79.0,Peter Weir,Dead Poets Society,1989,128,USA, 16400000,95860116,235860116,140000000,219460116,1
23869,24.0,"Comedy, Crime, Drama","During the 1930s, a New York City illegal gambling house owner and his associates must deal with strong competition, gangsters, and corrupt cops in order to stay in business.",16.0,Eddie Murphy,Harlem Nights,1989,116,USA, 30000000,60864870,60864870,0,30864870,1
23866,162.0,"Horror, Thriller",One year after the events of,28.0,Dominique Othenin-Girard,Halloween 5: The Revenge of Michael Myers,1989,96,USA, 5000000,11642254,11642254,0,6642254,1
23858,68.0,"Biography, Drama, History","Robert Gould Shaw leads the U.S. Civil War's first all-black volunteer company, fighting prejudices from both his own Union Army, and the Confederates.",78.0,Edward Zwick,Glory,1989,122,USA, 18000000,26979166,26979166,0,8979166,1
23856,16.0,"Action, Drama, Mystery",A young avid skateboarder uncovers a government conspiracy while investigating his adoptive brother's mysterious death.,40.0,Graeme Clifford,Gleaming the Cube,1989,100,USA, 10000000,2777280,2777280,0,-7222720,0
23853,121.0,"Action, Comedy, Fantasy",The discovery of a massive river of ectoplasm and a resurgence of spectral activity allows the staff of Ghostbusters to revive the business.,56.0,Ivan Reitman,Ghostbusters II,1989,108,USA, 37000000,112494738,215394738,102900000,178394738,1
23817,34.0,"Comedy, Drama, Music","The lives of two struggling musicians, who happen to be brothers, inevitably change when they team up with a beautiful, up-and-coming singer.",85.0,Steve Kloves,The Fabulous Baker Boys,1989,114,USA, 13000000,18428904,18428904,0,5428904,1
23791,43.0,"Crime, Drama",A pharmacy-robbing dope fiend and his crew pop pills and evade the law.,82.0,Gus Van Sant,Drugstore Cowboy,1989,101,USA, 2500000,4729352,4729352,0,2229352,1
23790,63.0,Drama,An old Jewish woman and her African-American chauffeur in the American South have a relationship that grows and improves over the years.,81.0,Bruce Beresford,Driving Miss Daisy,1989,99,USA, 7500000,106593296,145793296,39200000,138293296,1
23788,19.0,"Comedy, Crime, Thriller","Four mental patients on a field trip in New York City must save their caring chaperon, who ends up being taken to a hospital in a coma after accidentally witnessing a murder, before the killers can find him and finish the job.",54.0,Howard Zieff,The Dream Team,1989,113,USA, 15000000,28890240,28890240,0,13890240,1
23773,36.0,"Action, Horror, Sci-Fi","At the bottom of the ocean, the DeepStar Six has just discovered a new and deadly alien menace.",34.0,Sean S. Cunningham,DeepStar Six,1989,105,USA, 8000000,8143225,8143225,0,143225,1
23832,31.0,"Comedy, Crime, Mystery","After receiving an inheritance in Louisiana, Los Angeles reporter Irvin Fletcher heads to the Belle Isle plantation where he gets himself into hilarious trouble.",40.0,Michael Ritchie,Fletch Lives,1989,95,USA, 8000000,35150960,39450960,4300000,31450960,1
23783,90.0,"Comedy, Drama","On the hottest day of the year on a street in the Bedford-Stuyvesant section of Brooklyn, everyone's hate and bigotry smolders and builds until it explodes into violence.",92.0,Spike Lee,Do the Right Thing,1989,120,USA, 6500000,27545445,37313222,9767777,30813222,1
24737,151.0,"Action, Horror, Sci-Fi","Amidst a territorial gang war in 1997, a sophisticated alien hunter stalks the citizens of Los Angeles and the only man between him and his prey is veteran L.A.P.D. officer, Lieutenant Mike Harrigan.",46.0,Stephen Hopkins,Predator 2,1990,108,USA, 35000000,30669413,57120318,26450905,22120318,1
24735,47.0,"Comedy, Drama",A substance-addicted actress tries to look on the bright side even as she is forced to move back in with her mother to avoid unemployment.,71.0,Mike Nichols,Postcards from the Edge,1990,101,USA, 22000000,39071603,39071603,0,17071603,1
24713,30.0,Thriller,"A couple work hard to renovate their dream house and become landlords to pay for it. Unfortunately, one of their tenants has plans of his own.",55.0,John Schlesinger,Pacific Heights,1990,102,USA, 18000000,29381956,44926706,15544750,26926706,1
24693,111.0,Horror,The unburied dead return to life and seek human victims.,54.0,Tom Savini,Night of the Living Dead,1990,92,USA, 4200000,5835247,5835247,0,1635247,1
24658,31.0,"Comedy, Drama, Romance","An unconventional single mother relocates with her two daughters to a small Massachusetts town in 1963, where a number of events and relationships both challenge and strengthen their familial bonds.",56.0,Richard Benjamin,Mermaids,1990,110,USA, 20000000,35419397,35419397,0,15419397,1
24667,157.0,"Drama, Thriller","After a famous author is rescued from a car crash by a fan of his novels, he comes to realize that the care he is receiving is only the beginning of a nightmare of captivity and abuse.",75.0,Rob Reiner,Misery,1990,107,USA, 20000000,61276872,61276872,0,41276872,1
24663,150.0,"Crime, Drama, Thriller","Tom Regan, an advisor to a Prohibition-era crime boss, tries to keep the peace between warring mobs but gets caught in divided loyalties.",66.0,"Joel Coen, Ethan Coen",Miller's Crossing,1990,115,USA, 14000000,5080409,5080409,0,-8919591,0
24650,47.0,"Action, Adventure, Crime",A retired DEA agent is out to hunt down and take out a Jamaican drug posse that has targeted he and his family for murder.,49.0,Dwight H. Little,Marked for Death,1990,93,USA, 12000000,46044396,57968936,11924540,45968936,1
24622,44.0,"Action, Crime, Drama",An Ex-French Soldier begins participating in underground street fights in order to make money for his brother's family.,41.0,Sheldon Lettich,Lionheart,1990,108,USA, 6000000,24078196,24271196,193000,18271196,1
24614,84.0,"Horror, Thriller",A California couple and a survivalist encounter Leatherface and his family.,30.0,Jeff Burr,Leatherface: Texas Chainsaw Massacre III,1990,85,USA, 2000000,5765562,5765562,0,3765562,1
24738,36.0,"Mystery, Thriller","As a lawyer investigates the murder of a colleague, he finds himself more connected to the crime than anyone else.",72.0,Alan J. Pakula,Presumed Innocent,1990,127,USA, 22000000,86303188,221303188,135000000,199303188,1
24670,29.0,"Drama, Music, Romance",Jazz trumpeter Bleek Gilliam makes questionable decisions in his professional and romantic lives.,61.0,Spike Lee,Mo' Better Blues,1990,129,USA, 10000000,16153593,16153593,0,6153593,1
24739,84.0,"Comedy, Romance","A man in a legal but hurtful business needs an escort for some social events, and hires a beautiful prostitute he meets... only to fall in love.",51.0,Garry Marshall,Pretty Woman,1990,119,USA, 14000000,178406268,463406268,285000000,449406268,1
24750,48.0,"Comedy, Crime","Three thieves successfully rob a New York City bank, but making the escape from the city proves to be almost impossible.",56.0,"Howard Franklin, Bill Murray",Quick Change,1990,89,USA, 15000000,15260154,15260154,0,260154,1
25478,66.0,"Comedy, Drama","A day in the life of Austin, Texas as the camera roams from place to place and provides a brief look at the overeducated, the social misfits, the outcasts and the oddballs.",69.0,Richard Linklater,Slacker,1990,97,USA, 23000,1228108,1228108,0,1205108,1
24927,26.0,"Action, Western","In 1881, cattle baron John Chisum pays a bounty to Patrick Floyd Garrett to kill outlaw Billy the Kid.",47.0,Geoff Murphy,Young Guns II,1990,104,USA, 20000000,44143410,44143410,0,24143410,1
24910,124.0,"Comedy, Crime, Drama",Young lovers Sailor and Lula run from the variety of weirdos that Lula's mom has hired to kill Sailor.,52.0,David Lynch,Wild at Heart,1990,125,USA, 9500000,14560247,14560247,0,5060247,1
24880,35.0,"Crime, Drama, Mystery",The sequel to,56.0,Jack Nicholson,The Two Jakes,1990,137,USA, 19000000,10005969,10005969,0,-8994031,0
24743,15.0,"Comedy, Family",A young boy is just short of a monster. He is adopted by a loving man and his wacky wife. The laughs keep coming as the boy pushes them to the limits.,27.0,Dennis Dugan,Problem Child,1990,81,USA, 10000000,53470891,72270891,18800000,62270891,1
24874,163.0,"Comedy, Horror",Natives of a small isolated town defend themselves against strange underground creatures which are killing them one by one.,65.0,Ron Underwood,Tremors,1990,96,USA, 11000000,16667084,16667084,0,5667084,1
24776,75.0,"Drama, Sport","Reluctantly retired from boxing, and back from riches to rags, Rocky takes on a new protege who betrays him, as the champ's son must adjust to his family's new life after bankruptcy.",55.0,John G. Avildsen,Rocky V,1990,104,USA, 42000000,40946358,119946358,79000000,77946358,1
24772,108.0,"Action, Crime, Sci-Fi","Cyborg law enforcer RoboCop returns to protect the citizens of old Detroit but faces a deadly challenge when a rogue OCP member secretly creates a new, evil RoboCop 2.",42.0,Irvin Kershner,RoboCop 2,1990,117,USA, 35000000,45681173,45681173,0,10681173,1
24764,37.0,"Animation, Adventure, Crime","The R.A.S. agents, Miss Bianca and Bernard, race to Australia to save a little boy and a rare golden eagle from a murderous poacher.",70.0,"Hendel Butoy, Mike Gabriel",The Rescuers Down Under,1990,77,USA, 30000000,27931461,27931461,0,-2068539,0
24850,60.0,"Comedy, Fantasy, Horror",A young boy tells three stories of horror to distract a witch who plans to eat him.,54.0,John Harrison,Tales from the Darkside: The Movie,1990,93,USA, 3500000,16324573,16324573,0,12824573,1
24597,56.0,"Comedy, Crime","A tough cop must pose as a kindergarten teacher in order to locate a dangerous criminal's ex-wife, who may hold the key to putting him behind bars.",61.0,Ivan Reitman,Kindergarten Cop,1990,111,USA, 15000000,91457688,201957688,110500000,186957688,1
24583,128.0,"Drama, Horror, Mystery","Mourning his dead child, a haunted Vietnam War veteran attempts to uncover his past while suffering from a severe case of dissociation. To do so, he must decipher reality and life from his own dreams, delusions, and perceptions of death.",62.0,Adrian Lyne,Jacob's Ladder,1990,113,USA, 25000000,26118851,26118851,0,1118851,1
24301,54.0,"Action, Adventure, Comedy",A vulgar private detective is hired to find a missing groupie and is drawn into a mystery involving a series of murders tied to the music industry.,24.0,Renny Harlin,The Adventures of Ford Fairlane,1990,104,USA, 20000000,21413502,21413502,0,1413502,1
24421,70.0,"Action, Drama, Sport",A young hot-shot stock car driver gets his chance to compete at the top level.,60.0,Tony Scott,Days of Thunder,1990,107,USA, 60000000,82670733,157920733,75250000,97920733,1
24419,148.0,"Action, Sci-Fi, Thriller",A brilliant scientist left for dead returns to exact revenge on the people who burned him alive.,65.0,Sam Raimi,Darkman,1990,96,USA, 16000000,33878502,48878502,15000000,32878502,1
24408,46.0,"Comedy, Musical","In 1950s Baltimore, a bad boy with a heart of gold wins the love of a good girl, whose boyfriend sets out for revenge.",63.0,John Waters,Cry-Baby,1990,85,USA, 11000000,8266343,8266343,0,-2733657,0
24391,76.0,"Action, Horror, Sci-Fi","Robot teachers have been secretly placed in the schools where the students have run riot. The teachers do a good job of controlling the unruly youngsters, until they go too far and some ...",33.0,Mark L. Lester,Class of 1999,1990,99,USA, 5200000,2459895,2459895,0,-2740105,0
24381,75.0,"Horror, Thriller","While Andy's mother is admitted to a psychiatric hospital, the young boy is placed in foster care, and Chucky, determined to claim Andy's soul, is not far behind.",37.0,John Lafia,Child's Play 2,1990,84,USA, 13000000,28501605,35763605,7262000,22763605,1
24357,43.0,"Comedy, Drama, Romance","After his mistress runs over a young teen, a Wall Street hotshot sees his life unravel in the spotlight and attracting the interest of a down and out reporter.",27.0,Brian De Palma,The Bonfire of the Vanities,1990,125,USA, 47000000,15691192,15691192,0,-31308808,0
24349,32.0,"Action, Comedy",An old flame discovers her ex-boyfriend from the past is a relocated FBI informant out to stop the bad guys.,36.0,John Badham,Bird on a Wire,1990,110,USA, 20000000,70978012,138697012,67719000,118697012,1
24336,39.0,"Drama, Thriller",A soft and hesitant young man is in danger when tries to break toxic relationships with a mysterious stranger claiming to be his friend.,63.0,Curtis Hanson,Bad Influence,1990,99,USA, 7000000,12626043,12626043,0,5626043,1
24327,43.0,"Biography, Drama","The victims of an encephalitis epidemic many years ago have been catatonic ever since, but now a new drug offers the prospect of reviving them.",74.0,Penny Marshall,Awakenings,1990,121,USA, 31000000,52096475,52096475,0,21096475,1
24320,88.0,"Comedy, Fantasy, Horror",A species of South American killer spider hitches a lift to the U.S. in a coffin and starts to breed and kill.,67.0,Frank Marshall,Arachnophobia,1990,109,USA, 22000000,53208180,53208180,0,31208180,1
24319,31.0,"Action, Comedy, Crime","Jack Cates once again enlists the aid of ex-con Reggie Hammond--this time, to take down The Iceman, a ruthless drug lord operating in the San Francisco bay area.",23.0,Walter Hill,Another 48 Hrs.,1990,93,USA, 38000000,80818974,153518974,72700000,115518974,1
24310,59.0,"Comedy, Romance",A spoiled Manhattan housewife re-evaluates her life after visiting a Chinatown healer.,67.0,Woody Allen,Alice,1990,106,USA, 12000000,7331647,7331647,0,-4668353,0
24308,28.0,"Action, Comedy, War",A young pilot finds himself recruited unwittingly into a covert and corrupt C.I.A. airlift organization operating in Vietnam War-era Laos.,33.0,Roger Spottiswoode,Air America,1990,113,USA, 35000000,31053601,33461269,2407668,-1538731,0
24588,45.0,"Comedy, Romance","When a hypochondriac learns that he is dying, he accepts an offer to throw himself in a volcano at a tropical island, and along the way there, learns to truly live.",45.0,John Patrick Shanley,Joe Versus the Volcano,1990,102,USA, 25000000,39404261,39404261,0,14404261,1
24333,124.0,"Adventure, Comedy, Sci-Fi","Stranded in 1955, Marty McFly learns about the death of Doc Brown in 1885 and must travel back in time to save him. With no fuel readily available for the DeLorean, the two must figure out a way to escape the Old West before Emmett is murdered.",55.0,Robert Zemeckis,Back to the Future Part III,1990,118,USA, 40000000,88277583,246144250,157866667,206144250,1
24562,124.0,"Action, Adventure, Thriller","In November 1984, the Soviet Union's best submarine Captain in their newest sub violates orders and heads for the U.S. Is he trying to defect or to start a war?",58.0,John McTiernan,The Hunt for Red October,1990,135,USA, 30000000,122012643,200512643,78500000,170512643,1
24443,157.0,"Action, Thriller","John McClane attempts to avert disaster as rogue military operatives seize control of Dulles International Airport in Washington, D.C.",67.0,Renny Harlin,Die Hard 2,1990,124,USA, 70000000,117540947,240247433,122706486,170247433,1
24560,19.0,"Comedy, Music, Romance","Kid decides to go to his friend Play's house party, but neither of them can predict what's in store for them on what could be the wildest night of their lives.",76.0,Reginald Hudlin,House Party,1990,100,USA, 2500000,26385627,26385627,0,23885627,1
24559,52.0,"Crime, Drama, Romance","Upon arriving to a small town, a drifter quickly gets into trouble with the local authorities- and the local women- after he robs a bank.",56.0,Dennis Hopper,The Hot Spot,1990,130,USA, 13000000,1293976,1293976,0,-11706024,0
24557,127.0,"Comedy, Family",An eight-year-old troublemaker must protect his house from a pair of burglars when he is accidentally left home alone by his family during Christmas vacation.,63.0,Chris Columbus,Home Alone,1990,103,USA, 18000000,285761243,476684675,190923432,458684675,1
24526,229.0,"Biography, Crime, Drama","The story of Henry Hill and his life in the mob, covering his relationship with his wife Karen Hill and his mob partners Jimmy Conway and Tommy DeVito in the Italian-American crime syndicate.",89.0,Martin Scorsese,Goodfellas,1990,146,USA, 25000000,46836214,46879633,43419,21879633,1
24543,49.0,"Action, Crime, Drama","Left for dead with his wife killed in their house, L.A. Detective Mason Storm will have to make a quick recovery, expose those behind the murder and take revenge.",41.0,Bruce Malmuth,Hard to Kill,1990,96,USA, 10000000,47410827,47410827,0,37410827,1
24516,86.0,"Drama, Fantasy, Romance","After a young man is murdered, his spirit stays behind to warn his lover of impending danger, with the help of a reluctant psychic.",52.0,Jerry Zucker,Ghost,1990,127,USA, 22000000,217631306,505706694,288075388,483706694,1
24465,98.0,"Drama, Fantasy, Romance","An artificial man, who was incompletely constructed and has scissors for hands, leads a solitary life. Then one day, a suburban lady meets him and introduces him to her world.",74.0,Tim Burton,Edward Scissorhands,1990,105,USA, 20000000,56362352,86024005,29661653,66024005,1
24524,115.0,"Crime, Drama","In the midst of trying to legitimize his business dealings in New York City and Italy in 1979, aging Mafia Don Michael Corleone seeks to avow for his sins, while taking his nephew Vincent Mancini under his wing.",60.0,Francis Ford Coppola,The Godfather: Part III,1990,162,USA, 54000000,66666062,136766062,70100000,82766062,1
24490,52.0,"Drama, Horror, Sci-Fi","Five medical students experiment with ""near death"" experiences, until the dark consequences of past tragedies begin to jeopardize their lives.",55.0,Joel Schumacher,Flatliners,1990,115,USA, 26000000,61489265,61489265,0,35489265,1
24488,32.0,"Crime, Horror, Thriller","A dedicated L.A. police detective and a female psychic must stop a demonic serial killer who was given the powers of resurrection, teleportation and possession.",35.0,Robert Resnikoff,The First Power,1990,98,USA, 10000000,22424195,22424195,0,12424195,1
25420,29.0,"Drama, Romance","After being shot, a man loses his memory and must relearn speech and mobility, but he has a loving family to support him.",47.0,Mike Nichols,Regarding Henry,1991,108,USA, 25000000,43001500,43001500,0,18001500,1
25405,36.0,"Drama, Romance",A troubled man talks to his suicidal sister's psychiatrist about their family history and falls in love with her in the process.,65.0,Barbra Streisand,The Prince of Tides,1991,132,USA, 30000000,74787599,74787599,0,44787599,1
25394,35.0,"Drama, Horror, Romance","A boy shoots his father and flies out the window. A man falls in love with a fellow inmate in prison. A doctor accidentally ingests his experimental sex serum, wrecking havoc on the community.",67.0,Todd Haynes,Poison,1991,85,USA, 250000,787280,787280,0,537280,1
25376,70.0,"Action, Crime, Drama",The gruesome murder of a Brooklyn Detective will turn the case into a personal vendetta when the deceased's best friend and fellow officer will unleash an all-out attack against a psychotic Mafia enforcer's brutal gang.,38.0,John Flynn,Out for Justice,1991,91,USA, 14000000,39673161,39673161,0,25673161,1
25335,39.0,"Comedy, Drama, Family","A young girl, on the threshold of her teen years, finds her life turning upside down, when she is accompanied by an unlikely friend.",56.0,Howard Zieff,My Girl,1991,102,USA, 17000000,59489799,59489799,0,42489799,1
25348,34.0,"Action, Crime, Drama",A crime lord ascends to power and becomes megalomaniacal while a maverick police detective vows to stop him.,61.0,Mario Van Peebles,New Jack City,1991,97,USA, 8000000,47624353,47624353,0,39624353,1
25345,12.0,"Comedy, Sport","Due to NCAA sanctions, the Texas State University Fightin' Armadillos must form a football team from their actual student body, with no scholarships to help, to play their football schedule.",45.0,Stan Dragoti,Necessary Roughness,1991,108,USA, 13500000,26255594,26255594,0,12755594,1
25340,48.0,"Comedy, Crime",Lieutenant Frank Drebin discovers that his ex-girlfriend's new beau is involved in a plot to kidnap a scientist who advocates solar energy.,65.0,David Zucker,The Naked Gun 2¬Ω: The Smell of Fear,1991,85,USA, 23000000,86930411,86930411,0,63930411,1
25337,64.0,Drama,Two best friends living on the streets of Portland as hustlers embark on a journey of self discovery and find their relationship stumbling along the way.,77.0,Gus Van Sant,My Own Private Idaho,1991,104,USA, 2500000,6401336,6401336,0,3901336,1
25434,101.0,"Action, Adventure, Family",A young pilot stumbles onto a prototype jetpack that allows him to become a high flying masked hero.,61.0,Joe Johnston,The Rocketeer,1991,108,USA, 35000000,46704056,46704056,0,11704056,1
25561,13.0,"Adventure, Drama",Jack London's classic adventure story about the friendship developed between a Yukon gold hunter and the mixed dog-wolf he rescues from the hands of a man who mistreats him.,62.0,Randal Kleiser,White Fang,1991,107,USA, 14000000,34793160,34793160,0,20793160,1
25558,42.0,Comedy,"A successful psychotherapist loses his mind after one of his most dependent patients, an obsessive-compulsive neurotic, tracks him down during his family vacation.",60.0,Frank Oz,What About Bob?,1991,99,USA, 35000000,63707829,63707829,0,28707829,1
25524,36.0,"Action, Drama, Thriller",A group of troublemaking boys decide to take a stand when terrorists seize control of their boarding school.,46.0,Daniel Petrie Jr.,Toy Soldiers,1991,111,USA, 10000000,15073942,15073942,0,5073942,1
25513,289.0,"Action, Sci-Fi","A cyborg, identical to the one who failed to kill Sarah Connor, must now protect her teenage son, John Connor, from a more advanced and powerful cyborg.",75.0,James Cameron,Terminator 2: Judgment Day,1991,137,USA, 102000000,205881154,520884847,315003693,418884847,1
25485,77.0,"Action, Adventure, Sci-Fi","On the eve of retirement, Kirk and McCoy are charged with assassinating the Klingon High Chancellor and imprisoned. The Enterprise crew must help them escape to thwart a conspiracy aimed at sabotaging the last best hope for peace.",65.0,Nicholas Meyer,Star Trek VI: The Undiscovered Country,1991,110,USA, 30000000,74888996,96888996,22000000,66888996,1
25481,28.0,"Comedy, Romance","An ambitious television soap actress connives with her producer to scuttle the career of the show's long-time star, but nothing works as they plan.",65.0,Michael Hoffman,Soapdish,1991,97,USA, 25000000,36489888,36489888,0,11489888,1
25479,48.0,"Drama, Thriller","A young woman fakes her own death in an attempt to escape her nightmarish marriage, but discovers it is impossible to elude her controlling husband.",48.0,Joseph Ruben,Sleeping with the Enemy,1991,99,USA, 19000000,101599005,174999005,73400000,155999005,1
25473,206.0,"Crime, Drama, Thriller","A young F.B.I. cadet must receive the help of an incarcerated and manipulative cannibal killer to help catch another serial killer, a madman who skins his victims.",85.0,Jonathan Demme,The Silence of the Lambs,1991,118,USA, 19000000,130742922,272753884,142010962,253753884,1
25091,66.0,"Crime, Drama, Mystery","A woman who has lost her memory is taken in by a Los Angeles orphanage, and a private eye is enlisted to track down her identity, but he soon finds that he might have a past life connection to her that endangers their lives.",66.0,Kenneth Branagh,Dead Again,1991,107,USA, 15000000,38016380,38016380,0,23016380,1
25056,47.0,Comedy,"On the verge of turning 40, an unhappy Manhattan yuppie is roped into joining his two friends on a cattle drive in the southwest.",70.0,Ron Underwood,City Slickers,1991,113,USA, 27000000,124033791,179033791,55000000,152033791,1
25046,135.0,"Crime, Thriller","A convicted rapist, released from prison after serving a fourteen-year sentence, stalks the family of the lawyer who originally defended him.",73.0,Martin Scorsese,Cape Fear,1991,128,USA, 35000000,79091969,182291969,103200000,147291969,1
25033,57.0,"Biography, Crime, Drama","The story of how Benjamin ""Bugsy"" Siegel started Las Vegas.",80.0,Barry Levinson,Bugsy,1991,136,USA, 30000000,49114016,49114016,0,19114016,1
25005,61.0,"Adventure, Comedy, Fantasy",A tyrant from the future creates evil android doubles of Bill and Ted and sends them back to eliminate the originals.,60.0,Peter Hewitt,Bill & Ted's Bogus Journey,1991,93,USA, 20000000,38037513,38037513,0,18037513,1
24992,209.0,"Animation, Family, Fantasy",A prince cursed to spend his days as a hideous monster sets out to regain his humanity by earning a young woman's love.,95.0,"Gary Trousdale, Kirk Wise",Beauty and the Beast,1991,84,USA, 25000000,218967620,440118382,221150762,415118382,1
24985,71.0,"Crime, Drama, Mystery","Two Chicago firefighter brothers, who don't get along, have to work together while a dangerous arsonist is on the loose.",38.0,Ron Howard,Backdraft,1991,137,USA, 40000000,77868585,152368585,74500000,112368585,1
25281,28.0,Drama,"Fred Tate is a prodigy. He's also a lonely, little boy with the emotional needs that his single mom covers. Worries about world problems gives him ulcer. He takes a quantum physics summer college class at 7.",71.0,Jodie Foster,Little Man Tate,1991,99,USA, 10000000,25010896,25010896,0,15010896,1
25030,80.0,"Crime, Drama","Follows the lives of three young males living in the Crenshaw ghetto of Los Angeles, dissecting questions of race, relationships, violence and future prospects.",76.0,John Singleton,Boyz n the Hood,1991,112,USA, 6500000,57504069,57529070,25001,51029070,1
24948,71.0,"Comedy, Fantasy",Con artists plan to fleece an eccentric family using an accomplice who claims to be their long-lost uncle.,57.0,Barry Sonnenfeld,The Addams Family,1991,99,USA, 30000000,113502426,191502426,78000000,161502426,1
25124,85.0,"Biography, Drama, Music",The story of the famous and influential 1960s rock band,62.0,Oliver Stone,The Doors,1991,140,USA, 38000000,34416893,34416893,0,-3583107,0
25278,18.0,Comedy,"A filthy rich businessman bets a corporate rival that he can live on the streets of L.A. without the comforts of home or money, which proves to be tougher than he thought.",54.0,Mel Brooks,Life Stinks,1991,92,USA, 13000000,4102526,4102526,0,-8897474,0
25264,67.0,"Action, Comedy, Crime","A private detective's protected female witness is murdered, prompting him and the victim's boyfriend to investigate the crime that leads to a corrupt politician and a crooked football team owner.",52.0,Tony Scott,The Last Boy Scout,1991,105,USA, 29000000,59509925,59509925,0,30509925,1
25212,72.0,"Action, Adventure, Comedy",A cat burglar is forced to steal Da Vinci works of art for a world domination plot.,17.0,Michael Lehmann,Hudson Hawk,1991,100,USA, 65000000,17218080,17218080,0,-47781920,0
25208,45.0,"Action, Comedy",A parody of,61.0,Jim Abrahams,Hot Shots!,1991,84,USA, 26000000,69467617,181096164,111628547,155096164,1
25206,90.0,"Adventure, Comedy, Family","When Captain Hook kidnaps his children, an adult Peter Pan must return to Neverland and reclaim his youthful spirit in order to challenge his old enemy.",52.0,Steven Spielberg,Hook,1991,142,USA, 70000000,119654823,300854823,181200000,230854823,1
25166,56.0,Drama,A housewife who is unhappy with her life befriends an old lady in a nursing home and is enthralled by the tales she tells of people she used to know.,64.0,Jon Avnet,Fried Green Tomatoes,1991,130,USA, 11000000,82418501,119418501,37000000,108418501,1
25164,90.0,"Fantasy, Horror","Dream-haunting Freddy Krueger returns once again to prowl the nightmares of Springwood's last surviving teenager, and of a woman whose personal connection to Krueger may mean his doom.",39.0,Rachel Talalay,Freddy's Dead: The Final Nightmare,1991,89,USA, 11000000,34872033,34872033,0,23872033,1
25163,29.0,"Comedy, Drama, Romance","Johnny has just been released from prison, and gets a job in a caf√© beside waitress Frankie. Frankie is a bit of a loner, but Johnny is determined their romance will blossom.",66.0,Garry Marshall,Frankie and Johnny,1991,118,USA, 29000000,22773535,22773535,0,-6226465,0
25159,95.0,"Comedy, Drama, Fantasy","A former radio DJ, suicidally despondent because of a terrible mistake he made, finds redemption in helping a deranged homeless man who was an unwitting victim of that mistake.",61.0,Terry Gilliam,The Fisher King,1991,137,USA, 24000000,41895491,41895491,0,17895491,1
25147,27.0,"Action, Thriller","A special effects man helps his girlfriend's ex, a cop, with a sting operation, where the ex gets killed. Something's off and he investigates with help from an ex-cop PI friend.",48.0,Richard Franklin,F/X2,1991,108,USA, 16400000,21082165,21082165,0,4682165,1
26026,56.0,"Action, Thriller","When CIA analyst Jack Ryan interferes with an IRA assassination, a renegade faction targets him and his family for revenge.",64.0,Phillip Noyce,Patriot Games,1992,117,USA, 45000000,83351587,178051587,94700000,133051587,1
26031,56.0,"Fantasy, Horror","A teenage boy and his father move to his recently-deceased mother's hometown, where they encounter the ancient Native American cemetery with the power to raise the dead.",35.0,Mary Lambert,Pet Sematary II,1992,100,USA, 8000000,17092453,17092453,0,9092453,1
26037,85.0,"Comedy, Crime, Drama","A Hollywood studio executive is being sent death threats by a writer whose script he rejected, but which one?",86.0,Robert Altman,The Player,1992,124,USA, 8000000,21706101,21706101,0,13706101,1
25999,16.0,"Comedy, Crime, Drama",The story about a cheating and incompetent lawyer (Harry Fabian) who suddenly gets obsessed on becoming a boxing promoter.,61.0,Irwin Winkler,Night and the City,1992,105,USA, 20000000,6202756,6202756,0,-13797244,0
25996,32.0,"Drama, Family, History",A musical based on the New York City newsboy strike of 1899. When young newspaper sellers are exploited beyond reason by their bosses they set out to enact change and are met by the ruthlessness of big business.,46.0,Kenny Ortega,Newsies,1992,121,USA, 15000000,2819485,2819485,0,-12180515,0
25983,52.0,"Comedy, Crime","Two New Yorkers are accused of murder in rural Alabama while on their way back to college, and one of their cousins--an inexperienced, loudmouth lawyer not accustomed to Southern rules and manners--comes in to defend them.",68.0,Jonathan Lynn,My Cousin Vinny,1992,120,USA, 11000000,52929168,64088552,11159384,53088552,1
25963,30.0,"Comedy, Drama, Family",A self-centered Minnesota lawyer is sentenced to community service coaching a rag tag youth hockey team.,46.0,Stephen Herek,The Mighty Ducks,1992,100,USA, 10000000,50752337,50752337,0,40752337,1
26066,203.0,"Crime, Drama, Thriller","When a simple jewelry heist goes horribly wrong, the surviving criminals begin to suspect that one of them is a police informant.",79.0,Quentin Tarantino,Reservoir Dogs,1992,99,USA, 1200000,2832029,2859750,27721,1659750,1
26220,74.0,"Comedy, Music",Two slacker friends try to promote their public-access cable show.,57.0,Penelope Spheeris,Wayne's World,1992,94,USA, 20000000,121697323,183097323,61400000,163097323,1
26073,48.0,Drama,"The story about two sons of a stern minister -- one reserved, one rebellious -- growing up in rural Montana while devoted to fly fishing.",68.0,Robert Redford,A River Runs Through It,1992,123,USA, 12000000,43440294,43440294,0,31440294,1
26297,242.0,"Comedy, Horror","A man is accidentally transported to 1300 A.D., where he must battle an army of the dead and retrieve the Necronomicon so he can return home.",57.0,Sam Raimi,Army of Darkness,1992,81,USA, 11000000,11502976,11502976,0,502976,1
26375,59.0,"Horror, Thriller","A journalist and his son travel to Nebraska to investigate the mysterious town of Gatlin where, unbeknownst to them, a murderous cult of children are still waiting in the corn fields.",18.0,David Price,Children of the Corn II: The Final Sacrifice,1992,92,USA, 900000,6980986,6980986,0,6080986,1
26196,99.0,"Action, Sci-Fi","Private Luc Deveraux and his sadistic sergeant, Andrew Scott, got killed in Viet Nam. The army uses their bodies for a secret project - reanimating dead soldiers as deadly obedient cyborgs. However, their memories come back too.",35.0,Roland Emmerich,Universal Soldier,1992,102,USA, 23000000,36299898,36299898,0,13299898,1
26195,116.0,"Drama, Western","Retired Old West gunslinger William Munny (Clint Eastwood) reluctantly takes on one last job, with the help of his old partner Ned Logan (Morgan Freeman) and a young man, The ""Schofield Kid"" (Jaimz Woolvett).",85.0,Clint Eastwood,Unforgiven,1992,130,USA, 14400000,101157447,159157447,58000000,144757447,1
26173,29.0,"Adventure, Comedy, Drama","When a military general inherits a toy making company and begins making war toys, his employees band together to stop him before he ruins the name of Zevo Toys forever.",40.0,Barry Levinson,Toys,1992,118,USA, 43000000,23278931,23278931,0,-19721069,0
26120,77.0,Horror,A mother-and-son team of strange supernatural creatures move to a small town to seek out a young virgin to feed on.,38.0,Mick Garris,Sleepwalkers,1992,91,USA, 15000000,30524763,30524763,0,15524763,1
26118,30.0,"Comedy, Crime, Family","When a worldly singer witnesses a mob crime, the police hide her as a nun in a traditional convent where she has trouble fitting in.",51.0,Emile Ardolino,Sister Act,1992,100,USA, 31000000,139605150,231605150,92000000,200605150,1
26116,66.0,"Drama, Thriller",A woman advertising for a new roommate finds that something very strange is going on with the tenant who decides to move in.,63.0,Barbet Schroeder,Single White Female,1992,107,USA, 16000000,48017402,48017402,0,32017402,1
26090,23.0,Drama,"Set in the 1950s, a star-quarterback is given an opportunity to attend an elite preparatory school but must conceal the fact that he is Jewish.",65.0,Robert Mandel,School Ties,1992,106,USA, 18000000,14715067,14715067,0,-3284933,0
26089,58.0,Drama,"A prep school student needing money agrees to ""babysit"" a blind man, but the job is not at all what he anticipated.",59.0,Martin Brest,Scent of a Woman,1992,156,USA, 31000000,63095253,134095253,71000000,103095253,1
25921,19.0,"Comedy, Drama","Luke is a gay hustler. Jon is a movie critic. Both are HIV positive. They go on a hedonistic, dangerous journey, their motto ""Fuck the world"".",65.0,Gregg Araki,The Living End,1992,81,USA, 22769,692585,692585,0,669816,1
25744,16.0,"Comedy, Crime","A conman discovers during a ""job"" that US Congress is where the money is. ""Name recognition"" gets him elected. Will he develop a conscience?",45.0,Jonathan Lynn,The Distinguished Gentleman,1992,112,USA, 50000000,46666502,46666502,0,-3333498,0
25730,70.0,"Comedy, Fantasy, Horror","When a woman learns of an immortality treatment, she sees it as a way to outdo her long-time rival.",56.0,Robert Zemeckis,Death Becomes Her,1992,104,USA, 55000000,58422650,149022650,90600000,94022650,1
25710,48.0,"Animation, Comedy, Fantasy",A comic strip femme fatale seeks to seduce her cartoonist creator in order to cross over into the real world.,28.0,Ralph Bakshi,Cool World,1992,102,USA, 30000000,14110589,14110589,0,-15889411,0
25678,13.0,"Adventure, Comedy","A Chicagoan inherits an old yacht. He, his wife, daughter and son fly to a Caribbean island and hire a dubious Captain Ron to sail them on an adventure to Miami.",39.0,Thom Eberhardt,Captain Ron,1992,90,USA, 24000000,22518097,22518097,0,-1481903,0
25668,77.0,"Action, Comedy, Fantasy",A flighty teenage girl learns that she is her generation's destined battler of vampires.,48.0,Fran Rubel Kuzui,Buffy the Vampire Slayer,1992,86,USA, 7000000,16624456,16624456,0,9624456,1
25661,23.0,"Comedy, Drama, Romance",A successful executive and womanizer finds his lifestyle choices have turned back on him when his new female boss turns out to be an even bigger deviant than he is.,45.0,Reginald Hudlin,Boomerang,1992,117,USA, 42000000,70052444,131052444,61000000,89052444,1
25760,31.0,Comedy,"When they find a frozen caveman in their back yard, two high school outcasts thaw him and introduce him to modern life while he in turn gets them to actually enjoy life.",25.0,Les Mayfield,Encino Man,1992,88,USA, 7000000,40693477,40693477,0,33693477,1
25659,57.0,"Drama, Music, Romance","A former Secret Service agent takes on the job of bodyguard to an R&B singer, whose lifestyle is most unlike a President's.",39.0,Mick Jackson,The Bodyguard,1992,129,USA, 25000000,122006740,411006740,289000000,386006740,1
25607,16.0,"Biography, Crime, Drama","A Mexican-American Mafia kingpin is released from prison, falls in love for the first time, and grows introspective about his gangster lifestyle.",66.0,Edward James Olmos,American Me,1992,125,USA, 16000000,13086430,13086430,0,-2913570,0
25603,260.0,"Action, Horror, Sci-Fi","After her last encounter, Ellen Ripley crash-lands on Fiorina 161, a maximum security prison. When a series of strange and deadly events occur shortly after her arrival, Ripley realizes that she has brought along an unwelcome visitor.",59.0,David Fincher,Alien¬≥,1992,114,USA, 50000000,55473545,159814498,104340953,109814498,1
25601,154.0,"Animation, Adventure, Comedy",A kindhearted street urchin and a power-hungry Grand Vizier vie for a magic lamp that has the power to make their deepest wishes come true.,86.0,"Ron Clements, John Musker",Aladdin,1992,90,USA, 28000000,217350219,504050219,286700000,476050219,1
25593,12.0,"Action, Comedy, Family","Each year, three brothers visit their grandfather for the summer. He is highly skilled in ninjutsu, and for years he has trained the boys in his techniques.",36.0,Jon Turteltaub,3 Ninjas,1992,84,USA, 6500000,29000301,29000301,0,22500301,1
25279,22.0,"Crime, Drama",A drug dealer reconsiders his profession when his boss plans to go straight and an old flame reappears.,70.0,Paul Schrader,Light Sleeper,1992,103,USA, 5000000,1050861,1055987,5126,-3944013,0
25624,83.0,"Crime, Drama, Thriller","While investigating a young nun's rape, a corrupt New York City police detective, with a serious drug and gambling addiction, tries to change his ways and find forgiveness and redemption.",70.0,Abel Ferrara,Bad Lieutenant,1992,96,USA, 1000000,2000022,2038916,38894,1038916,1
25665,193.0,Horror,The centuries old vampire Count Dracula comes to England to seduce his barrister Jonathan Harker's fianc√©e Mina Murray and inflict havoc in the foreign land.,57.0,Francis Ford Coppola,Dracula,1992,128,USA, 40000000,82522790,215862692,133339902,175862692,1
25823,18.0,"Adventure, Comedy, Family","The Szalinski family is back, this time hilarious disaster strikes when an experiment causes their new toddler son to grow many stories tall.",50.0,Randal Kleiser,"Honey, I Blew Up the Kid",1992,89,USA, 40000000,58662452,58662452,0,18662452,1
25768,34.0,"Adventure, Drama, Romance","A young Irish couple flee to the States, but subsequently struggle to obtain land and prosper freely.",49.0,Ron Howard,Far and Away,1992,140,USA, 60000000,58883840,137783840,78900000,77783840,1
25908,55.0,"Comedy, Drama, Family",Two sisters join the first female professional baseball league and struggle to help it succeed amidst their own growing rivalry.,67.0,Penny Marshall,A League of Their Own,1992,128,USA, 40000000,107533928,132440069,24906141,92440069,1
25905,92.0,"Action, Adventure, Drama",Three trappers protect the daughters of a British Colonel in the midst of the French and Indian War.,76.0,Michael Mann,The Last of the Mohicans,1992,112,USA, 40000000,75505856,75505856,0,35505856,1
25820,35.0,"Biography, Crime, Drama","The story of the notorious American labor union figure Jimmy Hoffa, who organizes a bitter strike, makes deals with members of the organized crime syndicate and mysteriously disappears in 1975.",50.0,Danny DeVito,Hoffa,1992,140,USA, 35000000,24276506,29302121,5025615,-5697879,0
25925,29.0,Drama,"A boy develops a disease so rare that nobody is working on a cure, so his father decides to learn all about it and tackle the problem himself.",80.0,George Miller,Lorenzo's Oil,1992,129,USA, 30000000,7286388,7286388,0,-22713612,0
25914,81.0,"Action, Crime, Thriller",Martin Riggs and Roger Murtaugh pursue a former LAPD officer who uses his knowledge of police procedure and policies to steal and sell confiscated guns and ammunition to local street gangs.,40.0,Richard Donner,Lethal Weapon 3,1992,118,USA, 35000000,144731527,321731527,177000000,286731527,1
25815,119.0,Horror,An investigative reporter must send the newly unbound Pinhead and his legions back to Hell.,50.0,Anthony Hickox,Hellraiser III: Hell on Earth,1992,97,USA, 5000000,12534961,12534961,0,7534961,1
25808,46.0,"Drama, Thriller","After her humiliated husband kills himself, an embittered pregnant widow loses her child, and embarks on a mission of vengeance against a woman and her family.",64.0,Curtis Hanson,The Hand That Rocks the Cradle,1992,110,USA, 11700000,88036683,88036683,0,76336683,1
25805,17.0,"Crime, Drama, Romance","A trashy teen murders her sexually abusive step-father, then helps get her reformed prison pen-pal released on good behavior so that she can re-corrupt him.",69.0,Tamra Davis,Guncrazy,1992,97,USA, 800000,114516,114516,0,-685484,0
25794,122.0,"Crime, Drama, Mystery",An examination of the machinations behind the scenes at a real estate office.,80.0,James Foley,Glengarry Glen Ross,1992,100,USA, 12500000,10725228,10725228,0,-1774772,0
25776,86.0,"Drama, Thriller",Military lawyer Lieutenant Daniel Kaffee defends Marines accused of murder. They contend they were acting under orders.,62.0,Rob Reiner,A Few Good Men,1992,138,USA, 41000000,141340178,243240178,101900000,202240178,1
26720,232.0,"Animation, Family, Fantasy","Jack Skellington, king of Halloween Town, discovers Christmas Town, but his attempts to bring Christmas to his home causes confusion.",82.0,Henry Selick,The Nightmare Before Christmas,1993,76,USA, 18000000,75082668,88170974,13088306,70170974,1
26751,54.0,"Crime, Drama, Mystery","A law student uncovers a conspiracy, putting herself and others in danger.",50.0,Alan J. Pakula,The Pelican Brief,1993,141,USA, 45000000,100768056,195268056,94500000,150268056,1
26756,68.0,"Crime, Drama, Thriller","Kidnapped boy Phillip Perry (T.J. Lowther) strikes up a friendship with his captor Butch Haynes (Kevin Costner): an escaped convict on the run from the law, while the search is headed up by honorable Texas Ranger ""Red"" Garrett (Clint Eastwood).",71.0,Clint Eastwood,A Perfect World,1993,138,USA, 30000000,31130999,135130999,104000000,105130999,1
26674,32.0,"Crime, Drama, Thriller",A young street hustler attempts to escape the rigors and temptations of the ghetto in a quest for a better life.,76.0,"Albert Hughes, Allen Hughes",Menace II Society,1993,97,USA, 3500000,27912072,27912072,0,24412072,1
26759,82.0,Drama,"When a man with HIV is fired by his law firm because of his condition, he hires a homophobic small time lawyer as the only willing advocate for a wrongful dismissal suit.",66.0,Jonathan Demme,Philadelphia,1993,125,USA, 26000000,77446440,206678440,129232000,180678440,1
26693,57.0,"Comedy, Drama, Family","After a bitter divorce, an actor disguises himself as a female housekeeper to spend time with his children held in custody by his former wife.",53.0,Chris Columbus,Mrs. Doubtfire,1993,125,USA, 25000000,219195243,441286195,222090952,416286195,1
26952,42.0,"Comedy, Music",The inseparable duo try to organize a rock concert while Wayne must fend off a record producer who has an eye for his girlfriend.,60.0,Stephen Surjik,Wayne's World 2,1993,95,USA, 40000000,48197805,48197805,0,8197805,1
26957,85.0,Drama,"After his father's death, Gilbert has to care for his mentally-disabled brother, Arnie, and his morbidly obese mother. This situation is suddenly challenged though, when love unexpectedly walks into his life.",73.0,Lasse Hallstr√∂m,What's Eating Gilbert Grape,1993,118,USA, 11000000,10032765,10032765,0,-967235,0
26621,111.0,"Action, Adventure, Comedy","With the help of a magic ticket, a young movie fan is transported into the fictional world of his favorite action movie character.",44.0,John McTiernan,Last Action Hero,1993,130,USA, 85000000,50016394,137298489,87282095,52298489,1
26914,93.0,"Action, Biography, Drama","A successful lawman's plans to retire anonymously in Tombstone, Arizona, are disrupted by the kind of outlaws he was famous for eliminating.",50.0,"George P. Cosmatos, Kevin Jarre",Tombstone,1993,130,USA, 25000000,56505065,56505065,0,31505065,1
26766,14.0,"Drama, Romance","In this film, we see the world through the eyes of main character Justice, a young African-American poet. A mail carrier invites a few friends along for a long overnight delivery run.",51.0,John Singleton,Poetic Justice,1993,109,USA, 14000000,27515786,27515786,0,13515786,1
26846,49.0,"Drama, Thriller","A woman moves into an exclusive New York City apartment building, which she soon discovers houses tenants with all manner of shocking secrets.",38.0,Phillip Noyce,Sliver,1993,107,USA, 40000000,36300000,116300000,80000000,76300000,1
26845,80.0,"Comedy, Drama, Romance",A recently widowed man's son calls a radio talk-show in an attempt to find his father a partner.,72.0,Nora Ephron,Sleepless in Seattle,1993,105,USA, 21000000,126808165,227927165,101119000,206927165,1
26842,38.0,"Comedy, Drama, Mystery","An affluent New York City couple finds their lives touched, intruded upon, and compelled by a mysterious young black man who is never quite who he says he is.",72.0,Fred Schepisi,Six Degrees of Separation,1993,112,USA, 12000000,6405918,6405918,0,-5594082,0
26840,20.0,"Comedy, Family, Music",Showgirl Deloris Van Cartier returns as Sister Mary Clarence to teach music to a group of Catholic students whose run-down school is slated for closure.,38.0,Bill Duke,Sister Act 2: Back in the Habit,1993,107,USA, 38000000,57319029,57319029,0,19319029,1
26820,40.0,"Biography, Drama",A prepubescent chess prodigy refuses to harden himself in order to become a champion like the famous but unlikable Bobby Fischer.,89.0,Steven Zaillian,Searching for Bobby Fischer,1993,109,USA, 12000000,7266383,7266383,0,-4733617,0
26817,221.0,"Biography, Drama, History","In German-occupied Poland during World War II, industrialist",94.0,Steven Spielberg,Schindler's List,1993,195,USA, 22000000,96898818,322243445,225344627,300243445,1
26799,18.0,"Comedy, Family, Fantasy","When an accident miraculously gives a boy an incredibly powerful pitching arm, he becomes a major league pitcher for the Chicago Cubs.",53.0,Daniel Stern,Rookie of the Year,1993,103,USA, 10000000,53615089,56500758,2885669,46500758,1
26795,98.0,"Action, Crime, Sci-Fi","Robocop saves the day once more. This time the half man/half robot takes on ruthless developers who want to evict some people on ""their"" land.",40.0,Fred Dekker,RoboCop 3,1993,104,USA, 22000000,10696210,10696210,0,-11303790,0
26793,44.0,"Action, Crime, Drama","When an escort girl is found dead in the offices of a Japanese company in Los Angeles, detectives Web Smith and John Connor act as liaison between the company's executives and the investigating cop Tom Graham.",56.0,Philip Kaufman,Rising Sun,1993,125,USA, 35000000,63179523,107198790,44019267,72198790,1
26612,50.0,"Drama, History",A young boy struggles on his own in a run-down motel after his parents and younger brother are separated from him in 1930s Depression-era Midwest.,86.0,Steven Soderbergh,King of the Hill,1993,103,USA, 8000000,1214231,1214231,0,-6785769,0
26601,352.0,"Action, Adventure, Sci-Fi",A pragmatic Paleontologist visiting an almost complete theme park is tasked with protecting a couple of kids after a power failure causes the park's cloned dinosaurs to run loose.,68.0,Steven Spielberg,Jurassic Park,1993,127,USA, 63000000,402828120,1030314141,627486021,967314141,1
26387,51.0,"Adventure, Comedy, Family","When a Jamaican sprinter is disqualified from the Olympic Games, he enlists the help of a dishonored coach to start the first Jamaican Bobsled Team.",60.0,Jon Turteltaub,Cool Runnings,1993,98,USA, 14000000,68856263,154856263,86000000,140856263,1
26362,112.0,"Crime, Drama, Thriller","A Puerto Rican former convict, just released from prison, pledges to stay away from drugs and violence despite the pressure around him and lead on to a better life outside of N.Y.C.",65.0,Brian De Palma,Carlito's Way,1993,144,USA, 30000000,36948322,63851527,26903205,33851527,1
26355,55.0,"Crime, Drama, Romance",A father becomes worried when a local gangster befriends his son in the Bronx in the 1960s.,80.0,Robert De Niro,A Bronx Tale,1993,121,USA, 22000000,17287898,17287898,0,-4712102,0
26349,5.0,Drama,"In this story of a black policeman during South African apartheid, Danny Glover plays the cop, who believes he's trying to help his people, even while serving as a pawn of the racist ...",68.0,Morgan Freeman,Bopha!,1993,120,USA, 12000000,212483,212483,0,-11787517,0
26344,71.0,"Horror, Sci-Fi",A teenage girl and her father discover alien clones are replacing humans on a remote U.S. military base in Alabama.,65.0,Abel Ferrara,Body Snatchers,1993,87,USA, 13000000,428868,428868,0,-12571132,0
26400,94.0,"Horror, Mystery, Thriller",A writer's fictional alter ego wants to take over his life...at any price.,53.0,George A. Romero,The Dark Half,1993,122,USA, 15000000,10611160,10611160,0,-4388840,0
26270,70.0,"Drama, Romance","A tale of nineteenth-century New York high society in which a young lawyer falls in love with a woman separated from her husband, while he is engaged to the woman's cousin.",90.0,Martin Scorsese,The Age of Innocence,1993,139,USA, 34000000,32255440,32255440,0,-1744560,0
26267,59.0,"Comedy, Fantasy","The Addams Family try to rescue their beloved Uncle Fester from his gold-digging new love, a black widow named Debbie.",62.0,Barry Sonnenfeld,Addams Family Values,1993,94,USA, 47000000,48919043,48919043,0,1919043,1
26604,62.0,"Crime, Drama, Thriller","A journalist duo go on a tour of serial killer murder sites with two companions, unaware that one of them is a serial killer himself.",49.0,Dominic Sena,Kalifornia,1993,117,USA, 9000000,2395231,2395231,0,-6604769,0
26063,53.0,"Crime, Drama, Thriller","Upon arriving to a small town, a drifter is mistaken for a hitman, but when the real hitman arrives, complications ensue.",79.0,John Dahl,Red Rock West,1993,98,USA, 8000000,2502551,2502551,0,-5497449,0
26403,54.0,"Comedy, Romance","To avoid a potentially explosive scandal when the U.S. President goes into a coma, an affable temp agency owner with an uncanny resemblance is put in his place.",76.0,Ivan Reitman,Dave,1993,110,USA, 28000000,63270710,63270710,0,35270710,1
26586,132.0,"Fantasy, Horror, Thriller",Serial killer Jason Voorhees' supernatural origins are revealed.,17.0,Adam Marcus,Jason Goes to Hell: The Final Friday,1993,87,USA, 3000000,15935068,15935068,0,12935068,1
26404,166.0,Comedy,The adventures of high school and junior high students on the last day of school in May 1976.,78.0,Richard Linklater,Dazed and Confused,1993,102,USA, 6900000,7993039,7993039,0,1093039,1
26570,74.0,"Action, Crime, Drama","Secret Service agent Frank Horrigan (Clint Eastwood) couldn't save Kennedy, but he's determined not to let a clever assassin take out this president.",74.0,Wolfgang Petersen,In the Line of Fire,1993,128,USA, 40000000,102314823,176997168,74682345,136997168,1
26516,181.0,"Comedy, Fantasy, Romance",A weatherman finds himself inexplicably living the same day over and over again.,72.0,Harold Ramis,Groundhog Day,1993,101,USA, 14600000,70906973,70906973,0,56306973,1
26574,59.0,"Drama, Romance",A billionaire offers one million dollars to a young married couple for one night with the wife.,35.0,Adrian Lyne,Indecent Proposal,1993,117,USA, 38000000,106614059,266614059,160000000,228614059,1
26410,107.0,"Action, Crime, Sci-Fi",A police officer is brought out of suspended animation in prison to pursue an old ultra-violent nemesis who is loose in a non-violent future society.,34.0,Marco Brambilla,Demolition Man,1993,115,USA, 57000000,58055768,58055768,0,1055768,1
26471,71.0,"Drama, Mystery, Thriller",A young lawyer joins a prestigious law firm only to discover that it has a sinister dark side.,58.0,Sydney Pollack,The Firm,1993,154,USA, 42000000,158348367,270248367,111900000,228248367,1
26447,26.0,"Comedy, Drama, Romance","Sissy Hankshaw (Uma Thurman) is born with enormous thumbs that help her hitchhiking through the U.S. from a young age. She becomes a model in advertising, and her New York agent, ""the ...",28.0,Gus Van Sant,Even Cowgirls Get the Blues,1993,95,USA, 8000000,1708873,1708873,0,-6291127,0
26492,125.0,"Action, Crime, Drama","Dr. Richard Kimble, unjustly accused of murdering his wife, must find the real killer while being the target of a nationwide manhunt led by a seasoned U.S. Marshal.",87.0,Andrew Davis,The Fugitive,1993,130,USA, 44000000,183875760,368875760,185000000,324875760,1
27509,15.0,Comedy,"A high school senior visits college for the weekend, and stays at the wildest house on campus in this classic tale of anti-political-correctness.",42.0,Hart Bochner,PCU,1994,79,USA, 8000000,4330020,4330020,0,-3669980,0
27503,65.0,"Action, Adventure, Thriller",A mystical martial artist/environmental Agent takes on a ruthless oil corporation.,33.0,Steven Seagal,On Deadly Ground,1994,101,USA, 50000000,38590458,38590458,0,-11409542,0
27537,20.0,"Comedy, Crime",The Russian government hires the veterans of the,11.0,Alan Metter,Police Academy: Mission to Moscow,1994,83,USA, 6200000,126247,126247,0,-6073753,0
27493,47.0,"Comedy, Drama",A stubborn man past his prime reflects on his life of strict independence and seeks more from himself.,86.0,Robert Benton,Nobody's Fool,1994,110,USA, 20000000,39491975,39491975,0,19491975,1
27555,21.0,"Comedy, Drama",A chronicle of the interconnected lives of a group of people in the lead up to Paris Fashion Week.,48.0,Robert Altman,Pr√™t-√†-Porter,1994,133,USA, 18000000,11300653,11300653,0,-6699347,0
27482,31.0,"Action, Drama, Family",Mr. Miyagi is back and he takes a new pupil under his wing; a troubled adolescent girl.,36.0,Christopher Cain,The Next Karate Kid,1994,107,USA, 12000000,8914777,15876353,6961576,3876353,1
27453,25.0,"Comedy, Drama",The events focus around a crisis hotline business on one crazy night during the Christmas holidays.,14.0,Nora Ephron,Mixed Nuts,1994,97,USA, 15000000,6821850,6821850,0,-8178150,0
27471,52.0,"Comedy, Crime",Frank Drebin comes out of retirement to help Police Squad infiltrate a gang of terrorists planning to detonate a bomb at the Academy Awards.,63.0,Peter Segal,Naked Gun 33 1/3: The Final Insult,1994,83,USA, 30000000,51132598,51132598,0,21132598,1
27470,32.0,"Drama, Horror","This ultra-hip, post-modern vampire tale is set in contemporary New York City. Members of a dysfunctional family of vampires are trying to come to terms with each other, in the wake of ...",64.0,Michael Almereyda,Nadja,1994,93,USA, 1000000,443169,443169,0,-556831,0
27433,46.0,"Action, Adventure, Comedy","Bret Maverick, needing money for a poker tournament, faces various comic mishaps and challenges, including a charming woman thief.",62.0,Richard Donner,Maverick,1994,127,USA, 75000000,101631272,183031272,81400000,108031272,1
27431,70.0,"Comedy, Crime, Fantasy",Bank clerk Stanley Ipkiss is transformed into a manic superhero when he wears a mysterious mask.,56.0,Chuck Russell,The Mask,1994,101,USA, 23000000,119938730,351583407,231644677,328583407,1
27409,14.0,"Comedy, Drama, Romance","Ex-football star Mike Gambril meets Terry McKay on a flight to Sydney, which is forced to land on a small atoll. Both engaged to others, they become romantic on board the ship sent to take ...",55.0,Glenn Gordon Caron,Love Affair,1994,108,USA, 60000000,18272894,18272894,0,-41727106,0
27402,33.0,"Crime, Drama",Early 1990s drama about a family of Soviet Jews living in Brooklyn's Brighton Beach ocean-side neighborhood nicknamed Little Odessa.,62.0,James Gray,Little Odessa,1994,98,USA, 2300000,1095885,1095885,0,-1204115,0
27558,278.0,"Crime, Drama","The lives of two mob hitmen, a boxer, a gangster and his wife, and a pair of diner bandits intertwine in four tales of violence and redemption.",94.0,Quentin Tarantino,Pulp Fiction,1994,154,USA, 8000000,107928762,214179088,106250326,206179088,1
27403,14.0,"Comedy, Family, Romance","Alfalfa is wooing Darla and his ""He-Man-Woman-Hating"" friends attempt to sabotage the relationship.",45.0,Penelope Spheeris,The Little Rascals,1994,82,USA, 23000000,52125282,67308282,15183000,44308282,1
27474,157.0,"Crime, Drama",Two victims of traumatized childhoods become lovers and psychopathic serial murderers irresponsibly glorified by the mass media.,74.0,Oliver Stone,Natural Born Killers,1994,118,USA, 34000000,50282766,50282766,0,16282766,1
27564,51.0,"Biography, Drama, History","A young lawyer, Richard Goodwin, investigates a potentially fixed game show. Charles Van Doren, a big time show winner, is under Goodwin's investigation.",88.0,Robert Redford,Quiz Show,1994,133,USA, 31000000,24822619,24822619,0,-6177381,0
28512,41.0,"Comedy, Crime","A young, naive Hollywood studio assistant finally turns the tables on his incredibly abusive producer boss.",66.0,George Huang,Swimming with Sharks,1994,93,USA, 700000,382928,382928,0,-317072,0
27397,225.0,"Animation, Adventure, Drama","A Lion cub crown prince is tricked by a treacherous uncle into thinking he caused his father's death and flees into exile in despair, only to learn in adulthood his identity and his responsibilities.",88.0,"Roger Allers, Rob Minkoff",The Lion King,1994,88,USA, 45000000,422783777,968511805,545728028,923511805,1
28179,159.0,"Drama, Horror, Mystery",An insurance investigator begins discovering that the impact a horror writer's books have on his fans is more than inspirational.,53.0,John Carpenter,In the Mouth of Madness,1994,95,USA, 8000000,8924549,8924549,0,924549,1
28022,41.0,"Comedy, Drama, Romance","A psychiatrist must cure a young patient that presents himself as Don Juan, the greatest lover in the world.",63.0,Jeremy Leven,Don Juan DeMarco,1994,97,USA, 25000000,22150451,68792531,46642080,43792531,1
27786,47.0,"Adventure, Biography, Crime",The story of Wyatt Earp as he interacts and battles other famous figures of the Wild West era.,47.0,Lawrence Kasdan,Wyatt Earp,1994,191,USA, 63000000,25052000,25052000,0,-37948000,0
27769,97.0,"Fantasy, Horror, Mystery",A demonic force has chosen Freddy Krueger as its portal to the real world. Can,64.0,Wes Craven,Wes Craven's New Nightmare,1994,112,USA, 8000000,18090181,19721741,1631560,11721741,1
27725,95.0,"Action, Comedy, Thriller","A fearless, globe-trotting, terrorist-battling secret agent has his life turned upside down when he discovers his wife might be having an affair with a used car salesman while terrorists smuggle nuclear war heads into the United States.",63.0,James Cameron,True Lies,1994,141,USA, 115000000,146282411,378882411,232600000,263882411,1
27683,37.0,"Action, Adventure, Crime","A homeless man is hired as a survival guide for a group of wealthy businessmen on a hunting trip in the mountains, unaware that they are killers who hunt humans for sport, and that he is their new prey.",41.0,Ernest R. Dickerson,Surviving the Game,1994,96,USA, 7400000,7727256,7727256,0,327256,1
27673,113.0,"Action, Adventure, Mystery","With the help of long presumed dead Captain Kirk, Captain Picard must stop a deranged scientist willing to murder on a planetary scale in order to enter a space matrix.",55.0,David Carson,Star Trek: Generations,1994,118,USA, 35000000,75671125,118071125,42400000,83071125,1
27667,124.0,"Action, Adventure, Thriller",A young police officer must prevent a bomb exploding aboard a city bus by keeping its speed above 50 mph.,78.0,Jan de Bont,Speed,1994,116,USA, 30000000,121248145,350448145,229200000,320448145,1
27663,34.0,"Comedy, Drama","About to stay a summer internship, promising younng medical student, Raymond Aibelli's mother, Susan, breaks her leg. Housebound and immobile, his father, Tom makes Raymond stay home, and ...",66.0,David O. Russell,Spanking the Monkey,1994,100,USA, 200000,1359736,1359736,0,1159736,1
27628,224.0,Drama,"Two imprisoned men bond over a number of years, finding solace and eventual redemption through acts of common decency.",80.0,Frank Darabont,The Shawshank Redemption,1994,142,USA, 25000000,28699976,28781790,81814,3781790,1
27619,65.0,"Comedy, Crime, Thriller",A sweet mother finds herself participating in homicidal activities when she sees the occasion call for it.,64.0,John Waters,Serial Mom,1994,95,USA, 13000000,7820688,7820688,0,-5179312,0
27605,76.0,"Comedy, Drama, Family","When a man inadvertently makes Santa fall off of his roof on Christmas Eve, he finds himself magically recruited to take his place.",57.0,John Pasquin,The Santa Clause,1994,97,USA, 22000000,144833357,189833357,45000000,167833357,1
27587,21.0,"Comedy, Family",A rich young boy finds his family targeted in an inside job and must use his cunning to save them.,49.0,Donald Petrie,Ri¬¢hie Ri¬¢h,1994,95,USA, 40000000,38087756,38087756,0,-1912244,0
27583,67.0,"Comedy, Horror, Thriller","A group of teenagers get into a car crash in the Texas woods on prom night, and then wander into an old farmhouse that is home to Leatherface and his insane family of cannibalistic psychopaths.",50.0,Kim Henkel,The Return of the Texas Chainsaw Massacre,1994,87,USA, 600000,185898,185898,0,-414102,0
27580,14.0,"Comedy, Drama",A failed businessman is hired by the army to teach a group of underachieving recruits in order to help them pass basic training.,44.0,Penny Marshall,Renaissance Man,1994,128,USA, 40000000,24332324,24332324,0,-15667676,0
27571,51.0,"Comedy, Drama, Romance","A documentary filmmaker and her fellow Gen X graduates face life after college, looking for work and love in Houston.",67.0,Ben Stiller,Reality Bites,1994,99,USA, 11500000,20982557,33351557,12369000,21851557,1
27356,41.0,"Comedy, Romance, Sci-Fi","As part of a fertility research project, a male scientist agrees to carry a pregnancy in his own body.",59.0,Ivan Reitman,Junior,1994,109,USA, 60000000,36763355,108431355,71668000,48431355,1
27147,32.0,"Comedy, Drama",,65.0,Spike Lee,Crooklyn,1994,115,USA, 14000000,13642861,13642861,0,-357139,0
27136,60.0,"Mystery, Romance, Thriller","A color-blind psychiatrist Bill Capa is stalked by an unknown killer after taking over his murdered friend's therapy group, all of whom have a connection to a mysterious young woman that Capa begins having intense sexual encounters with.",36.0,Richard Rush,Color of Night,1994,121,USA, 40000000,19726050,19726050,0,-20273950,0
27131,48.0,"Crime, Drama, Mystery",A young boy who witnessed the suicide of a mafia lawyer hires an attorney to protect him when the District Attorney tries to use him to take down a mob family.,65.0,Joel Schumacher,The Client,1994,119,USA, 45000000,92115211,117615211,25500000,72615211,1
27130,135.0,Comedy,"A day in the lives of two convenience clerks named Dante and Randal as they annoy customers, discuss movies, and play hockey on the store roof.",70.0,Kevin Smith,Clerks,1994,92,USA, 27000,3151130,3151130,0,3124130,1
27125,14.0,Comedy,"One year after their first western adventure, Mitch Robbins and his friends discover a treasure map that belonged to their late trail guide Curly and they set out to discover its secrets.",43.0,Paul Weiland,City Slickers II: The Legend of Curly's Gold,1994,116,USA, 40000000,43622150,43622150,0,3622150,1
27064,39.0,"Action, Comedy, Crime","Axel Foley, while investigating a car theft ring, comes across something much bigger than that: the same men who killed his boss are running a counterfeit money ring out of a theme park in Los Angeles.",16.0,John Landis,Beverly Hills Cop III,1994,104,USA, 50000000,42614912,119208989,76594077,69208989,1
27057,42.0,"Comedy, Drama, Romance","Ted, a stuffy white guy from Illinois working in sales for the Barcelona office of a US corporation, is paid an unexpected visit by his somewhat less stuffy cousin Fred, who is an officer ...",74.0,Whit Stillman,Barcelona,1994,101,USA, 3200000,7266973,7266973,0,4066973,1
27039,23.0,"Comedy, Family, Fantasy","When a boy prays for a chance to have a family if the California Angels win the pennant, angels are assigned to make that possible.",44.0,William Dear,Angels in the Outfield,1994,102,USA, 24000000,50236831,50236831,0,26236831,1
27388,63.0,"Drama, Romance, War","In the early 1900s, three brothers and their father living in the remote wilderness of Montana are affected by betrayal, history, love, nature, and war.",45.0,Edward Zwick,Legends of the Fall,1994,133,USA, 30000000,66638883,160638883,94000000,130638883,1
27148,143.0,"Action, Drama, Fantasy",A man brutally murdered comes back to life as an undead avenger of his and his fianc√©e's murder.,71.0,Alex Proyas,The Crow,1994,102,USA, 23000000,50693129,50693129,0,27693129,1
27186,60.0,"Drama, Thriller","A computer specialist is sued for sexual harassment by a former lover turned boss who initiated the act forcefully, which threatens both his career and his personal life.",58.0,Barry Levinson,Disclosure,1994,128,USA, 55000000,83015089,214015089,131000000,159015089,1
27017,79.0,Comedy,A goofy detective specializing in animals goes in search of the missing mascot of the Miami Dolphins.,37.0,Tom Shadyac,Ace Ventura: Pet Detective,1994,86,USA, 15000000,72217396,107217396,35000000,92217396,1
27354,23.0,"Adventure, Family, Romance","Rudyard Kipling's classic tale of Mowgli, the orphaned jungle boy raised by wolves, and how he becomes king of the jungle.",63.0,Stephen Sommers,The Jungle Book,1994,111,USA, 27000000,43229904,43229904,0,16229904,1
27339,37.0,"Comedy, Drama, Romance",A police officer promises to share his lottery ticket with a waitress in lieu of a tip.,64.0,Andrew Bergman,It Could Happen to You,1994,101,USA, 20000000,37939757,37939757,0,17939757,1
27317,33.0,"Comedy, Romance","A mechanic romances the mathematician niece of physicist Albert Einstein, with help from Einstein and his friends.",66.0,Fred Schepisi,I.Q.,1994,100,USA, 25000000,26381221,26381221,0,1381221,1
27334,136.0,"Drama, Horror","A vampire tells his epic life story: love, betrayal, loneliness, and hunger.",59.0,Neil Jordan,Interview with the Vampire: The Vampire Chronicles,1994,123,USA, 60000000,105264608,223664608,118400000,163664608,1
27276,24.0,"Comedy, Drama","A former U.S. First Lady wants a particular Secret Service agent to head her bodyguard detail, even though he can't stand her.",46.0,Hugh Wilson,Guarding Tess,1994,96,USA, 20000000,27058304,27058304,0,7058304,1
27197,92.0,Comedy,"After a woman leaves a briefcase at the airport terminal, a dumb limo driver and his dumber friend set out on a hilarious cross-country road trip to Aspen, to return the briefcase to its owner.",41.0,"Peter Farrelly, Bobby Farrelly",Dumb and Dumber,1994,107,USA, 17000000,127175374,247275374,120100000,230275374,1
27203,167.0,"Biography, Comedy, Drama",Ambitious but troubled movie director,70.0,Tim Burton,Ed Wood,1994,127,USA, 18000000,5887457,5887457,0,-12112543,0
27226,13.0,"Comedy, Romance","Kathy is married to Peter. Now she can't help but wonder how things could have been if she got together with her old boyfriend, Tom. Being married prevents from doing that so she asks her ...",51.0,Donald Petrie,The Favor,1994,97,USA, 13000000,3134381,3134381,0,-9865619,0
27245,163.0,"Drama, Romance","The presidencies of Kennedy and Johnson, the events of Vietnam, Watergate, and other history unfold through the perspective of an Alabama man with an IQ of 75.",82.0,Robert Zemeckis,Forrest Gump,1994,142,USA, 55000000,330455270,678151134,347695864,623151134,1
27241,45.0,"Comedy, Family, Fantasy","In a parallel modern-day Stone Age world, a working-class family, the Flintstones, are set up for an executive job. But they learn that money can't buy happiness.",38.0,Brian Levant,The Flintstones,1994,91,USA, 46000000,130531208,341631208,211100000,295631208,1
28337,88.0,"Biography, Drama, History","A biographical story of former U.S. President Richard Milhous Nixon, from his days as a young boy, to his eventual Presidency, which ended in shame.",66.0,Oliver Stone,Nixon,1995,192,USA, 44000000,13681765,13681765,0,-30318235,0
28400,102.0,"Animation, Adventure, Drama",An English soldier and the daughter of an Algonquin chief share a romance when English colonists invade seventeenth-century Virginia.,58.0,"Mike Gabriel, Eric Goldberg",Pocahontas,1995,81,USA, 55000000,141579773,346079773,204500000,291079773,1
28380,27.0,Comedy,"Party girl Mary gets bailed out of jail by her librarian godmother. She starts working at the library, slowly fills her empty brain and gets anal.",55.0,Daisy von Scherler Mayer,Party Girl,1995,94,USA, 150000,472370,472370,0,322370,1
28366,71.0,"Action, Drama, Thriller",Army doctors struggle to find a cure for a deadly virus spreading throughout a California town that was brought to America by an African monkey.,65.0,Wolfgang Petersen,Outbreak,1995,127,USA, 50000000,67659560,189859560,122200000,139859560,1
28327,57.0,"Action, Crime, Drama","A computer programmer stumbles upon a conspiracy, putting her life and the lives of those around her in great danger.",51.0,Irwin Winkler,The Net,1995,114,USA, 22000000,50727965,110627965,59900000,88627965,1
28305,43.0,"Drama, Music",A frustrated composer finds fulfillment as a high school music teacher.,59.0,Stephen Herek,Mr. Holland's Opus,1995,143,USA, 23000000,82569971,106269971,23700000,83269971,1
28302,86.0,"Action, Adventure, Fantasy",Three unknowing martial artists are summoned to a mysterious island to compete in a tournament whose outcome will decide the fate of the world.,58.0,Paul W.S. Anderson,Mortal Kombat,1995,101,USA, 18000000,70454098,122195920,51741822,104195920,1
28287,53.0,"Comedy, Fantasy, Romance","When he discovers his adopted son is a genius, a New York sportswriter seeks out the boy's birth mother: a ditzy porn star and prostitute.",59.0,Woody Allen,Mighty Aphrodite,1995,95,USA, 15000000,6468498,6468498,0,-8531502,0
28273,93.0,"Comedy, Romance","Both dumped by their girlfriends, two best friends seek refuge in the local mall.",41.0,Kevin Smith,Mallrats,1995,94,USA, 6000000,2122561,2122561,0,-3877439,0
28258,49.0,"Comedy, Drama",Film about filmmaking. It takes place during one day on set of non-budget movie. Ultimate tribute to all independent filmmakers.,81.0,Tom DiCillo,Living in Oblivion,1995,90,USA, 500000,1111790,1111790,0,611790,1
28526,45.0,"Crime, Drama",Five different criminals face imminent death after botching a job quite badly.,46.0,Gary Fleder,Things to Do in Denver When You're Dead,1995,115,USA, 7000000,529766,529766,0,-6470234,0
28585,77.0,"Comedy, Drama","An awkward seventh grader struggles to cope with inattentive parents, snobbish classmates, a smart older brother, an attractive younger sister and her own insecurities in suburban New Jersey.",83.0,Todd Solondz,Welcome to the Dollhouse,1995,88,USA, 800000,4569019,4569019,0,3769019,1
28589,65.0,"Comedy, Drama, Romance",A hopeless romantic Chicago Transit Authority token collector is mistaken for the fianc√©e of a coma patient.,67.0,Jon Turteltaub,While You Were Sleeping,1995,103,USA, 17000000,81057016,182057016,101000000,165057016,1
28584,121.0,"Action, Adventure, Sci-Fi","In a future where the polar ice-caps have melted and Earth is almost entirely submerged, a mutated mariner fights starvation and outlaw ""smokers,"" and reluctantly helps a woman and a young girl try to find dry land.",56.0,Kevin Reynolds,Waterworld,1995,135,USA, 175000000,88246220,264218220,175972000,89218220,1
28574,53.0,"Action, Crime, Sci-Fi","When a virtual reality simulation created using the personalities of multiple serial killers manages to escape into the real world, an ex-cop is tasked with stopping its reign of terror.",39.0,Brett Leonard,Virtuosity,1995,106,USA, 30000000,24047675,24047675,0,-5952325,0
28573,92.0,"Horror, Sci-Fi, Thriller",A small town's women give birth to unfriendly alien children posing as humans.,41.0,John Carpenter,Village of the Damned,1995,98,USA, 22000000,9418365,9418365,0,-12581635,0
28568,38.0,"Comedy, Fantasy, Horror","A ship sails into Brooklyn with all its crew dead. But something gets off and the killing continues on land. The vampire is looking for a specific woman - half-human, half-vampire. Rita's the cop detective investigating the many killings.",27.0,Wes Craven,Vampire in Brooklyn,1995,100,USA, 20000000,19751736,19751736,0,-248264,0
28560,31.0,"Crime, Thriller",A recovering gambling addict attempts to reconcile with his family and friends but finds trouble and temptation when caught between feelings for his ex-wife and her dangerous hoodlum boyfriend.,69.0,Steven Soderbergh,Underneath,1995,99,USA, 6500000,536023,536023,0,-5963977,0
28556,60.0,"Action, Thriller","Casey Ryback hops on a Colorado to LA train to start a vacation with his niece. Early into the trip, terrorists board the train and use it as a mobile HQ to hijack a top secret destructive US satellite.",52.0,Geoff Murphy,Under Siege 2: Dark Territory,1995,100,USA, 60000000,50024083,104324083,54300000,44324083,1
28549,176.0,"Mystery, Sci-Fi, Thriller","In a future world devastated by disease, a convict is sent back in time to gather information about the man-made virus that wiped out most of the human population on the planet.",74.0,Terry Gilliam,Twelve Monkeys,1995,129,USA, 29000001,57141459,168839459,111698000,139839458,1
28542,193.0,"Animation, Adventure, Comedy",A cowboy doll is profoundly threatened and jealous when a new spaceman figure supplants him as top toy in a boy's room.,95.0,John Lasseter,Toy Story,1995,81,USA, 30000000,222498679,406594102,184095423,376594102,1
28513,76.0,"Action, Fantasy, Horror",A man on the run is hunted by a demon known as the Collector.,48.0,Ernest R. Dickerson,Tales from the Crypt: Demon Knight,1995,92,USA, 13000000,21089146,21089146,0,8089146,1
28254,30.0,"Drama, Family, Fantasy",A young girl is relegated to servitude at a boarding school when her father goes missing and is presumed dead.,83.0,Alfonso Cuar√≥n,A Little Princess,1995,97,USA, 17000000,10015449,10015449,0,-6984551,0
28503,110.0,"Action, Crime, Drama",A former cop turned street-hustler accidentally uncovers a conspiracy in Los Angeles in 1999.,66.0,Kathryn Bigelow,Strange Days,1995,145,USA, 42000000,7959291,7959291,0,-34040709,0
28494,119.0,"Action, Horror, Sci-Fi",A group of scientists try to track down and trap a killer alien seductress before she successfully mates with a human.,49.0,Roger Donaldson,Species,1995,108,USA, 35000000,60074103,113374103,53300000,78374103,1
28459,258.0,"Crime, Drama, Mystery","Two detectives, a rookie and a veteran, hunt a serial killer who uses the seven deadly sins as his motives.",65.0,David Fincher,Se7en,1995,127,USA, 33000000,100125643,327311859,227186216,294311859,1
27976,92.0,"Action, Drama, Thriller","On a U.S. nuclear missile sub, a young First Officer stages a mutiny, to prevent his trigger happy Captain from launching his missiles, before confirming his orders to do so.",66.0,Tony Scott,Crimson Tide,1995,116,USA, 53000000,91387195,157387195,66000000,104387195,1
28206,101.0,"Adventure, Comedy, Family","When two kids find and play a magical board game, they release a man trapped for decades in it and a host of dangers that can only be stopped by finishing the game.",39.0,Joe Johnston,Jumanji,1995,104,USA, 65000000,100499940,262821940,162322000,197821940,1
27977,46.0,"Drama, Thriller",Freddy Gale is a seedy jeweller who has sworn to kill the drunk driver who killed his little girl.,46.0,Sean Penn,The Crossing Guard,1995,111,USA, 9000000,868979,868979,0,-8131021,0
27970,63.0,"Drama, Mystery, Thriller",An agoraphobic psychologist and a female detective must work together to take down a serial killer who copies serial killers from the past.,54.0,Jon Amiel,Copycat,1995,123,USA, 20000000,32051917,32051917,0,12051917,1
27968,71.0,"Action, Adventure, Mystery","When an expedition to the African Congo ends in disaster, a new team is assembled to find out what went wrong.",22.0,Frank Marshall,Congo,1995,109,USA, 50000000,81022101,152022101,71000000,102022101,1
27960,100.0,"Comedy, Romance","A rich high school student tries to boost a new pupil's popularity, but reckons without affairs of the heart getting in the way.",68.0,Amy Heckerling,Clueless,1995,97,USA, 12000000,56631572,56631572,0,44631572,1
27958,51.0,"Crime, Drama, Mystery","Young drug pushers in the projects of Brooklyn live hard dangerous lives, trapped between their drug bosses and the detectives out to stop them.",71.0,Spike Lee,Clockers,1995,128,USA, 25000000,13071518,13071518,0,-11928482,0
27943,38.0,"Comedy, Family, Fantasy",An afterlife therapist and his daughter meet a friendly young ghost when they move into a crumbling mansion in order to rid the premises of wicked spirits.,49.0,Brad Silberling,Casper,1995,100,USA, 50000000,100328194,287928194,187600000,237928194,1
27919,31.0,"Comedy, Drama, Romance","Three Irish Catholic brothers from Long Island struggle to deal with love, marriage, and infidelity.",73.0,Edward Burns,The Brothers McMullen,1995,98,USA, 238000,10426506,10426506,0,10188506,1
27917,82.0,"Drama, Romance","Photographer Robert Kincaid (Clint Eastwood) wanders into the life of housewife Francesca Johnson (Meryl Streep), for four days in the 1960s.",66.0,Clint Eastwood,The Bridges of Madison County,1995,135,USA, 24000000,71516617,182016617,110500000,158016617,1
27914,151.0,"Biography, Drama, History","When his secret bride is executed for assaulting an English soldier who tried to rape her, William Wallace begins a revolt against King Edward I of England.",68.0,Mel Gibson,Braveheart,1995,178,USA, 72000000,75609945,213216216,137606271,141216216,1
27913,33.0,Comedy,"The original '70s T.V. family is now placed in the 1990s, where they're even more square and out of place than ever.",54.0,Betty Thomas,The Brady Bunch Movie,1995,90,USA, 12000000,46576136,46576136,0,34576136,1
27996,40.0,"Biography, Drama",An ex-Marine turned teacher struggles to connect with her students in an inner city school.,47.0,John N. Smith,Dangerous Minds,1995,99,USA, 23000000,84919401,179519401,94600000,156519401,1
27891,49.0,Comedy,"In order to inherit his fed up father's hotel empire, an immature and lazy man must repeat grades 1-12 all over again.",16.0,Tamra Davis,Billy Madison,1995,89,USA, 10000000,25588734,26488734,900000,16488734,1
27867,77.0,"Action, Comedy, Crime",Two hip detectives protect a witness to a murder while investigating a case of stolen heroin from the evidence storage room from their police precinct.,41.0,Michael Bay,Bad Boys,1995,119,USA, 19000000,65807024,141407024,75600000,122407024,1
27849,165.0,"Adventure, Drama, History",NASA must devise a strategy to return Apollo 13 to Earth safely after the spacecraft undergoes massive internal damage putting the lives of the three astronauts on board in jeopardy.,77.0,Ron Howard,Apollo 13,1995,140,USA, 52000000,173837933,355237933,181400000,303237933,1
27836,58.0,"Comedy, Drama, Romance","A widowed U.S. President running for reelection and an environmental lobbyist fall in love. It's all above-board, but ""politics is perception,"" and sparks fly anyway.",67.0,Rob Reiner,The American President,1995,114,USA, 62000000,60079496,107879496,47800000,45879496,1
27819,67.0,"Adventure, Comedy, Crime","Ace Ventura, Pet Detective, returns from a spiritual quest to investigate the disappearance of a rare white bat, the sacred animal of a tribe in Africa.",45.0,Steve Oedekerk,Ace Ventura: When Nature Calls,1995,90,USA, 30000000,108385533,212385533,104000000,182385533,1
28218,72.0,Drama,"A day in the life of a group of teens as they travel around New York City skating, drinking, smoking and deflowering virgins.",63.0,Larry Clark,Kids,1995,91,USA, 1500000,7412216,7412216,0,5912216,1
27901,33.0,Comedy,"Brooklyn Cigar Store is a neighborhood hangout in Brooklyn with Auggie Wren/H.Keitel as center. Some people are interviewed about Brooklyn, spiced up with statistics on Brooklyn.",54.0,"Paul Auster, Wayne Wang",Blue in the Face,1995,83,USA, 2000000,1268636,1268636,0,-731364,0
28016,164.0,"Action, Adventure, Thriller","John McClane and a Harlem store owner are targeted by German terrorist Simon Gruber in New York City, where he plans to rob the Federal Reserve Building.",58.0,John McTiernan,Die Hard: With a Vengeance,1995,128,USA, 90000000,100012499,366236538,266224039,276236538,1
28014,62.0,"Crime, Drama, Mystery","An African-American man is hired to find a woman, and gets mixed up in a murderous political scandal.",78.0,Carl Franklin,Devil in a Blue Dress,1995,102,USA, 27000000,16140822,16140822,0,-10859178,0
28182,27.0,"Drama, Family, Fantasy","Omri, a young boy growing up in Brooklyn, receives an odd variety of presents for his birthday: a wooden cabinet from his older brother, a set of antique keys from his mother and a tiny plastic model of an Indian from his best friend Patrick.",58.0,Frank Oz,The Indian in the Cupboard,1995,96,USA, 45000000,35656131,35656131,0,-9343869,0
28147,203.0,"Crime, Drama, Thriller",A group of professional bank robbers start to feel the heat from police when they unknowingly leave a clue at their latest heist.,76.0,Michael Mann,Heat,1995,170,USA, 60000000,67436818,187436818,120000000,127436818,1
28140,139.0,"Horror, Thriller","Six years after Michael Myers last terrorized Haddonfield, he returns there in pursuit of his niece, Jamie Lloyd, who has escaped with her newborn child, for which Michael and a mysterious cult have sinister plans.",10.0,Joe Chappelle,Halloween: The Curse of Michael Myers,1995,87,USA, 5000000,15116634,15116634,0,10116634,1
28137,92.0,"Comedy, Crime, Drama",Hackers are blamed for making a virus that will capsize five oil tankers.,46.0,Iain Softley,Hackers,1995,107,USA, 20000000,7563728,7563728,0,-12436272,0
28158,52.0,"Comedy, Drama, Romance","After losing her job, making out with her soon-to-be former boss, and finding out that her daughter plans to spend Thanksgiving with her boyfriend, Claudia Larson faces spending the holiday with her family.",56.0,Jodie Foster,Home for the Holidays,1995,103,USA, 20000000,17519169,17519169,0,-2480831,0
28131,26.0,"Comedy, Romance","John and Max resolve to save their beloved bait shop from turning into an Italian restaurant, just as its new female owner catches Max's attention.",46.0,Howard Deutch,Grumpier Old Men,1995,101,USA, 25000000,71518503,71518503,0,46518503,1
28112,105.0,"Comedy, Crime, Thriller","A mobster travels to Hollywood to collect a debt, and discovers that the movie business is much the same as his current job.",82.0,Barry Sonnenfeld,Get Shorty,1995,105,USA, 30250000,72101622,115101622,43000000,84851622,1
28098,24.0,"Comedy, Drama","Two homies, Smokey and Craig, smoke a dope dealer's weed and try to figure a way to get the $200 they owe to the dealer by 10 p.m. that same night.",54.0,F. Gary Gray,Friday,1995,91,USA, 3500000,27467564,28215918,748354,24715918,1
28065,38.0,"Comedy, Family, Romance","George Banks must deal not only with the pregnancy of his daughter, but also with the unexpected pregnancy of his wife.",49.0,Charles Shyer,Father of the Bride Part II,1995,106,USA, 30000000,76594107,76594107,0,46594107,1
28057,45.0,"Action, Crime, Romance","Max Kirkpatrick is a cop who protects Kate McQuean, a civil law attorney, from a renegade KGB team out to terminate her.",13.0,Andrew Sipes,Fair Game,1995,91,USA, 50000000,11534477,11534477,0,-38465523,0
29157,19.0,"Comedy, Drama, Romance",Connie Doyle is eighteen and pregnant when her boyfriend kicks her out. She accidentally ends up on a train where she meets Hugh Winterbourne and his wife Patricia who is pregnant. The ...,35.0,Richard Benjamin,Mrs. Winterbourne,1996,105,USA, 25000000,10082005,10082005,0,-14917995,0
29163,30.0,"Adventure, Comedy","Two former U. S. Presidents, hated rivals, join forces to expose the current, corrupt President at the risk of their lives.",49.0,Peter Segal,My Fellow Americans,1996,101,USA, 21500000,22313201,22313201,0,813201,1
29245,88.0,"Crime, Drama, Mystery","An altar boy is accused of murdering a priest, and the truth is buried several layers deep.",47.0,Gregory Hoblit,Primal Fear,1996,129,USA, 30000000,56116183,102616183,46500000,72616183,1
29226,58.0,"Drama, Fantasy, Romance","An ordinary man sees a bright light descend from the sky, and discovers he now has super-intelligence and telekinesis.",41.0,Jon Turteltaub,Phenomenon,1996,123,USA, 32000000,104636382,152036382,47400000,120036382,1
29220,80.0,"Biography, Drama",The story of a controversial pornography publisher and how he became a defender of free speech.,79.0,Milos Forman,The People vs. Larry Flynt,1996,129,USA, 36000000,20300385,20300385,0,-15699615,0
29139,187.0,"Action, Adventure, Thriller","An American agent, under false suspicion of disloyalty, must discover and expose the real spy without the help of his organization.",59.0,Brian De Palma,Mission: Impossible,1996,110,USA, 80000000,180981856,457731166,276749310,377731166,1
29194,60.0,"Comedy, Romance, Sci-Fi",Grossly overweight yet good-hearted professor Sherman Klump takes a special chemical that turns him into the slim but obnoxious Buddy Love.,62.0,Tom Shadyac,The Nutty Professor,1996,95,USA, 54000000,128814019,273961019,145147000,219961019,1
29073,33.0,"Comedy, Family",A motivational speaker discovers that the inheritance his father left for him is in the form of an elephant.,43.0,Howard Franklin,Larger Than Life,1996,93,USA, 30000000,8315693,8315693,0,-21684307,0
29124,42.0,"Comedy, Family, Fantasy","Story of a wonderful little girl, who happens to be a genius, and her wonderful teacher vs. the worst parents ever and the worst school principal imaginable.",72.0,Danny DeVito,Matilda,1996,98,USA, 36000000,33459416,33459416,0,-2540584,0
29118,46.0,Drama,"After 20 years caring for her father, woman with cancer now must re-connect with her trashy sister and nephews she's never met after being diagnosed. Her love helps the angry teen nephew, and her sister learns to relate to people.",68.0,Jerry Zaks,Marvin's Room,1996,98,USA, 23000000,12803305,12803305,0,-10196695,0
29117,135.0,"Comedy, Sci-Fi",Earth is invaded by Martians with unbeatable weapons and a cruel sense of humor.,52.0,Tim Burton,Mars Attacks!,1996,106,USA, 70000000,37771017,101371017,63600000,31371017,1
29093,107.0,"Action, Crime, Drama",A woman suffering from amnesia begins to recover her memories after trouble from her past finds her again.,44.0,Renny Harlin,The Long Kiss Goodnight,1996,121,USA, 65000000,33447612,89456761,56009149,24456761,1
29092,76.0,"Drama, Mystery","When the skeleton of his murdered predecessor is found, Sheriff Sam Deeds unearths many other long-buried secrets in his Texas border town.",78.0,John Sayles,Lone Star,1996,135,USA, 5000000,12408986,12408986,0,7408986,1
29079,37.0,"Action, Sci-Fi, Thriller","Jobe is resuscitated by Jonathan Walker. He wants Jobe to create a special computer chip that would connect all the computers in the world into one network, which Walker would control and ...",29.0,Farhad Mann,Lawnmower Man 2: Beyond Cyberspace,1996,93,USA, 15000000,2409225,2409225,0,-12590775,0
29062,65.0,"Comedy, Sport","A star bowler whose career was prematurely ""cut off"" hopes to ride a new prodigy to success and riches.",43.0,"Bobby Farrelly, Peter Farrelly",Kingpin,1996,114,USA, 27000000,25023434,25023434,0,-1976566,0
29262,84.0,"Action, Crime, Thriller","Multimillionaire, Tom Mullen's beloved son is kidnapped. He cooperates at first, but then turns the tables on the kidnappers and decides to take matters into his own hands.",60.0,Ron Howard,Ransom,1996,121,USA, 80000000,136492681,309492681,173000000,229492681,1
29053,21.0,"Comedy, Family, Fantasy","A troubled kid inadvertently releases a genie, who must grant him any three wishes he requests.",24.0,Paul Michael Glaser,Kazaam,1996,93,USA, 20000000,18937262,18937262,0,-1062738,0
29404,28.0,"Drama, Thriller","A blackout leaves those affected to consider what is necessary, what is legal, and what is questionable, in order to survive in a predatory environment.",66.0,David Koepp,The Trigger Effect,1996,94,USA, 8000000,3622979,3622979,0,-4377021,0
29290,35.0,"Comedy, Fantasy, Mystery","Fletcher Munson, the lethargic employee of a pseudo-religious self help company, and his doppelganger, the friendly but dull dentist Dr. Jeffrey Korchek.",44.0,Steven Soderbergh,Schizopolis,1996,96,USA, 250000,10580,10580,0,-239420,0
29813,73.0,"Crime, Drama",Professional gambler Sydney teaches John the tricks of the trade. John does well until he falls for cocktail waitress Clementine.,78.0,Paul Thomas Anderson,Sydney,1996,102,USA, 3000000,222559,222559,0,-2777441,0
29446,54.0,Comedy,An aspiring director and the marginally talented amateur cast of a hokey small-town Missouri musical production go overboard when they learn that someone from Broadway will be in attendance.,71.0,Christopher Guest,Waiting for Guffman,1996,84,USA, 4000000,2923982,2923982,0,-1076018,0
29434,29.0,Comedy,"The Bradys receive a surprise visit when a man claiming to be Carol's long-lost first husband shows up at their residence, the family question his motives.",56.0,Arlene Sanford,A Very Brady Sequel,1996,90,USA, 12000000,21440752,21440752,0,9440752,1
29416,126.0,"Action, Adventure, Thriller","Bill and Jo Harding, advanced storm chasers on the brink of divorce, must join together to create an advanced weather alert system by putting themselves in the cross-hairs of extremely violent tornadoes.",68.0,Jan de Bont,Twister,1996,113,USA, 92000000,241721524,494471524,252750000,402471524,1
29025,89.0,"Comedy, Family","A father vows to get his son a Turbo Man action figure for Christmas. However, every store is sold out of them, and he must travel all over town and compete with everybody else in order to find one.",34.0,Brian Levant,Jingle All the Way,1996,89,USA, 60000000,60592389,129832389,69240000,69832389,1
29402,47.0,"Comedy, Drama","Tommy is an unemployed mechanic who spends most of his time in a bar (Trees Lounge) in a small blue collar town. He seems to always be thinking, ""If only X then I could stop drinking"".",76.0,Steve Buscemi,Trees Lounge,1996,95,USA, 1300000,749741,749741,0,-550259,0
29394,53.0,"Comedy, Drama, Romance",A washed up golf pro working at a driving range tries to qualify for the US Open in order to win the heart of his successful rival's girlfriend.,60.0,Ron Shelton,Tin Cup,1996,135,USA, 45000000,53854588,53854588,0,8854588,1
29392,79.0,"Crime, Drama, Thriller","In Canton, Mississippi, a fearless young lawyer and his assistant defend a black man accused of murdering two white men who raped his ten-year-old daughter, inciting violent retribution and revenge from the Ku Klux Klan.",54.0,Joel Schumacher,A Time to Kill,1996,149,USA, 40000000,108766007,152266007,43500000,112266007,1
29384,83.0,"Fantasy, Horror",An obese attorney is cursed by a gypsy to rapidly and uncontrollably lose weight.,33.0,Tom Holland,Thinner,1996,93,USA, 8500000,15315484,15315484,0,6815484,1
29382,75.0,"Comedy, Drama, Music","A local Pennsylvania band scores a one hit wonder in 1964 and rides the star-making machinery as long as they can, with lots of help from its manager.",71.0,Tom Hanks,That Thing You Do!,1996,108,USA, 26000000,25857416,34585416,8728000,8585416,1
29375,86.0,"Comedy, Fantasy, Horror",The Crypt Keeper returns to tell the story of a funeral parlor that moonlights as a vampire bordello.,36.0,Gilbert Adler,Bordello of Blood,1996,87,USA, 13000000,5781045,5781045,0,-7218955,0
29366,75.0,"Comedy, Drama",Wannabe actors become regulars in the stylish neo-lounge scene; Trent teaches his friend Mike the unwritten rules of the scene.,71.0,Doug Liman,Swingers,1996,96,USA, 200000,4555020,4555020,0,4355020,1
29362,25.0,"Biography, Drama, Romance","The passionate Merchant Ivory drama tells the story of Fran√ßoise Gilot (Natascha McElhone), the only lover of Pablo Picasso (Sir Anthony Hopkins) who was strong enough to withstand his ferocious cruelty, and move on with her life.",55.0,James Ivory,Surviving Picasso,1996,125,USA, 16000000,2021348,2021348,0,-13978652,0
29339,157.0,"Action, Adventure, Drama",The Borg travel back in time intent on preventing Earth's first contact with an alien species. Captain Picard and his crew pursue them to ensure that Zefram Cochrane makes his maiden flight reaching warp speed.,71.0,Jonathan Frakes,Star Trek: First Contact,1996,111,USA, 45000000,92027888,146027888,54000000,101027888,1
29337,26.0,"Action, Comedy","Dick Steele, Agent WD-40 is assigned by his Director, to stop the evil General Rancor from destroying the world. WD-40 believed Rancor was dead and he teams up with the hot K.G.B. Agent Veronique Ukrinsky to find Rancor and save the world.",25.0,Rick Friedberg,Spy Hard,1996,81,USA, 18000000,26960191,26960191,0,8960191,1
29329,64.0,"Animation, Adventure, Comedy","In a desperate attempt to win a basketball match and earn their freedom, the Looney Tunes seek the aid of retired basketball champion, Michael Jordan.",59.0,Joe Pytka,Space Jam,1996,88,USA, 80000000,90418342,230418342,140000000,150418342,1
29321,105.0,Drama,"Karl Childers, a simple man hospitalized since his childhood murder of his mother and her lover, is released to start a new life in a small town.",84.0,Billy Bob Thornton,Sling Blade,1996,135,USA, 1000000,24444121,24444121,0,23444121,1
29320,65.0,"Crime, Drama, Thriller","After a prank goes disastrously wrong, a group of boys are sent to a detention center where they are brutalized. Thirteen years later, they get their chance for revenge.",49.0,Barry Levinson,Sleepers,1996,147,USA, 44000000,53315285,165615285,112300000,121615285,1
29303,25.0,Comedy,"Sgt. Bilko is a well-liked conman in charge of the army base's motor pool, developing a hover tank and unofficially of gambling etc. One man hates Bilko and he's coming to inspect the base for possible closure.",47.0,Jonathan Lynn,Sgt. Bilko,1996,93,USA, 39000000,30356793,37956793,7600000,-1043207,0
29293,254.0,"Horror, Mystery","A year after the murder of her mother, a teenage girl is terrorized by a new killer, who targets the girl and her friends by using horror films as part of a deadly game.",65.0,Wes Craven,Scream,1996,111,USA, 14000000,103046663,173046663,70000000,159046663,1
29277,124.0,"Action, Adventure, Thriller","A mild-mannered chemist and an ex-con must lead the counterstrike when a rogue group of military men, led by a renegade general, threaten a nerve gas attack from Alcatraz against San Francisco.",58.0,Michael Bay,The Rock,1996,136,USA, 75000000,134069511,335062621,200993110,260062621,1
29021,116.0,"Comedy, Drama, Romance","When a sports agent has a moral epiphany and is fired for expressing it, he decides to put his new philosophy to the test as an independent agent with the only athlete who stays with him and his former secretary.",77.0,Cameron Crowe,Jerry Maguire,1996,139,USA, 50000000,153952592,273552592,119600000,223552592,1
28780,70.0,"Action, Drama, Mystery","A U.S. Army officer, despondent about a deadly mistake he made, investigates a female chopper commander's worthiness for the Medal of Honor.",77.0,Edward Zwick,Courage Under Fire,1996,116,USA, 46000000,59031057,100860818,41829761,54860818,1
28762,46.0,"Comedy, Drama","An irresponsible, drug-addicted, recently impregnated woman finds herself in the middle of an abortion debate when both parties attempt to sway her to their respective sides.",64.0,Alexander Payne,Citizen Ruth,1996,106,USA, 3000000,285112,285112,0,-2714888,0
28753,40.0,"Crime, Drama, Thriller",A young man fresh out of law school tries to win a reprieve for his racist grandfather who is on death row.,45.0,James Foley,The Chamber,1996,113,USA, 50000000,14551359,22540359,7989000,-27459641,0
28742,15.0,Comedy,"When his wife falls sick, a father - with an important business meeting - finds himself having to carpool for the neighborhood school children and is held hostage of a bank robber.",15.0,Arthur Hiller,Carpool,1996,89,USA, 17000000,3325651,3325651,0,-13674349,0
28732,81.0,"Comedy, Drama, Thriller","A lonely and mentally disturbed cable guy raised on television just wants a new friend, but his target, a designer, rejects him, with bad consequences.",56.0,Ben Stiller,The Cable Guy,1996,96,USA, 47000000,60240295,102825796,42585501,55825796,1
28718,83.0,"Action, Adventure, Thriller",Terrorists steal nuclear warheads from the U.S. military but don't count on a pilot and park ranger spoiling their plans.,61.0,John Woo,Broken Arrow,1996,108,USA, 50000000,70770147,150270147,79500000,100270147,1
28708,130.0,"Crime, Romance, Thriller","Corky, a tough female ex con and her lover Violet concoct a scheme to steal millions of stashed mob money and pin the blame on Violet's crooked boyfriend Caesar.",61.0,"Lana Wachowski, Lilly Wachowski",Bound,1996,109,USA, 4500000,3802260,3802260,0,-697740,0
28706,88.0,"Comedy, Crime, Drama",Three friends plan to pull off a simple robbery and go on the run.,66.0,Wes Anderson,Bottle Rocket,1996,91,USA, 7000000,560069,560069,0,-6439931,0
28690,76.0,Comedy,A gay cabaret owner and his drag queen companion agree to put up a false straight front so that their son can introduce them to his fianc√©e's right-wing moralistic parents.,72.0,Mike Nichols,The Birdcage,1996,117,USA, 31000000,124060553,185260553,61200000,154260553,1
28688,29.0,Comedy,"Moronic best friends get themselves locked inside the Bio-Dome, a science experiment, along with a group of environmental scientists for one year.",1.0,Jason Bloom,Bio-Dome,1996,88,USA, 15000000,13427615,13427615,0,-1572385,0
28686,56.0,"Drama, Romance","New Jersey, 1950s. Two brothers run an Italian restaurant. Business is not going well as a rival Italian restaurant is out-competing them. In a final effort to save the restaurant, the brothers plan to put on an evening of incredible food.",80.0,"Campbell Scott, Stanley Tucci",Big Night,1996,109,USA, 4100000,12008376,12008376,0,7908376,1
28675,63.0,"Animation, Adventure, Comedy",The dim-witted teen duo of Beavis and Butt-Head travel across America in search of their stolen television set.,64.0,"Mike Judge, Mike de Seve",Beavis and Butt-Head Do America,1996,81,USA, 12000000,63118386,63118386,0,51118386,1
28670,48.0,"Biography, Drama",The brief life of,65.0,Julian Schnabel,Basquiat,1996,107,USA, 3300000,3011195,3011195,0,-288805,0
29012,37.0,"Comedy, Drama, Fantasy","Because of an unusual aging disorder that has aged him four times faster than a normal human being, a boy enters the fifth grade for the first time with the appearance of a 40 year old man.",31.0,Francis Ford Coppola,Jack,1996,113,USA, 45000000,58620973,58620973,0,13620973,1
28728,33.0,"Action, Comedy, Crime","Two criminals, Keats and Moses, end their friendship, when Keats turns out to be an undercover cop. Many years later, the two are forced to work together when Keats is assigned to protect Moses as a witness.",30.0,Ernest R. Dickerson,Bulletproof,1996,84,USA, 25000000,21576954,22611954,1035000,-2388046,0
29001,210.0,"Action, Adventure, Sci-Fi","The aliens are coming and their goal is to invade and destroy Earth. Fighting superior technology, mankind's best weapon is the will to survive.",59.0,Roland Emmerich,Independence Day,1996,145,USA, 75000000,306169268,817400891,511231623,742400891,1
28833,32.0,Comedy,"Lt. Cmdr. Tom Dodge is assigned as Captain to the USS Stingray, an old diesel driven submarine that has seen better days.",39.0,David S. Ward,Down Periscope,1996,92,USA, 31000000,25785603,37553752,11768149,6553752,1
28988,86.0,"Animation, Drama, Family","A deformed bell-ringer must assert his independence from a vicious government minister in order to help his friend, a gypsy dancer.",74.0,"Gary Trousdale, Kirk Wise",The Hunchback of Notre Dame,1996,91,USA, 100000000,100138851,325338851,225200000,225338851,1
28967,100.0,"Horror, Sci-Fi","In the 22nd century, a scientist attempts to right the wrong his ancestor created: the puzzle box that opens the gates of Hell and unleashes Pinhead and his Cenobite legions.",21.0,Kevin Yagher,Hellraiser: Bloodline,1996,85,USA, 4000000,9336886,9336886,0,5336886,1
28957,69.0,"Comedy, Sport",A rejected hockey player puts his skills to the golf course to save his grandmother's house.,31.0,Dennis Dugan,Happy Gilmore,1996,92,USA, 12000000,38824099,41205099,2381000,29205099,1
28938,49.0,"Action, Comedy, Crime","Two cops, played by Seagal and Wayans, are forced to work together to solve a chain of mysterious killings by a killer nicknamed ""The Family Man"".",33.0,John Gray,The Glimmer Man,1996,91,USA, 45000000,20351264,20351264,0,-24648736,0
28907,53.0,Comedy,"A young man, his wife, and his incompetent case worker travel across country to find his birth parents.",81.0,David O. Russell,Flirting with Disaster,1996,92,USA, 7000000,14702438,14702438,0,7702438,1
28905,24.0,"Adventure, Family","Sandy Ricks is sent by his mother to Coral Key, a rustic island in the Florida keys, to spend the summer with his uncle Porter Ricks. Sandy dislikes everything about his new environment ...",43.0,Alan Shapiro,Flipper,1996,95,USA, 25530000,20080020,20080020,0,-5449980,0
28935,33.0,"Comedy, Drama",An aspiring actress disappointed by her treatment in the movie industry turns to phone sex to make a living.,44.0,Spike Lee,Girl 6,1996,108,USA, 12000000,4939939,4939939,0,-7060061,0
28873,65.0,"Biography, Drama, History","The hit musical based on the life of Evita Duarte, a B-picture Argentinian actress who eventually became the wife of Argentinian president Juan Per√≥n, and the most beloved and hated woman in Argentina.",45.0,Alan Parker,Evita,1996,135,USA, 55000000,50047179,141047179,91000000,86047179,1
28902,52.0,Comedy,"Reunited by the death of a college friend, three divorced women seek revenge on the husbands who left them for younger women.",58.0,Hugh Wilson,The First Wives Club,1996,103,USA, 26000000,105489203,181489203,76000000,155489203,1
28883,57.0,"Action, Drama, Sport",An all star baseball player becomes the unhealthy focus of a down on his luck salesman.,32.0,Tony Scott,The Fan,1996,116,USA, 55000000,18626419,18626419,0,-36373581,0
28874,66.0,"Action, Adventure, Thriller","When terrorists seize control of an airliner, an intelligence analyst accompanies a commando unit for a midair boarding operation.",62.0,Stuart Baird,Executive Decision,1996,133,USA, 55000000,56569216,121969216,65400000,66969216,1
28847,17.0,"Comedy, Family, Sport",A trained chimpanzee plays third base for a minor-league baseball team.,25.0,Bill Couturi√©,Ed,1996,94,USA, 24000000,4422380,4422380,0,-19577620,0
28865,119.0,"Action, Adventure, Sci-Fi","Snake Plissken is once again called in by the United States government to recover a potential doomsday device from Los Angeles, now an autonomous island where undesirables are deported.",54.0,John Carpenter,Escape from L.A.,1996,101,USA, 50000000,25477365,25477365,0,-24522635,0
28863,74.0,"Action, Drama, Thriller",A Witness Protection specialist becomes suspicious of his co-workers when dealing with a case involving high-tech weapons.,56.0,Chuck Russell,Eraser,1996,115,USA, 100000000,101295562,242295562,141000000,142295562,1
30016,72.0,Comedy,Two stumblebum inheritors are determined to rid their antique house of a mouse who is equally determined to stay where he is.,54.0,Gore Verbinski,Mousehunt,1997,98,USA, 38000000,61917389,122417389,60500000,84417389,1
30067,34.0,"Comedy, Romance","A failed gambler, intent on meeting a rich widow, tricks his widowed brother-in-law into boarding a cruise ship as dance hosts.",49.0,Martha Coolidge,Out to Sea,1997,106,USA, 33000000,29022252,30716901,1694649,-2283099,0
30013,67.0,"Action, Adventure, Fantasy",A group of martial arts warriors have only six days to save the Earth from an extra-dimensional invasion.,11.0,John R. Leonetti,Mortal Kombat: Annihilation,1997,95,USA, 30000000,35927406,51376861,15449455,21376861,1
30018,17.0,"Adventure, Comedy, Family",The myopic millionaire defeats jewel smugglers in his usual bumbling manner.,18.0,Stanley Tong,Mr. Magoo,1997,87,USA, 30000000,21437192,21437192,0,-8562808,0
30029,91.0,"Comedy, Drama, Romance","When a woman's long-time friend reveals he's engaged, she realizes she loves him herself and sets out to get him, with only days before the wedding.",50.0,P.J. Hogan,My Best Friend's Wedding,1997,105,USA, 38000000,127120029,299288605,172168576,261288605,1
30033,35.0,"Comedy, Drama, Romance",An ambitious debut for writer/director Bart Freundlich charting the unrest with a family who gather together for Thanksgiving Day.,58.0,Bart Freundlich,The Myth of Fingerprints,1997,93,USA, 2000000,523025,523025,0,-1476975,0
30058,140.0,"Comedy, Drama, Romance","A single mother and waitress, a misanthropic author, and a gay artist form an unlikely friendship after the artist is assaulted in a robbery.",67.0,James L. Brooks,As Good as It Gets,1997,139,USA, 50000000,148478011,314178011,165700000,264178011,1
30078,94.0,"Action, Thriller",A US Army colonel and a civilian woman supervising him must track down stolen Russian nuclear weapons before they're used by terrorists.,43.0,Mimi Leder,The Peacemaker,1997,124,USA, 50000000,41263140,110463140,69200000,60463140,1
30024,60.0,"Action, Crime, Drama",A young woman is murdered in the White House. Homicide detective Regis/W.Snipes investigates while Secret Service works against him. He's assigned agent Chance/D.Lane. She eventually cooperates after a man's framed.,47.0,Dwight H. Little,Murder at 1600,1997,107,USA, 40000000,25804707,25804707,0,-14195293,0
29999,137.0,"Horror, Sci-Fi","Three years ago, entomologist Dr. Susan Tyler genetically created an insect to kill cockroaches carrying a virulent disease. Now, the insects are out to destroy their only predator, mankind.",55.0,Guillermo del Toro,Mimic,1997,105,USA, 30000000,25480490,25480490,0,-4519510,0
29904,86.0,"Crime, Drama, Mystery",Police hunting for a serial kidnapper are helped when a victim manages to escape for the first time.,46.0,Gary Fleder,Kiss the Girls,1997,115,USA, 27000000,60527873,60527873,0,33527873,1
29860,78.0,"Comedy, Romance",A midwestern teacher questions his sexuality after a former student makes a comment about him at the Academy Awards.,70.0,Frank Oz,In & Out,1997,90,USA, 35000000,63856929,63856929,0,28856929,1
29856,131.0,Drama,"In suburban New Canaan, Connecticut, 1973, middle class families experimenting with casual sex and substance abuse find their lives beyond their control.",72.0,Ang Lee,The Ice Storm,1997,112,USA, 18000000,8038061,8038061,0,-9961939,0
29875,165.0,"Crime, Drama, Thriller",A middle-aged woman finds herself in the middle of a huge conflict that will either make her a profit or cost her life.,64.0,Quentin Tarantino,Jackie Brown,1997,154,USA, 12000000,39673162,39673162,0,27673162,1
29902,23.0,Comedy,"Warren has an extra room in his apartment (and is five months behind on the rent) after his lover moves out, so a friend places an ad on his behalf for a GWM roommate. Frankie, a pizza ...",46.0,Tony Vitale,"Kiss Me, Guido",1997,86,USA, 740000,1918497,1918497,0,1178497,1
29910,131.0,"Crime, Drama, Mystery","As corruption grows in 1950s Los Angeles, three policemen -- one strait-laced, one brutal, and one sleazy -- investigate a series of murders with their own brand of justice.",90.0,Curtis Hanson,L.A. Confidential,1997,138,USA, 35000000,64616940,126216940,61600000,91216940,1
29920,23.0,"Comedy, Family","The several misadventures and life-lessons learned by 8-year-old Theodore ""Beaver"" Cleaver in an entertaining and hilarious tale of a small-town Ohio family and the daily trials and tribunes of life.",42.0,Andy Cadiff,Leave It to Beaver,1997,84,USA, 15000000,10925060,10925060,0,-4074940,0
29930,77.0,"Comedy, Fantasy",A fast-track lawyer can't lie for 24 hours due to his son's birthday wish after he disappoints his son for the last time.,70.0,Tom Shadyac,Liar Liar,1997,86,USA, 45000000,181410615,302710615,121300000,257710615,1
29948,203.0,"Action, Adventure, Sci-Fi","A research team is sent to the Jurassic Park Site B island to study the dinosaurs there, while an InGen team approaches with another agenda.",59.0,Steven Spielberg,The Lost World: Jurassic Park,1997,129,USA, 73000000,229086679,618638999,389552320,545638999,1
29963,65.0,"Crime, Drama, Thriller","A disgruntled security guard holds a school trip group hostage, while a news reporter forms a bond with him.",45.0,Costa-Gavras,Mad City,1997,115,USA, 50000000,10541523,10541523,0,-39458477,0
29980,21.0,"Action, Comedy","Retired Lieutenant Commander Quinton McHale spends his days puttering around the Caribbean in the old PT-73 selling homebrew, ice cream, and swimsuit calendars. He's brought out of ...",18.0,Bryan Spicer,McHale's Navy,1997,108,USA, 31190000,4529843,4529843,0,-26660157,0
29986,164.0,"Action, Adventure, Comedy",A police officer joins a secret organization that polices and monitors extraterrestrial interactions on Earth.,71.0,Barry Sonnenfeld,Men in Black,1997,98,USA, 90000000,250690539,589390539,338700000,499390539,1
29995,100.0,"Crime, Drama, Mystery","A visiting city reporter's (John Cusack's) assignment suddenly revolves around the murder trial of a local millionaire (Kevin Spacey), whom he befriends.",57.0,Clint Eastwood,Midnight in the Garden of Good and Evil,1997,155,USA, 35000000,25105255,25105255,0,-9894745,0
30088,57.0,"Comedy, Drama, Romance","A young advertising executive's life becomes increasingly complicated when, in order to impress her boss, she pretends to be engaged to a man she has just met.",44.0,Glenn Gordon Caron,Picture Perfect,1997,105,USA, 10000000,31407873,44332015,12924142,34332015,1
30097,81.0,"Action, Adventure, Drama",A nameless drifter dons a postman's uniform and bag of mail as he begins a quest to inspire hope to the survivors living in post-apocalyptic America.,29.0,Kevin Costner,The Postman,1997,177,USA, 80000000,17626234,17626234,0,-62373766,0
30262,324.0,"Drama, Romance","A seventeen-year-old aristocrat falls in love with a kind but poor artist aboard the luxurious, ill-fated R.M.S. Titanic.",75.0,James Cameron,Titanic,1997,194,USA, 200000000,659363944,2187463944,1528100000,1987463944,1
30293,62.0,Drama,"A reclusive beekeeper slowly pulls his dysfunctional family back together, but not without having to fight his son's previous dastardly cohorts.",77.0,Victor Nunez,Ulee's Gold,1997,113,USA, 2700000,9161691,9161691,0,6461691,1
30306,36.0,Comedy,"In the fourth outing for the vacation franchise, the Griswolds have to survive Vegas fever when they go to Las Vegas for a fun family vacation.",20.0,Stephen Kessler,Vegas Vacation,1997,93,USA, 25000000,36400360,36400360,0,11400360,1
30316,93.0,"Action, Drama, Sci-Fi","A volcano erupts in downtown Los Angeles, threatening to destroy the city.",55.0,Mick Jackson,Volcano,1997,104,USA, 90000000,49323468,122823468,73500000,32823468,1
30485,71.0,Comedy,"A 16-year-old girl visits her gay half-brother and ends up seducing his boyfriend, thus wreaking havoc on all of their lives.",70.0,Don Roos,The Opposite of Sex,1997,105,USA, 5000000,5881367,5881367,0,881367,1
30550,142.0,"Comedy, Drama","Shortly before an election, a spin-doctor and a Hollywood producer join efforts to fabricate a war in order to cover up a Presidential sex scandal.",73.0,Barry Levinson,Wag the Dog,1997,97,USA, 15000000,43061945,64256513,21194568,49256513,1
30833,53.0,"Comedy, Drama","2 girls wait outside a young actor's door and find out he's had them both as ""only"" girlfriend the last 10 months. They wait inside after breaking in. When Blake comes home he just can't stop lying but they stay.",66.0,James Toback,Two Girls and a Guy,1997,84,USA, 1000000,2057193,2057193,0,1057193,1
31047,8.0,Sci-Fi,"A writer, Tucker Harding, is hired to cover an article on the hydrogen-bomb test, Nevada, 1952. While there, radiation mutates her code/soul, spawning in her the ability to travel through ...",59.0,Hilary Brougher,The Sticky Fingers of Time,1997,81,USA, 250000,1610,1610,0,-248390,0
30247,23.0,"Drama, Music","A loner befriends a local celebrity, Billy Magic, but he soon begins to tell lies in order to maintain the friendship and the newfound status.",65.0,Guy Ferland,Telling Lies in America,1997,101,USA, 4000000,318809,318809,0,-3681191,0
30230,49.0,"Comedy, Crime, Drama",A group of youngsters kidnap a respected Mafia figure.,43.0,Peter O'Fallon,Suicide Kings,1997,106,USA, 5000000,1740156,1740156,0,-3259844,0
30215,195.0,"Action, Adventure, Sci-Fi","Humans in a fascist, militaristic future wage war with giant alien bugs.",51.0,Paul Verhoeven,Starship Troopers,1997,129,USA, 105000000,54814377,121214377,66400000,16214377,1
30106,26.0,"Biography, Drama, Romance","Based on the life of Olympic hopeful Steve Prefontaine, a long distance runner who lived in Oregon and died young",56.0,Steve James,Prefontaine,1997,106,USA, 8000000,589304,589304,0,-7410696,0
30111,33.0,"Biography, Comedy, Drama","The autobiographical story of Howard Stern, the radio rebel who is now also a TV personality, an author and a movie star.",67.0,Betty Thomas,Private Parts,1997,109,USA, 28000000,41230799,41230799,0,13230799,1
30144,37.0,"Action, Drama, History",A dramatization of a 1923 horrific racist lynch mob attack on an African-American community.,71.0,John Singleton,Rosewood,1997,140,USA, 25000000,13130349,13130349,0,-11869651,0
30151,57.0,"Action, Adventure, Romance","Simon Templar (The Saint), is a thief for hire, whose latest job to steal the secret process for cold fusion puts him at odds with a traitor bent on toppling the Russian government, as well as the woman who holds its secret.",50.0,Phillip Noyce,The Saint,1997,116,USA, 68000000,61363304,118063304,56700000,50063304,1
30160,205.0,"Horror, Mystery","Two years after the first series of murders, as Sydney acclimates to college life, someone donning the Ghostface costume begins a new string of killings.",63.0,Wes Craven,Scream 2,1997,120,USA, 24000000,101363301,172363301,71000000,148363301,1
30164,38.0,"Biography, Drama, Music","The true story of Selena Quintanilla-Perez, a Texas-born Tejano singer who rose from cult status to performing at the Astrodome, as well as having chart topping albums on the Latin music charts.",67.0,Gregory Nava,Selena,1997,127,USA, 20000000,35281794,35281794,0,15281794,1
30198,33.0,"Comedy, Drama","One person can keep a family together and, when that one person is gone, a family can be torn apart.",68.0,George Tillman Jr.,Soul Food,1997,115,USA, 7500000,43700855,43700855,0,36200855,1
30201,102.0,"Drama, Mystery, Thriller",An employee of a corporation with a lucrative secret process is tempted to betray it. But there's more to it than that.,70.0,David Mamet,The Spanish Prisoner,1997,110,USA, 10000000,9593903,9593903,0,-406097,0
30202,86.0,"Action, Drama, Horror","An elite mercenary is killed, but comes back from Hell as a reluctant soldier of the Devil.",34.0,Mark A.Z. Dipp√©,Spawn,1997,96,USA, 40000000,54870175,87840042,32969867,47840042,1
30203,84.0,"Action, Adventure, Crime",A computer hacker breaks into the computer system of the Seabourn Legend cruise liner and sets it speeding on a collision course into a gigantic oil tanker.,23.0,Jan de Bont,Speed 2: Cruise Control,1997,121,USA, 160000000,48608066,164508066,115900000,4508066,1
29853,160.0,"Horror, Mystery",Four young friends bound by a tragic accident are reunited when they find themselves being stalked by a hook-wielding maniac in their small seaside town.,52.0,Jim Gillespie,I Know What You Did Last Summer,1997,101,USA, 17000000,72586134,125586134,53000000,108586134,1
29758,46.0,"Action, Drama, Thriller","Going undercover in rural Kentucky, an environmental agent tries to prove the dumping of toxic waste in the local coal mines by ruthless industrialists.",40.0,F√©lix Enr√≠quez Alcal√°,Fire Down Below,1997,105,USA, 60000000,16228448,16228448,0,-43771552,0
29690,76.0,Comedy,"Suffering from writer's block and eagerly awaiting his writing award, Harry Block remembers events from his past and scenes from his best-selling books as characters, real and fictional, come back to haunt him.",61.0,Woody Allen,Deconstructing Harry,1997,96,USA, 20000000,10686841,10686841,0,-9313159,0
29739,37.0,Drama,"After a daughter witnesses her father having an affair, she begins a chain reaction that could tear her family apart.",78.0,Kasi Lemmons,Eve's Bayou,1997,109,USA, 6000000,14842388,14842388,0,8842388,1
29532,66.0,"Animation, Adventure, Drama","The last surviving child of the Russian Royal Family joins two con men to reunite with her grandmother, the Dowager Empress, while the undead Rasputin seeks her death.",61.0,"Don Bluth, Gary Goldman",Anastasia,1997,94,USA, 50000000,58406347,139804348,81398001,89804348,1
29713,127.0,"Biography, Crime, Drama","An FBI undercover agent infiltrates the mob and finds himself identifying more with the mafia life, at the expense of his regular one.",76.0,Mike Newell,Donnie Brasco,1997,127,USA, 35000000,41909762,124909762,83000000,89909762,1
29697,70.0,"Action, Crime, Drama","A police officer uncovers the real identity of his house-guest, an I.R.A. terrorist in hiding.",53.0,Alan J. Pakula,The Devil's Own,1997,111,USA, 90000000,42868348,140807547,97939199,50807547,1
29536,100.0,Drama,"After his happy life spins out of control, a preacher from Texas changes his name, goes to Louisiana and starts preaching on the radio.",83.0,Robert Duvall,The Apostle,1997,134,USA, 5000000,19868354,19868354,0,14868354,1
29499,84.0,"Action, Crime, Drama",Career thief Luther Whitney (Clint Eastwood) witnesses a horrific crime involving U.S. President Alan Richmond (Gene Hackman).,52.0,Clint Eastwood,Absolute Power,1997,121,USA, 50000000,50068310,50068310,0,68310,1
29682,100.0,"Action, Adventure, Thriller","A vulcanologist arrives at a countryside town recently named the second most desirable place to live in America, and discovers that the long dormant volcano, Dante's Peak, may wake up at any moment.",43.0,Roger Donaldson,Dante's Peak,1997,108,USA, 116000000,67127760,178127760,111000000,62127760,1
29743,47.0,"Action, Comedy, Crime","A bratty teenager fakes her own kidnapping, but gets mistakenly kidnapped for real instead.",34.0,Marco Brambilla,Excess Baggage,1997,101,USA, 20000000,14515490,14515490,0,-5484510,0
29547,118.0,"Adventure, Comedy","A 1960s secret agent is brought out of cryofreeze to oppose his greatest enemy in the 1990s, where his social attitudes are glaringly out of place.",51.0,Jay Roach,Austin Powers: International Man of Mystery,1997,94,USA, 16500000,53883989,67683989,13800000,51183989,1
29659,170.0,"Drama, Mystery, Sci-Fi","Dr. Ellie Arroway (Jodie Foster), after years of searching, finds conclusive radio proof of extraterrestrial intelligence, sending plans for a mysterious machine.",62.0,Robert Zemeckis,Contact,1997,150,USA, 90000000,100920329,171120329,70200000,81120329,1
29658,84.0,"Action, Mystery, Thriller","A man obsessed with conspiracy theories becomes a target after one of his theories turns out to be true. Unfortunately, in order to save himself, he has to figure out which theory it is.",49.0,Richard Donner,Conspiracy Theory,1997,135,USA, 75000000,75982834,136982834,61000000,61982834,1
29656,140.0,"Action, Crime, Thriller",Newly paroled ex-con and former U.S. Ranger Cameron Poe finds himself trapped in a prisoner transport plane when the passengers seize control.,52.0,Simon West,Con Air,1997,115,USA, 75000000,101117573,224012234,122894661,149012234,1
29639,157.0,"Comedy, Drama, Romance","Holden and Banky are comic book artists. Everything's going good for them until they meet Alyssa, also a comic book artist. Holden falls for her, but his hopes are crushed when he finds out she's a lesbian.",71.0,Kevin Smith,Chasing Amy,1997,113,USA, 250000,12021272,12021272,0,11771272,1
29575,31.0,"Action, Comedy",A man tries to rescue a woman with a little help from his half brother.,27.0,Dennis Dugan,Beverly Hills Ninja,1997,88,USA, 18000000,31480418,31480418,0,13480418,1
29610,83.0,"Crime, Drama, Mystery",A man searches for his missing wife after his car breaks down in the middle of the desert.,73.0,Jonathan Mostow,Breakdown,1997,93,USA, 36000000,50159144,50159144,0,14159144,1
29596,176.0,Drama,The story of a young man's adventures in the California pornography industry of the late 1970s and early 1980s.,85.0,Paul Thomas Anderson,Boogie Nights,1997,155,USA, 15000000,26400640,43101594,16700954,28101594,1
29661,144.0,"Crime, Drama, Thriller","The Sheriff of a suburban New Jersey community, populated by New York City police officers, slowly discovers the town is a front for mob connections and corruption.",64.0,James Mangold,Cop Land,1997,105,USA, 15000000,44862187,44862187,0,29862187,1
29746,159.0,"Action, Crime, Sci-Fi","In order to foil a terrorist plot, an FBI agent undergoes a facial transplant surgery and assumes the identity and physical appearance of a terrorist, but the plan turns from bad to worse when the same terrorist impersonates the FBI agent.",82.0,John Woo,Face/Off,1997,138,USA, 80000000,112276146,245676146,133400000,165676146,1
29761,57.0,"Comedy, Family, Sci-Fi","An absent-minded professor discovers ""flubber,"" a rubber-like super-bouncy substance.",37.0,Les Mayfield,Flubber,1997,93,USA, 80000000,92977226,177977226,85000000,97977226,1
29847,43.0,"Comedy, Drama",A mentally unbalanced young woman - who is convinced she is Jackie Kennedy - flies into a murderous rage when her brother returns home to reveal he is engaged.,54.0,Mark Waters,The House of Yes,1997,85,USA, 1500000,626057,626057,0,-873943,0
29840,46.0,"Crime, Drama",Black gangsters in 1930 Harlem fights Dutch Schultz who is trying to horn in on their numbers racket.,50.0,Bill Duke,Hoodlum,1997,130,USA, 30000000,23499102,23499102,0,-6500898,0
29826,93.0,"Animation, Adventure, Comedy",The son of Zeus and Hera is stripped of his immortality as an infant and must become a true hero in order to reclaim it.,74.0,"Ron Clements, John Musker",Hercules,1997,93,USA, 85000000,99112101,252712101,153600000,167712101,1
29801,52.0,"Comedy, Drama","Lonely residents of a tornado-stricken Ohio town wander the deserted landscape trying to fulfill their boring, nihilistic lives.",19.0,Harmony Korine,Gummo,1997,89,USA, 1300000,116799,116799,0,-1183201,0
29799,122.0,"Action, Comedy, Crime","Martin Blank is a professional assassin. He is sent on a mission to a small Detroit suburb, Grosse Pointe, and, by coincidence, his ten-year high school reunion party is taking place there at the same time.",76.0,George Armitage,Grosse Pointe Blank,1997,107,USA, 15000000,28084357,28084357,0,13084357,1
29514,246.0,"Action, Horror, Sci-Fi","200 years after her death, Ellen Ripley is revived as a powerful human/alien hybrid clone. Along with a crew of space pirates, she must again battle the deadly aliens and stop them from reaching Earth.",63.0,Jean-Pierre Jeunet,Alien Resurrection,1997,109,USA, 75000000,47795658,161376068,113580410,86376068,1
29752,35.0,"Comedy, Romance",A woman cons two old boyfriends into searching for her runaway son by convincing both that they are the boy's father.,43.0,Ivan Reitman,Fathers' Day,1997,98,USA, 85000000,28598376,28598376,0,-56401624,0
29791,180.0,"Drama, Romance","Will Hunting, a janitor at M.I.T., has a gift for mathematics, but needs help from a psychologist to find direction in his life.",70.0,Gus Van Sant,Good Will Hunting,1997,126,USA, 10000000,138433435,225933435,87500000,215933435,1
29789,33.0,"Comedy, Family","Two dim-witted teenagers are forced to save the fast food restaurant they work at from going out of business, despite a new-and-improved burger joint opening across the street that want to be the ""Top Dog"" in the fast food industry.",41.0,Brian Robbins,Good Burger,1997,95,USA, 9000000,23712993,23712993,0,14712993,1
29525,85.0,"Drama, History","In 1839, the revolt of Mende captives aboard a Spanish owned ship causes a major controversy in the United States when the ship is captured off the coast of Long Island. The courts must decide whether the Mende are slaves or legally free.",63.0,Steven Spielberg,Amistad,1997,155,USA, 36000000,44229441,44229441,0,8229441,1
29763,40.0,"Comedy, Drama, Romance","After a one night stand with Alex, Isabel realizes that she is pregnant and they decide to get married. However, along with the marriage comes compromise of one's own cultural traditions.",37.0,Andy Tennant,Fools Rush In,1997,109,USA, 20000000,29481428,29481428,0,9481428,1
29775,184.0,"Drama, Mystery, Thriller","After a wealthy banker is given an opportunity to participate in a mysterious game, his life is turned upside down when he becomes unable to distinguish between the game and reality.",61.0,David Fincher,The Game,1997,129,USA, 50000000,48323648,109423648,61100000,59423648,1
29778,57.0,"Action, Adventure, Comedy",A man raised in the jungle by apes falls in love with a wealthy American heiress.,53.0,Sam Weisman,George of the Jungle,1997,92,USA, 55000000,105263257,174463257,69200000,119463257,1
29776,182.0,"Drama, Sci-Fi, Thriller",A genetically inferior man assumes the identity of a superior one in order to pursue his lifelong dream of space travel.,64.0,Andrew Niccol,Gattaca,1997,106,USA, 36000000,12532777,12532777,0,-23467223,0
29530,136.0,"Action, Adventure, Horror","A ""National Geographic"" film crew is taken hostage by an insane hunter, who forces them along on his quest to capture the world's largest - and deadliest - snake.",37.0,Luis Llosa,Anaconda,1997,89,USA, 45000000,65885767,136885767,71000000,91885767,1
30541,65.0,"Action, Crime, Thriller","U.S. Marshal Samuel Gerard and his team of Marshals are assigned to track down Sheridan, who has been accused of a double-murder.",47.0,Stuart Baird,U.S. Marshals,1998,131,USA, 60000000,57167405,102367405,45200000,42367405,1
30559,147.0,"Drama, Mystery, Sci-Fi",Mulder and Scully must fight the government in a conspiracy and find the truth about an alien colonization of Earth.,60.0,Rob Bowman,The X Files,1998,121,USA, 66000000,83898313,189176423,105278110,123176423,1
30551,99.0,"Comedy, Music, Romance","Robbie, a singer, and Julia, a waitress, are both engaged, but to the wrong people. Fortune intervenes to help them discover each other.",59.0,Frank Coraci,The Wedding Singer,1998,100,USA, 18000000,80245725,123306987,43061262,105306987,1
30534,170.0,"Drama, War",Adaptation of,78.0,Terrence Malick,The Thin Red Line,1998,170,USA, 52000000,36400491,98126565,61726074,46126565,1
30553,79.0,"Crime, Drama, Mystery",A police detective uncovers a conspiracy behind a case involving a high-school guidance counselor when accusations of rape are made against him by two female students.,52.0,John McNaughton,Wild Things,1998,108,USA, 20000000,30147739,30147739,0,10147739,1
30517,50.0,"Comedy, Drama","In 1976, a lower-middle-class teenager struggles to cope living with her neurotic family of nomads on the outskirts of Beverly Hills.",69.0,Tamara Jenkins,Slums of Beverly Hills,1998,91,USA, 5000000,5502773,5502773,0,502773,1
30465,82.0,"Action, Crime, Drama",Shadowy elements in the NSA target a nine-year old autistic savant for death when he is able to decipher a top secret code.,37.0,Harold Becker,Mercury Rising,1998,111,USA, 60000000,32935289,93107289,60172000,33107289,1
30471,133.0,"Animation, Adventure, Family","To save her father from death in the army, a young maiden secretly goes in his place and becomes one of China's greatest heroines in the process.",71.0,"Tony Bancroft, Barry Cook",Mulan,1998,88,USA, 90000000,120620254,304320254,183700000,214320254,1
30478,64.0,"Action, Crime, Drama","The story of the Newton gang, the most successful bank robbers in history, owing to their good planning and minimal violence.",57.0,Richard Linklater,The Newton Boys,1998,122,USA, 27000000,10452012,10452012,0,-16547988,0
30479,67.0,"Comedy, Music, Romance","Two dim-witted brothers dream of owning their own dance club or at least getting into the coolest and most exclusive club in town, The Roxbury.",26.0,John Fortenberry,A Night at the Roxbury,1998,82,USA, 17000000,30331165,30331165,0,13331165,1
30481,52.0,"Comedy, Drama, Romance","A pregnant New York City social worker begins to develop romantic feelings for her gay best friend, and decides she'd rather raise her child with him, much to the dismay of her overbearing boyfriend.",51.0,Nicholas Hytner,The Object of My Affection,1998,111,USA, 15000000,29187243,46905889,17718646,31905889,1
30484,65.0,Drama,A career woman reassesses her parents' lives after she is forced to care for her cancer-stricken mother.,63.0,Carl Franklin,One True Thing,1998,127,USA, 30000000,23245840,26616840,3371000,-3383160,0
30488,164.0,"Comedy, Crime, Drama","A career bank robber breaks out of jail, and shares a moment of mutual attraction with a U.S. Marshal he has kidnapped.",85.0,Steven Soderbergh,Out of Sight,1998,123,USA, 48000000,37562568,77745568,40183000,29745568,1
30494,71.0,"Crime, Drama, Thriller","A wealthy Wall Street speculator discovers that his wife has a lover. He investigates him and uses the carrot and stick to make him murder his wife. Planned to detail, it seems like a perfect murder.",50.0,Andrew Davis,A Perfect Murder,1998,107,USA, 60000000,67638368,128038368,60400000,68038368,1
30496,174.0,"Comedy, Drama, Fantasy","Two 1990s teenage siblings find themselves in a 1950s sitcom, where their influence begins to profoundly change that complacent world.",71.0,Gary Ross,Pleasantville,1998,124,USA, 60000000,40584421,49805462,9221041,-10194538,0
30498,97.0,"Comedy, Drama, Fantasy","Two witch sisters, raised by their eccentric aunts in a small town, face closed-minded prejudice and a curse which threatens to prevent them ever finding lasting love.",46.0,Griffin Dunne,Practical Magic,1998,104,USA, 75000000,46732881,46732881,0,-28267119,0
30500,126.0,"Animation, Adventure, Drama",An Egyptian prince learns of his identity as a Hebrew and his destiny to become the chosen deliverer of his people.,64.0,"Brenda Chapman, Steve Hickner",The Prince of Egypt,1998,99,USA, 70000000,101413188,218613188,117200000,148613188,1
30508,76.0,"Action, Comedy, Crime","A loyal and dedicated Hong Kong Inspector teams up with a reckless and loudmouthed L.A.P.D. detective to rescue the Chinese Consul's kidnapped daughter, while trying to arrest a dangerous crime lord along the way.",60.0,Brett Ratner,Rush Hour,1998,98,USA, 33000000,141186864,244721064,103534200,211721064,1
30510,264.0,"Drama, War","Following the Normandy Landings, a group of U.S. soldiers go behind enemy lines to retrieve a paratrooper whose brothers have been killed in action.",91.0,Steven Spielberg,Saving Private Ryan,1998,169,USA, 70000000,217049603,482349603,265300000,412349603,1
30511,37.0,"Comedy, Romance",A student gets his senses enhanced by an experimental drug. But abuse is not an option.,36.0,Penelope Spheeris,Senseless,1998,93,USA, 15000000,12874899,12874899,0,-2125101,0
30515,101.0,"Action, Adventure, Comedy","Robin Monroe, a New York magazine editor, and the gruff pilot Quinn Harris must put aside their mutual dislike if they are to survive after crash landing on a deserted South Seas island.",51.0,Ivan Reitman,Six Days Seven Nights,1998,98,USA, 70000000,74339294,164839294,90500000,94839294,1
30525,169.0,"Action, Adventure, Sci-Fi","When the crew of the Enterprise learn of a Federation conspiracy against the inhabitants of a unique planet, Captain Picard begins an open rebellion.",64.0,Jonathan Frakes,Star Trek: Insurrection,1998,103,USA, 58000000,70187658,112587658,42400000,54587658,1
31120,133.0,"Crime, Drama","A young, reformed gambler must return to playing big stakes poker to help a friend pay off loan sharks, while balancing his relationship with his girlfriend and his commitments to law school.",54.0,John Dahl,Rounders,1998,121,USA, 12000000,22912409,22912409,0,10912409,1
31723,32.0,"Biography, Comedy, Romance",A documentary type film about the dates Myles has gone on as he tries to find out how to find love in the future.,36.0,Myles Berkowitz,20 Dates,1998,87,USA, 60000,541636,541636,0,481636,1
32179,150.0,"Comedy, Drama","The lives of several individuals intertwine as they go about their lives in their own unique ways, engaging in acts society as a whole might find disturbing in a desperate search for human connection.",81.0,Todd Solondz,Happiness,1998,134,USA, 2200000,2982011,2982011,0,782011,1
31716,5.0,"Action, Comedy, Crime",A tax investigator chasing a tax evader stumbles over a series of bloody murders and gets involved in an investigation with a rookie cop despite his boss' orders to stay out of the way.,48.0,Avi Nesher,Taxman,1998,104,USA, 3500000,9871,9871,0,-3490129,0
31704,140.0,"Drama, Horror, Mystery",A paranoid mathematician searches for a key number that will unlock the universal patterns found in nature.,72.0,Darren Aronofsky,Pi,1998,84,USA, 60000,3221152,3221152,0,3161152,1
32496,127.0,"Horror, Mystery, Thriller","A young female embezzler arrives at the Bates Motel, which has terrible secrets of its own.",47.0,Gus Van Sant,Psycho,1998,105,USA, 60000000,21485655,37170655,15685000,-22829345,0
31422,121.0,"Action, Thriller","The secret U.S. abduction of a suspected terrorist leads to a wave of terrorist attacks in New York City, which leads to the declaration of martial-law.",53.0,Edward Zwick,The Siege,1998,116,USA, 70000000,40981289,116672912,75691623,46672912,1
31414,171.0,"Horror, Sci-Fi",Students suspect that their teachers are aliens after bizarre occurrences.,61.0,Robert Rodriguez,The Faculty,1998,104,USA, 15000000,40283321,40283321,0,25283321,1
31308,42.0,"Comedy, Sport","Two childhood friends are pro athletes of a national sport called BASEketball, a hybrid of baseball and basketball, and must deal with a greedy businessman scheming against their team.",38.0,David Zucker,BASEketball,1998,103,USA, 25000000,7027290,7027290,0,-17972710,0
31176,177.0,"Comedy, Romance","A man gets a chance to meet up with his dream girl from high school, even though his date with her back then was a complete disaster.",69.0,"Bobby Farrelly, Peter Farrelly",There's Something About Mary,1998,119,USA, 23000000,176484651,369884651,193400000,346884651,1
31167,60.0,"Biography, Comedy, Drama","The true story of a heroic man, Hunter ""Patch"" Adams, determined to become a medical doctor because he enjoys helping people. He ventured where no doctor had ventured before, using humour and pathos.",25.0,Tom Shadyac,Patch Adams,1998,115,USA, 90000000,135026902,202292902,67266000,112292902,1
29485,27.0,Comedy,"Two college roommates go out and party, resulting in bad grades. They learn of the clause that says, ""If your roommate dies, you get an A,"" and decide to find someone who is on the verge, so to speak, to move in with them.",27.0,Alan Cohn,Dead Man on Campus,1998,96,USA, 14000000,15064946,15064946,0,1064946,1
30835,104.0,"Comedy, Crime, Thriller",A prostitute is killed during a bachelor party and the attendees turn on each other as the wedding approaches.,31.0,Peter Berg,Very Bad Things,1998,100,USA, 30000000,9898412,9898412,0,-20101588,0
30868,51.0,"Drama, Sport",A basketball player's father must try to convince him to go to a college so he can get a shorter sentence.,63.0,Spike Lee,He Got Game,1998,136,USA, 25000000,21567853,21567853,0,-3432147,0
30879,58.0,"Comedy, Drama, Family",A young boy with stunted growth is convinced that God has a great purpose for him.,39.0,Mark Steven Johnson,Simon Birch,1998,114,USA, 30000000,18253415,18253415,0,-11746585,0
30643,150.0,"Action, Crime, Thriller","With personal crises and age weighing in on them, LAPD officers Riggs and Murtaugh must contend with deadly Chinese triads that are trying to free their former leaders out of prison and onto American soil.",37.0,Richard Donner,Lethal Weapon 4,1998,127,USA, 140000000,130444603,285444603,155000000,145444603,1
30988,54.0,"Comedy, Drama","A talented young photographer, who enjoys snapping photos of his satirical, perverted Baltimore neighborhood and his wacky family, gets dragged into a world of pretentious artists from New York City and finds newfound fame.",66.0,John Waters,Pecker,1998,87,USA, 6000000,2281761,2281761,0,-3718239,0
31079,82.0,"Comedy, Romance",Multicharacter teenage comedy about high school graduates with different agenda of life on graduation night.,52.0,"Harry Elfont, Deborah Kaplan",Can't Hardly Wait,1998,100,USA, 10000000,25605015,25605015,0,15605015,1
30457,112.0,"Action, Adventure, Family",The Robinson family was going into space to fight for a chance for humanity. Now they are fighting to live long enough to find a way home.,42.0,Stephen Hopkins,Lost in Space,1998,130,USA, 80000000,69117629,136159423,67041794,56159423,1
31121,188.0,"Comedy, Drama",The extracurricular king of Rushmore Preparatory School is put on academic probation.,86.0,Wes Anderson,Rushmore,1998,93,USA, 9000000,17105219,17195500,90281,8195500,1
31135,157.0,"Comedy, Drama, Romance",Two business rivals who despise each other in real life unwittingly fall in love over the Internet.,57.0,Nora Ephron,You've Got Mail,1998,119,USA, 65000000,115821495,250821495,135000000,185821495,1
30451,89.0,"Comedy, Drama, Music","Story of two female Manhattan book editors fresh out of college, both finding love and themselves while frequenting the local disco.",76.0,Whit Stillman,The Last Days of Disco,1998,113,USA, 8000000,3020601,3020601,0,-4979399,0
30466,40.0,"Action, Adventure, Family",A legendary fifteen-foot tall mountain gorilla named Joe is taken to an animal sanctuary in California by a zoologist and a young woman whom he grew up with. A poacher from the past returns to seek vengeance on him.,51.0,Ron Underwood,Mighty Joe Young,1998,114,USA, 90000000,50632037,50632037,0,-39367963,0
30373,69.0,"Drama, History, Horror","Based on the book by Toni Morrison, in which a slave is visited by the spirit of a mysterious young woman",57.0,Jonathan Demme,Beloved,1998,172,USA, 80000000,22852487,22852487,0,-57147513,0
30366,165.0,"Action, Adventure, Sci-Fi","After discovering that an asteroid the size of Texas is going to impact Earth in less than a month, N.A.S.A. recruits a misfit team of deep core drillers to save the planet.",42.0,Michael Bay,Armageddon,1998,151,USA, 140000000,201578182,553709788,352131606,413709788,1
30364,131.0,"Animation, Adventure, Comedy",A rather neurotic ant tries to break from his totalitarian society while trying to win the affection of the princess he loves.,72.0,"Eric Darnell, Tim Johnson",Antz,1998,83,USA, 105000000,90757863,171757863,81000000,66757863,1
29982,98.0,"Drama, Fantasy, Romance","Death, who takes the form of a young man, asks a media mogul to act as a guide to teach him about life on Earth, and in the process, he falls in love with his guide's daughter.",43.0,Martin Brest,Meet Joe Black,1998,178,USA, 90000000,44619100,142940100,98321000,52940100,1
30363,167.0,Drama,A former neo-nazi skinhead tries to prevent his younger brother from going down the same wrong path that he did.,62.0,Tony Kaye,American History X,1998,119,USA, 20000000,6719864,23875127,17155263,3875127,1
29779,68.0,"Crime, Mystery, Thriller","A lawyer uses his power to help his lover put her father behind bars, but when he escapes, they are all in danger.",65.0,Robert Altman,The Gingerbread Man,1998,114,USA, 25000000,1677131,1677131,0,-23322869,0
30360,68.0,"Drama, Music",The famous 1970s New York City nightclub seen and told through the eyes of a young employee.,33.0,Mark Christopher,54,1998,93,USA, 13000000,16757163,16757163,0,3757163,1
30345,74.0,"Comedy, Drama",The fortunes of a husband and wife differ drastically after they divorce.,41.0,Woody Allen,Celebrity,1998,113,USA, 12000000,5078660,5078660,0,-6921340,0
30042,39.0,"Comedy, Drama, Romance","An unlucky in love nurse finds her life taking a detour when her mother places a personals ad in the paper, while on the other side of Boston, a plumber is trying to change careers.",71.0,Brad Anderson,Next Stop Wonderland,1998,104,USA, 1000000,3395581,3395581,0,2395581,1
30376,59.0,"Action, Comedy, Crime","Socially anxious hitman Melvin Smiley, an expert in his lucrative field, goes on a job and falls in love with his kidnapping victim, turning his world upside down.",31.0,Kirk Wong,The Big Hit,1998,91,USA, 13000000,27007143,27007143,0,14007143,1
29708,78.0,"Comedy, Family, Fantasy",A doctor discovers that he can communicate with animals.,46.0,Betty Thomas,Doctor Dolittle,1998,85,USA, 71500000,144156605,294456605,150300000,222956605,1
30325,88.0,"Comedy, Sport",A waterboy for a college football team discovers he has a unique tackling ability and becomes a member of the team.,41.0,Frank Coraci,The Waterboy,1998,90,USA, 23000000,161491646,185991646,24500000,162991646,1
30283,251.0,"Comedy, Drama, Sci-Fi",An insurance salesman discovers his whole life is actually a reality TV show.,90.0,Peter Weir,The Truman Show,1998,103,USA, 60000000,125618201,264118201,138500000,204118201,1
29549,118.0,"Action, Adventure, Sci-Fi",Two British Agents team up to stop Sir August de Wynter from destroying the world with a weather-changing machine.,12.0,Jeremiah S. Chechik,The Avengers,1998,89,USA, 60000000,23384939,23384939,0,-36615061,0
30446,24.0,"Comedy, Drama, Romance","Judith Nelson quit her medical studies to marry. Years later, her husband, a physician, divorces her to be with another doctor. Deeply frustrated, she now lives alone in her luxury ...",64.0,Richard LaGravenese,Living Out Loud,1998,100,USA, 20000000,12905901,15610299,2704398,-4389701,0
30204,106.0,"Drama, Horror, Mystery",A spaceship is discovered under three hundred years' worth of coral growth at the bottom of the ocean.,35.0,Barry Levinson,Sphere,1998,134,USA, 80000000,37020277,37020277,0,-42979723,0
29592,47.0,"Drama, Thriller","A couple with jobs and apartment in NYC, decide to move to his mom's farm, get married and have the baby there. They can also make the changes to get a better price for the farm. However, there's something seriously wrong with his mom.",18.0,Jonathan Darby,Hush,1998,96,USA, 21000000,13583690,13583690,0,-7416310,0
29622,120.0,"Comedy, Drama, Romance",A suicidally disillusioned liberal politician puts a contract out on himself and takes the opportunity to be bluntly honest with his voters by affecting the rhythms and speech of hip-hop music and culture.,75.0,Warren Beatty,Bulworth,1998,108,USA, 30000000,26528185,29202884,2674699,-797116,0
30378,210.0,"Action, Horror, Sci-Fi","A half-vampire, half-mortal man becomes a protector of the mortal race, while slaying evil vampires.",45.0,Stephen Norrington,Blade,1998,120,USA, 45000000,70087718,131183530,61095812,86183530,1
30133,105.0,"Action, Crime, Thriller","A troubled hitman seeks aid from a forger to help him get papers to China. However, the drug lord has hired replacements to finish the job, and kill the hitman.",42.0,Antoine Fuqua,The Replacement Killers,1998,87,USA, 30000000,19204929,19204929,0,-10795071,0
30410,90.0,"Action, Thriller",A lawyer becomes a target by a corrupt politician and his N.S.A. goons when he accidentally receives key evidence to a serious politically motivated crime.,67.0,Tony Scott,Enemy of the State,1998,132,USA, 90000000,111549836,250849789,139299953,160849789,1
29836,42.0,"Comedy, Romance, Drama",Pregnant Sally unknowingly falls for the stepson of the deceased father of her baby and has to deal with his homicidal family.,45.0,Dean Parisot,Home Fries,1998,91,USA, 35000000,10493366,10493366,0,-24506634,0
30403,134.0,"Action, Drama, Romance","Unless a comet can be destroyed before colliding with Earth, only those allowed into shelters will survive. Which people will survive?",40.0,Mimi Leder,Deep Impact,1998,120,USA, 75000000,140464664,349464664,209000000,274464664,1
30431,42.0,"Comedy, Crime",The story of three not so bright men who come up with a series of crazy schemes to get a friend out of jail.,16.0,Tamra Davis,Half Baked,1998,82,USA, 8000000,17460020,17460020,0,9460020,1
29841,66.0,"Drama, Romance","Birdee Calvert must choose between her morals and her heart after her husband divorces her and a charming young man, who her daughter disapproves of, comes back into her life.",42.0,Forest Whitaker,Hope Floats,1998,114,USA, 30000000,60053195,81471882,21418687,51471882,1
30394,119.0,Drama,"A tenacious lawyer takes on a case involving a major company responsible for causing several people to be diagnosed with leukemia due to the town's water supply being contaminated, at the risk of bankrupting his firm and career.",68.0,Steven Zaillian,A Civil Action,1998,115,USA, 75000000,56709981,56709981,0,-18290019,0
30392,93.0,"Comedy, Drama, Romance","The Brothers Grimm arrive at the home of a wealthy Grande Dame who speaks of the many legends surrounding the fable of the cinder girl before telling the ""true"" story of her ancestor.",66.0,Andy Tennant,EverAfter,1998,121,USA, 26000000,65705771,98005666,32299895,72005666,1
29842,98.0,"Drama, Romance, Western",The mother of a severely traumatized daughter enlists the aid of a unique horse trainer to help the girl's equally injured horse.,65.0,Robert Redford,The Horse Whisperer,1998,169,USA, 60000000,75383563,186883563,111500000,126883563,1
30385,131.0,"Animation, Adventure, Comedy","A misfit ant, looking for ""warriors"" to save his colony from greedy grasshoppers, recruits a group of bugs that turn out to be an inept circus troupe.",77.0,"John Lasseter, Andrew Stanton",A Bug's Life,1998,95,USA, 120000000,162798565,363258859,200460294,243258859,1
29795,79.0,"Drama, Romance",Modernization of Charles Dickens classic story finds the hapless Finn as a painter in New York City pursuing his unrequited and haughty childhood love.,55.0,Alfonso Cuar√≥n,Great Expectations,1998,111,USA, 25000000,26420672,55494066,29073394,30494066,1
29924,46.0,"Comedy, Drama, Romance",Unhappy couples fall apart and hop into other beds with other people.,70.0,Neil LaBute,Your Friends & Neighbors,1998,100,USA, 5000000,4714658,4714658,0,-285342,0
30425,64.0,"Comedy, Drama","A terminally-ill woman must deal with her ex-husband's new lover, who will be their children's stepmother.",58.0,Chris Columbus,Stepmom,1998,125,USA, 50000000,91137662,159710793,68573131,109710793,1
30437,57.0,"Comedy, Drama","Eddie Murphy stars as an over-the-top television evangelist who finds a way to turn television home shopping into a religious experience, and takes America by storm.",41.0,Stephen Herek,Holy Man,1998,114,USA, 60000000,12069719,12069719,0,-47930281,0
30438,30.0,"Comedy, Drama, Romance","Stella is a highly successful, forty-something San Francisco stock broker who is persuaded by her colorful New York girlfriend Delilah to take a well deserved, first-class vacation to ...",56.0,Kevin Rodney Sullivan,How Stella Got Her Groove Back,1998,124,USA, 20000000,37672941,39278722,1605781,19278722,1
30432,163.0,"Horror, Thriller","Laurie Strode, now the dean of a Northern California private school with an assumed name, must battle the Shape one last time, as the life of her own son hangs in the balance.",52.0,Steve Miner,Halloween H20: 20 Years Later,1998,86,USA, 17000000,55041738,55041738,0,38041738,1
30415,159.0,"Adventure, Comedy, Drama",An oddball journalist and his psychopathic lawyer travel to Las Vegas for a series of psychedelic escapades.,41.0,Terry Gilliam,Fear and Loathing in Las Vegas,1998,118,USA, 18500000,10680275,10680275,0,-7819725,0
32744,35.0,"Drama, Romance",A young girl from an affluent family rebels and becomes involved with a much older photographer.,68.0,Audrey Wells,Guinevere,1999,104,USA, 2600000,632283,635680,3397,-1964320,0
32074,100.0,"Horror, Sci-Fi, Thriller","A horrible massacre strikes up after an outcast teenage girl is taunted by a group of high school jocks, all of them unaware of her cutthroat telekinetic powers.",42.0,"Katt Shea, Robert Mandel",The Rage: Carrie 2,1999,104,USA, 21000000,17762705,17762705,0,-3237295,0
32243,37.0,"Comedy, Drama",A mother and daughter search for success in Beverly Hills.,59.0,Wayne Wang,Anywhere But Here,1999,114,USA, 23000000,18670401,23631929,4961528,631929,1
31997,17.0,"Comedy, Drama, Romance","A bachelor becomes the unwilling guardian of his autistic, intellectually disabled sister; then an experimental treatment works a dramatic change in her brain and his attitude.",21.0,John Duigan,Molly,1999,102,USA, 21000000,17650,17650,0,-20982350,0
32752,29.0,"Animation, Family, Fantasy","Traveling to the exotic kingdom of Siam, English schoolteacher Anna Leonowens soon discovers that her most difficult challenge is the stubborn, imperious King himself.",29.0,Richard Rich,The King and I,1999,87,USA, 25000000,11993021,11993021,0,-13006979,0
31918,94.0,"Action, Crime, Drama","With the aid from a New York City policeman, a top immigrant cop tries to stop drug-trafficking and corruption by immigrant Chinese Triads, but things get complicated when the Triads try to bribe the policeman.",56.0,James Foley,The Corruptor,1999,110,USA, 25000000,15164492,24493601,9329109,-506399,0
32761,14.0,"Comedy, Romance","Four professional women meet at an East Los Angeles restaurant called Luminarias to share secrets about their careers, love, family, and sex.",41.0,Jos√© Luis Valenzuela,Luminarias,1999,100,USA, 1000000,292309,292309,0,-707691,0
32788,77.0,"Comedy, Romance",A high school jock makes a bet that he can turn an unattractive girl into the school's prom queen.,51.0,Robert Iscove,She's All That,1999,95,USA, 10000000,63366989,103166989,39800000,93166989,1
32749,30.0,"Crime, Thriller, Drama",Jeff Cole is a recent graduate of the Cincinnati police academy who dreams of working undercover. His wish is granted and through success is given the task of taking down state-wide crack ...,53.0,Michael Rymer,In Too Deep,1999,95,USA, 7000000,14011454,14011454,0,7011454,1
32666,72.0,"Adventure, Comedy, Family","Gonzo is contacted by his alien family through his breakfast cereal. But when the men in black kidnap him, it's up to Kermit and the gang to rescue Gonzo and help him reunite with his long-lost family.",53.0,Tim Hill,Muppets from Space,1999,87,USA, 24000000,16625807,22323612,5697805,-1676388,0
32732,26.0,"Family, Drama","Poor, but happy, young Nello and his grandfather live alone, delivering milk as a livelihood, in the outskirts of Antwerp, a city in Flanders (the Flemish or Dutch-speaking part of ...",38.0,Kevin Brodie,A Dog of Flanders,1999,100,USA, 7000000,2165637,2165637,0,-4834363,0
32183,127.0,"Comedy, Drama, Romance","A pretty, popular teenager can't go out on a date until her ill-tempered older sister does.",70.0,Gil Junger,10 Things I Hate About You,1999,97,USA, 30000000,38178166,53478166,15300000,23478166,1
32327,100.0,"Comedy, Drama, Romance",A newspaper reporter enrolls in high school as part of research for a story.,60.0,Raja Gosnell,Never Been Kissed,1999,107,USA, 25000000,55474756,84565230,29090474,59565230,1
32330,130.0,Comedy,Three company workers who hate their jobs decide to rebel against their greedy boss.,68.0,Mike Judge,Office Space,1999,89,USA, 10000000,10827810,10827810,0,827810,1
32444,153.0,"Crime, Romance, Thriller","A very rich and successful playboy amuses himself by stealing artwork, but may have met his match in a seductive detective.",72.0,John McTiernan,The Thomas Crown Affair,1999,113,USA, 48000000,69305181,124305181,55000000,76305181,1
32476,163.0,"Comedy, Crime, Thriller",Three of the most popular girls at Reagan High accidentally kill the prom queen with a jawbreaker when a kidnapping goes horribly wrong.,22.0,Darren Stein,Jawbreaker,1999,87,USA, 3500000,3117085,3117085,0,-382915,0
32503,24.0,Drama,An ex convict befriends an elderly coworker as they both try to find meaning in life and forgiveness for their past.,79.0,Tom Gilroy,Spring Forward,1999,110,USA, 2000000,117471,117471,0,-1882529,0
32734,43.0,"Comedy, Family, Romance",Inept Canadian mountie Dudley Do-Right chases after villian Snidely Whiplash and woos girlfriend Nell Fenwick.,44.0,Hugh Wilson,Dudley Do-Right,1999,77,USA, 70000000,9974410,9974410,0,-60025590,0
32570,96.0,"Drama, Mystery, Romance","A police sergeant and a congresswoman both lose their spouses in a plane crash, and they soon discover that their spouses were having an affair with each other.",38.0,Sydney Pollack,Random Hearts,1999,133,USA, 64000000,31502583,74608570,43105987,10608570,1
32154,168.0,"Action, Fantasy, Horror","At the end of the century, Satan visits New York in search of a bride. It's up to an ex-cop who now runs an elite security outfit to stop him.",33.0,Peter Hyams,End of Days,1999,122,USA, 100000000,66889043,211989043,145100000,111989043,1
32119,179.0,"Action, Adventure, Comedy","Dr. Evil is back and has invented a new time machine that allows him to go back to the 1960s and steal Austin Powers' mojo, inadvertently leaving him ""shagless"".",59.0,Jay Roach,Austin Powers: The Spy Who Shagged Me,1999,95,USA, 33000000,206040086,312016858,105976772,279016858,1
32634,82.0,"Comedy, Drama, Music","In the 1930s, jazz guitarist Emmet Ray idolizes Django Reinhardt, faces gangsters and falls in love with a mute woman.",70.0,Woody Allen,Sweet and Lowdown,1999,95,USA, 29750000,4197015,4525794,328779,-25224206,0
32258,71.0,Drama,"A true story of politics and art in the 1930s U.S., focusing on a leftist musical drama and attempts to stop its production.",64.0,Tim Robbins,Cradle Will Rock,1999,132,USA, 36000000,2903404,2986932,83528,-33013068,0
32673,163.0,"Animation, Comedy, Fantasy","When Cartman and his friends go see an R rated movie, they start cursing and their parents think that Canada is to blame.",73.0,Trey Parker,"South Park: Bigger, Longer & Uncut",1999,81,USA, 21000000,52037603,83137603,31100000,62137603,1
32676,171.0,"Drama, Romance","A group of male friends become obsessed with five mysterious sisters who are sheltered by their strict, religious parents in suburban Detroit in the mid 1970s.",76.0,Sofia Coppola,The Virgin Suicides,1999,97,USA, 9000000,4906229,10409377,5503148,1409377,1
32158,105.0,"Drama, Sport",A behind-the-scenes look at the life-and-death struggles of modern-day gladiators and those who lead them.,52.0,Oliver Stone,Any Given Sunday,1999,162,USA, 55000000,75530832,100230832,24700000,45230832,1
32467,79.0,"Comedy, Crime, Drama","An ultraconservative police officer suffers a debilitating stroke and is assigned to a rehabilitative program that includes singing lessons, with the drag queen next door.",50.0,Joel Schumacher,Flawless,1999,112,USA, 15000000,4488529,4488529,0,-10511471,0
33519,39.0,"Drama, Thriller",A group of teens are bent on improving the run-down conditions of their high-school.,43.0,Craig Bolotin,Light It Up,1999,99,USA, 13000000,5985690,5985690,0,-7014310,0
32798,63.0,"Drama, Comedy","A woman and her daughter have been constantly moving from town to town for years, but their newest home might be different from all the others.",75.0,Gavin O'Connor,Tumbleweeds,1999,102,USA, 312000,1350248,1350248,0,1038248,1
33166,81.0,"Drama, Music",Story of a schoolteacher's struggle to teach violin to inner-city Harlem kids.,54.0,Wes Craven,Music of the Heart,1999,124,USA, 27000000,14859394,14936407,77013,-12063593,0
34766,67.0,"Comedy, Drama, Sport",Two best friends and former middleweight contenders travel to Las Vegas to fight each other for the first time.,32.0,Ron Shelton,Play It to the Bone,1999,124,USA, 24000000,8434146,8678812,244666,-15321188,0
34493,14.0,Drama,A picturesque Pacific Northwest community raising its wheat and children in the midst of a nation reeling from World War I sets the stage for The Basket. In a time of pain and prejudice ...,53.0,Rich Cowan,The Basket,1999,105,USA, 1300000,367098,367098,0,-932902,0
34459,58.0,"Drama, Comedy","Two veteran salesmen dissect a sales pitch to a particular client, through their young prot√©g√©.",56.0,John Swanbeck,The Big Kahuna,1999,90,USA, 7000000,3165544,3728888,563344,-3271112,0
33218,261.0,"Drama, Mystery, Thriller",A boy who communicates with spirits seeks the help of a disheartened child psychologist.,64.0,M. Night Shyamalan,The Sixth Sense,1999,107,USA, 40000000,293506292,672806292,379300000,632806292,1
34429,44.0,Comedy,"Seth Winnick has it all: a successful career in television, good friends, and a passionate relationship with beautiful Chelsea. However, when he fails to make a timely marriage proposal, Chelsea tries to make his life hell.",23.0,Jeff Franklin,Love Stinks,1999,94,USA, 4000000,2924635,2924635,0,-1075365,0
33220,46.0,"Comedy, Romance","A nerdy Catholic schoolgirl, Mary Katherine Gallagher, dreams of superstardom.",42.0,Bruce McCulloch,Superstar,1999,81,USA, 34000000,30636478,30636478,0,-3363522,0
33290,31.0,"Comedy, Drama, Romance",Just before best friend's wedding the life of Chicago writer becomes crazy when his friend guesses that new book's story based on his bride's fervent past.,61.0,Malcolm D. Lee,The Best Man,1999,120,USA, 9000000,34102780,34573780,471000,25573780,1
33134,80.0,"Drama, History, Romance","The story of the romance between the King of Siam and widowed British schoolteacher, Anna Leonowens, during the 1860s.",56.0,Andy Tennant,Anna and the King,1999,148,USA, 92000000,39263420,113996937,74733517,21996937,1
34267,405.0,"Horror, Mystery","Three film students vanish after traveling into a Maryland forest to film a documentary on the local Blair Witch legend, leaving only their footage behind.",81.0,"Daniel Myrick, Eduardo S√°nchez",The Blair Witch Project,1999,81,USA, 60000,140539099,248639099,108100000,248579099,1
33813,79.0,"Comedy, Drama, Romance",A naive teenager is sent to rehab camp when her straitlaced parents and friends suspect her of being a lesbian.,39.0,Jamie Babbit,But I'm a Cheerleader,1999,85,USA, 1200000,2205627,2595216,389589,1395216,1
33756,228.0,"Adventure, Comedy, Sci-Fi","The alumni cast of a space opera television series have to play their roles as the real thing when an alien race needs their help. However, they also have to defend both Earth and the alien race from a reptilian warlord.",70.0,Dean Parisot,Galaxy Quest,1999,102,USA, 45000000,71583916,90683916,19100000,45683916,1
33363,194.0,Drama,A sexually frustrated suburban father has a mid-life crisis after becoming infatuated with his daughter's best friend.,86.0,Sam Mendes,American Beauty,1999,122,USA, 15000000,130096601,356296601,226200000,341296601,1
33691,82.0,"Action, Sci-Fi","The ""universal soldiers"" must fight the whole army, when the military's supercomputer S.E.T.H gets out of control.",24.0,Mic Rodgers,Universal Soldier: The Return,1999,83,USA, 45000000,10667893,10667893,0,-34332107,0
33670,234.0,Drama,"An epic mosaic of interrelated characters in search of love, forgiveness, and meaning in the San Fernando Valley.",77.0,Paul Thomas Anderson,Magnolia,1999,188,USA, 37000000,22455976,48451803,25995827,11451803,1
33618,67.0,"Biography, Drama, Sport","The story of Rubin ""Hurricane"" Carter, a boxer wrongly imprisoned for murder, and the people who aided in his fight to prove his innocence.",74.0,Norman Jewison,The Hurricane,1999,146,USA, 50000000,50699241,73956241,23257000,23956241,1
33447,171.0,"Fantasy, Horror, Mystery","When Eleanor, Theo, and Luke decide to take part in a sleep study at a huge mansion they get more than they bargained for when Dr. Marrow tells them of the house's ghostly past.",42.0,Jan de Bont,The Haunting,1999,113,USA, 80000000,91411151,177311151,85900000,97311151,1
33467,120.0,"Biography, Crime, Drama","A young man named Brandon Teena navigates love, life, and being transgender in rural Nebraska.",86.0,Kimberly Peirce,Boys Don't Cry,1999,118,USA, 2000000,11540607,11540607,0,9540607,1
31887,74.0,"Action, Adventure, Comedy",A security guard's dreams come true when he is selected to be transformed into a cybernetic police officer.,36.0,David Kellogg,Inspector Gadget,1999,78,USA, 90000000,97403112,134403112,37000000,44403112,1
34245,159.0,"Horror, Mystery, Thriller","An amusement park mogul offers a group of diverse people $1,000,000 to spend the night in a haunted house with a horrifying past.",28.0,William Malone,House on Haunted Hill,1999,93,USA, 37000000,40846082,42593455,1747373,5593455,1
32790,100.0,"Comedy, Drama, Romance",Ben and Katie Jordan are a married couple who go through hard times in fifteen years of marriage.,37.0,Rob Reiner,The Story of Us,1999,95,USA, 50000000,27100031,58900031,31800000,8900031,1
33081,112.0,"Crime, Drama, Mystery",An extremely volatile and dangerous Englishman goes to Los Angeles to find the man he considers responsible for his daughter's death.,73.0,Steven Soderbergh,The Limey,1999,89,USA, 10000000,3204663,3325736,121073,-6674264,0
32806,18.0,"Comedy, Drama, Romance","While dealing with a friend's cold feet on his wedding day, a writer reminisces about his youth with his best friends.",52.0,Rick Famuyiwa,The Wood,1999,106,USA, 6000000,25059640,25059640,0,19059640,1
32858,21.0,"Comedy, Romance","Two brothers share a house in LA's Fairfax district: Tony's a feckless actor, Chris is an accountant. Both are in relationships on rocky ground. As these emotions swirl, Tony meets his US ...",44.0,Kevin Jordan,Goat on Fire and Smiling Fish,1999,90,USA, 40000,278492,278492,0,238492,1
32859,78.0,"Comedy, Crime, Romance","3 prisoners escape. 2 end up in Happy, Texas, where they're mistaken for a gay couple expected there to help with the small girls beauty pageant. As the 2 are paid $1000, they decide to stay until the heat is gone.",62.0,Mark Illsley,"Happy, Texas",1999,98,USA, 2500000,1955933,1955933,0,-544067,0
32871,87.0,"Crime, Drama, Romance","Spike Lee's take on the ""Son of Sam"" murders in New York City during the summer of 1977 centering on the residents of an Italian-American Northeast Bronx neighborhood who live in fear and distrust of one another.",67.0,Spike Lee,Summer of Sam,1999,142,USA, 22000000,19288130,19288130,0,-2711870,0
35996,12.0,Drama,The only goal of an ageing Asian-American widow is to see her son and rebellious daughter (described as an American Born Confused Deshi or ABCD) married off to respectable Indian families.,53.0,Krutin Patel,ABCD,1999,105,USA, 200000,83372,83372,0,-116628,0
35234,93.0,"Comedy, Romance","An average aquarium cleaner house-sits for a gigolo, only to be forced to become one himself.",30.0,Mike Mitchell,Deuce Bigalow: Male Gigolo,1999,88,USA, 17000000,65538755,92938755,27400000,75938755,1
32916,104.0,"Comedy, Romance",A reporter is assigned to write a story about a woman who has left a string of fiances at the altar.,39.0,Garry Marshall,Runaway Bride,1999,116,USA, 70000000,152257509,309460292,157202783,239460292,1
32929,68.0,"Action, Adventure, Comedy","A new biological chemical weapon that explodes up to temperatures over fifty degrees Fahrenheit, falls into the hands of two men who try to make sure that it doesn't get stolen by a terrorist.",33.0,Hugh Johnson,Chill Factor,1999,102,USA, 70000000,11263966,11788676,524710,-58211324,0
32935,154.0,Comedy,Four teenage boys enter a pact to lose their virginity by prom night.,58.0,"Paul Weitz, Chris Weitz",American Pie,1999,95,USA, 11000000,102561004,235483004,132922000,224483004,1
32951,170.0,"Drama, Thriller","Haunted by the patients he failed to save, an extremely burned-out Manhattan ambulance paramedic fights to maintain his sanity over three fraught and turbulent nights.",70.0,Martin Scorsese,Bringing Out the Dead,1999,121,USA, 55000000,16797191,16797191,0,-38202809,0
34962,105.0,"Horror, Sci-Fi, Thriller",Genetically mutated bats escape and it's up to a bat expert and the local sheriff to stop them.,23.0,Louis Morneau,Bats,1999,91,USA, 5250000,10155690,10155690,0,4905690,1
32965,101.0,Comedy,"With his career on the skids, a Hollywood screenwriter enlists the aid of a modern-day muse, who proves to test his patience.",56.0,Albert Brooks,The Muse,1999,97,USA, 15000000,11614954,11670561,55607,-3329439,0
32966,60.0,"Comedy, Drama, Romance","Nicole and Chase used to be BFFs, then junior high happened. The high school centennial dance is coming but Nicole gets dumped. So does Chase. They stage a relationship to get at their exes. They visit each other's worlds. Love in the air?",42.0,John Schultz,Drive Me Crazy,1999,91,USA, 8500000,17845337,22593409,4748072,14093409,1
32968,175.0,"Horror, Mystery, Thriller","After being hypnotized by his sister-in-law, a man begins seeing haunting visions of a girl's ghost and a mystery begins to unfold around him.",67.0,David Koepp,Stir of Echoes,1999,99,USA, 12000000,21142914,21142914,0,9142914,1
33065,37.0,"Crime, Drama, Music",A group of white high school teens become involved with Harlem's black hip-hop crowd.,47.0,James Toback,Black and White,1999,98,USA, 12000000,5277299,5541431,264132,-6458569,0
33067,43.0,"Comedy, Music","In 1978, four rebellious teenagers try to scam their way into a",33.0,Adam Rifkin,Detroit Rock City,1999,95,USA, 34000000,4217115,4217115,0,-29782885,0
35149,39.0,"Action, Adventure, Fantasy","Ancient codes hidden within the Torah reveal the secrets of global events, past (i.e., Hitler, the Kennedy assassination, the Gulf War), present, and future. One man (York) is after the ...",14.0,Robert Marcarelli,The Omega Code,1999,100,USA, 8000000,12614346,12614346,0,4614346,1
32876,54.0,Drama,Conjoined twins have their relationship tested when a woman takes interest in one of them.,71.0,Michael Polish,Twin Falls Idaho,1999,111,USA, 500000,985341,985341,0,485341,1
31943,89.0,"Comedy, Drama","A lazy law school grad adopts a kid to impress his girlfriend, but everything doesn't go as planned and he becomes the unlikely foster father.",41.0,Dennis Dugan,Big Daddy,1999,93,USA, 34200000,163479795,234801895,71322100,200601895,1
30473,48.0,"Comedy, Family, Sci-Fi",A Martian lands on Earth and makes friends with a reporter.,33.0,Donald Petrie,My Favorite Martian,1999,94,USA, 65000000,36850101,36850101,0,-28149899,0
30380,120.0,"Action, Adventure, Fantasy","At an archaeological dig in the ancient city of Hamunaptra, an American serving in the French Foreign Legion accidentally awakens a mummy who begins to wreck havoc as he searches for the reincarnation of his long-lost love.",48.0,Stephen Sommers,The Mummy,1999,124,USA, 80000000,155385488,415933406,260547918,335933406,1
30470,63.0,"Action, Crime, Thriller","Three delinquents are recruited by an undercover cop working to bust a drug ring - when that officer is killed, the trio decides to crack the case and prove they are real law officers. With Giovanni Ribisi, Omar Epps.",16.0,Scott Silver,The Mod Squad,1999,92,USA, 50000000,13263993,13263993,0,-36736007,0
30381,44.0,Comedy,A portrait of a fictional town in the midwest that is home to a group of idiosyncratic and slightly neurotic characters. Dwayne Hoover is a wealthy car dealership owner that's on the brink ...,42.0,Alan Rudolph,Breakfast of Champions,1999,110,USA, 12000000,178278,178278,0,-11821722,0
31110,99.0,"Drama, Thriller","When noted anthropologist Dr. Ethan Powell, who left society to live in the jungle is imprisoned for murder, it's up to young psychiatrist Theo Caulder to get through to him.",43.0,Jon Turteltaub,Instinct,1999,126,USA, 80000000,34105207,34105207,0,-45894793,0
30379,44.0,"Drama, Romance",The world of a young housewife is turned upside down when she has an affair with a free-spirited blouse salesman.,70.0,Tony Goldwyn,A Walk on the Moon,1999,107,USA, 14000000,4750660,4750660,0,-9249340,0
31155,190.0,"Animation, Action, Adventure",A young boy befriends a giant robot from outer space that a paranoid government agent wants to destroy.,85.0,Brad Bird,The Iron Giant,1999,86,USA, 70000000,23159305,23179225,19920,-46820775,0
30272,210.0,"Animation, Adventure, Comedy","When Woody is stolen by a toy collector, Buzz and his friends set out on a rescue mission to save Woody before he becomes a museum toy property with his roundup gang Jessie, Prospector, and Bullseye.",88.0,"John Lasseter, Ash Brannon",Toy Story 2,1999,92,USA, 90000000,245852179,508793269,262941090,418793269,1
31280,154.0,Comedy,"When a desperate movie producer fails to get a major star for his bargain basement film, he decides to shoot the film secretly around him.",71.0,Frank Oz,Bowfinger,1999,97,USA, 55000000,66384775,98625775,32241000,43625775,1
31284,71.0,"Comedy, Drama",A video store clerk agrees to have his life filmed by a camera crew for a television show.,48.0,Ron Howard,Edtv,1999,122,USA, 80000000,22431897,35242897,12811000,-44757103,0
31330,129.0,"Action, Comedy, Fantasy",A group of inept amateur superheroes must try to save the day when a supervillain threatens to destroy a major superhero and the city.,65.0,Kinka Usher,Mystery Men,1999,121,USA, 68000000,29762011,33461011,3699000,-34538989,0
31344,58.0,"Drama, Romance",A blind man has an operation to regain his sight at the urging of his girlfriend and must deal with the changes to his life.,40.0,Irwin Winkler,At First Sight,1999,128,USA, 60000000,22365133,22365133,0,-37634867,0
30427,199.0,"Crime, Drama, Fantasy","The lives of guards on Death Row are affected by one of their charges: a black man accused of child murder and rape, yet who has a mysterious gift.",61.0,Frank Darabont,The Green Mile,1999,189,USA, 60000000,136801374,286801374,150000000,226801374,1
31166,61.0,Comedy,"The remake of the 1970 Neil Simon comedy follows the adventures of a couple, Henry and Nancy Clark, vexed by misfortune while in New York City for a job interview.",33.0,Sam Weisman,The Out-of-Towners,1999,90,USA, 75000000,28544120,28544120,0,-46455880,0
31014,93.0,"Drama, Romance, Sport","After 19 years of playing the game he's loved his whole life, Billy Chapel has to decide if he's going to risk everything and put everything out there.",43.0,Sam Raimi,For Love of the Game,1999,137,USA, 80000000,35188640,46112640,10924000,-33887360,0
31012,186.0,"Comedy, Drama, Romance","A high school teacher's personal life becomes complicated as he works with students during the school elections, particularly with an obsessive overachiever determined to become student body president.",83.0,Alexander Payne,Election,1999,103,USA, 25000000,14902041,14902041,0,-10097959,0
30963,94.0,"Comedy, Drama",Conflict arises in the small town of Holly Springs when an old woman's death causes a variety of reactions among family and friends.,70.0,Robert Altman,Cookie's Fortune,1999,118,USA, 10000000,10920544,10920544,0,920544,1
30554,95.0,"Action, Comedy, Sci-Fi","The two best special agents in the Wild West must save President Grant from the clutches of a diabolical, wheelchair-bound, steampunk-savvy, Confederate scientist bent on revenge for losing the Civil War.",38.0,Barry Sonnenfeld,Wild Wild West,1999,106,USA, 170000000,113804681,222104681,108300000,52104681,1
30208,136.0,"Action, Adventure, Comedy","In the aftermath of the Persian Gulf War, four soldiers set out to steal gold that was stolen from Kuwait, but they discover people who desperately need their help.",82.0,David O. Russell,Three Kings,1999,114,USA, 75000000,60652036,107752036,47100000,32752036,1
30566,344.0,"Action, Adventure, Fantasy","Two Jedi escape a hostile blockade to find allies and come across a young boy who may bring balance to the Force, but the long dormant Sith resurface to claim their old glory.",51.0,George Lucas,Star Wars: Episode I - The Phantom Menace,1999,136,USA, 115000000,474544677,1027082707,552538030,912082707,1
30370,74.0,"Comedy, Romance","A commitment-phobic man goes in search of a bride, including his fed-up girlfriend, to inherit his grandfather's $100 million inheritance.",31.0,Gary Sinyor,The Bachelor,1999,101,USA, 51000000,21760240,36911617,15151377,-14088383,0
30529,166.0,"Animation, Adventure, Family",A man raised by gorillas must decide where he really belongs when he discovers he is a human.,79.0,"Chris Buck, Kevin Lima",Tarzan,1999,88,USA, 130000000,171091819,448191819,277100000,318191819,1
30521,33.0,"Comedy, Romance","In order to impress his beautiful French neighbor, Dylan Ramsey dognaps her pet pooch so he can return him and become a hero. Unfortunately, things do not work out as planned.",19.0,Jeff Pollack,Lost & Found,1999,100,USA, 30000000,6552255,6552255,0,-23447745,0
30519,98.0,"Drama, Mystery, Romance","A Japanese-American fisherman is accused of killing his neighbor at sea. In the 1950s, race figures into the trial. So does reporter Ishmael.",44.0,Scott Hicks,Snow Falling on Cedars,1999,127,USA, 35000000,14417593,23049593,8632000,-11950407,0
30746,51.0,"Comedy, Drama, Romance",A mentally challenged young woman seeks independence by obtaining her own apartment and attending college while her family plans her sister's wedding.,28.0,Garry Marshall,The Other Sister,1999,129,USA, 35000000,27807627,27807627,0,-7192373,0
30804,62.0,"Comedy, Crime, Drama","In 1932, two strangers are wrongfully convicted and develop a strong friendship in prison that lasts them through the 20th century.",63.0,Ted Demme,Life,1999,108,USA, 80000000,64016268,73475268,9459000,-6524732,0
30840,95.0,"Comedy, Drama, Romance",A naive man comes out into the world after spending 35 years in a nuclear fallout shelter.,48.0,Hugh Wilson,Blast from the Past,1999,112,USA, 35000000,26511114,40263020,13751906,5263020,1
30844,147.0,"Drama, Romance","A compassionate young man, raised in an orphanage and trained to be a doctor there, decides to leave to see the world.",75.0,Lasse Hallstr√∂m,The Cider House Rules,1999,126,USA, 24000000,57545092,88545092,31000000,64545092,1
30491,154.0,"Action, Crime, Drama","After a successful heist, Porter is shot by his wife and his best friend. They leave him there to die but when he recovers, he seeks revenge and wants his share of the money.",46.0,Brian Helgeland,Payback,1999,100,USA, 90000000,81526121,161626121,80100000,71626121,1
30948,72.0,"Comedy, Drama, Romance","After one too many run ins with the law, a punk teenager from a working class background is sent to prep school by his frustrated dad, and learns a thing or two.",62.0,Michael Corrente,Outside Providence,1999,96,USA, 7000000,7302522,7302522,0,302522,1
31879,94.0,"Comedy, Romance",A soon-to-be-married man encounters an exciting stranger after his plane suffers an accident on takeoff.,46.0,Bronwen Hughes,Forces of Nature,1999,105,USA, 75000000,52900680,93900680,41000000,18900680,1
30372,258.0,"Comedy, Drama, Fantasy",A puppeteer discovers a portal that leads literally into the head of movie star,90.0,Spike Jonze,Being John Malkovich,1999,113,USA, 13000000,22863596,23106667,243071,10106667,1
31368,68.0,"Comedy, Thriller","The story of a girl who is willing to do anything to become Valedictorian, even if it means murdering the teacher that stands in her way.",35.0,Kevin Williamson,Teaching Mrs. Tingle,1999,96,USA, 13000000,8951935,8951935,0,-4048065,0
31375,337.0,"Action, Sci-Fi",A computer hacker learns from mysterious rebels about the true nature of his reality and his role in the war against its controllers.,73.0,"Lana Wachowski, Lilly Wachowski",The Matrix,1999,136,USA, 63000000,171479930,465343787,293863857,402343787,1
31342,119.0,"Biography, Drama, Family","The true story of Homer Hickam, a coal miner's son who was inspired by the first Sputnik launch to take up rocketry against his father's wishes.",71.0,Joe Johnston,October Sky,1999,108,USA, 25000000,32570685,34698685,2128000,9698685,1
30422,48.0,"Crime, Drama, Thriller","A street-wise, middle-aged moll named Gloria stands up against the mobs, which is complicated by a six-year-old urchin with a will of his own who she reluctantly takes under her wing after ...",26.0,Sidney Lumet,Gloria,1999,108,USA, 30000000,4197729,4197729,0,-25802271,0
31835,69.0,"Comedy, Drama","In the small town of Mumford, a psychologist of the same name moves in and quickly becomes very popular, despite a questionable past.",62.0,Lawrence Kasdan,Mumford,1999,112,USA, 28000000,4555459,4555459,0,-23444541,0
31829,212.0,"Biography, Drama, Thriller","A research chemist comes under personal and professional attack when he decides to appear in a ""60 Minutes"" expose on Big Tobacco.",84.0,Michael Mann,The Insider,1999,157,USA, 90000000,29089912,60289912,31200000,-29710088,0
31792,69.0,"Comedy, Drama, Romance",A back-up quarterback is chosen to lead a Texas football team to victory after the star quarterback is injured.,50.0,Brian Robbins,Varsity Blues,1999,106,USA, 16000000,52894169,54294169,1400000,38294169,1
31784,96.0,"Crime, Drama, Mystery",Can an over-the-hill journalist uncover the evidence that can prove a death row inmate's innocence just hours before his execution?,65.0,Clint Eastwood,True Crime,1999,127,USA, 55000000,16649768,16649768,0,-38350232,0
31760,89.0,"Drama, Romance","A woman discovers a tragic love letter in a bottle on a beach, and is determined to track down its author.",39.0,Luis Mandoki,Message in a Bottle,1999,126,USA, 80000000,52880016,118880016,66000000,38880016,1
31753,164.0,"Action, Comedy, Horror","Three people attempt to stop a gigantic crocodile, who is terrorizing residents in Black Lake, Maine.",34.0,Steve Miner,Lake Placid,1999,82,USA, 35000000,31770414,56870414,25100000,21870414,1
31744,143.0,"Comedy, Crime","Go! tells the story of the events after a drug deal, told from three different points of view.",72.0,Doug Liman,Go,1999,102,USA, 20000000,16943454,28451622,11508168,8451622,1
31737,98.0,"Drama, Romance",Two vicious step-siblings of an elite Manhattan prep school make a wager: to deflower the new headmaster's daughter before the start of term.,56.0,Roger Kumble,Cruel Intentions,1999,97,USA, 10500000,38773785,76347426,37573641,65847426,1
30402,55.0,Drama,"The Deep End of The Ocean is a film about a family's reaction when Ben, the youngest son is kidnapped and then found nine years later, living in the same town, where his family had just moved.",45.0,Ulu Grosbard,The Deep End of the Ocean,1999,106,USA, 38000000,13898649,28121100,14222451,-9878900,0
30383,47.0,"Drama, Mystery, Thriller",Two women are arrested for smuggling while vacationing in Thailand.,44.0,Jonathan Kaplan,Brokedown Palace,1999,100,USA, 25000000,10115013,10115013,0,-14884987,0
31677,67.0,"Comedy, Fantasy, Horror",A teenage slacker's right hand becomes possessed with murderous intent.,31.0,Rodman Flender,Idle Hands,1999,92,USA, 25000000,4152230,4152230,0,-20847770,0
31657,109.0,"Drama, Sci-Fi, Thriller","After an explosion in space and subsequent two-minute radio-out period, two astronauts return home to their wives. Slightly it's revealed that they're not the same as they were.",37.0,Rand Ravich,The Astronaut's Wife,1999,109,USA, 75000000,10672566,19598588,8926022,-55401412,0
31616,160.0,"Crime, Drama, Thriller",A man begins to suspect his neighbors are not what they appear to be and their secrets could be deadly.,65.0,Mark Pellington,Arlington Road,1999,117,USA, 31000000,24756177,41067311,16311134,10067311,1
30563,132.0,"Animation, Comedy, Family",An update of the original film with new interpretations of great works of classical music.,59.0,"James Algar, Ga√´tan Brizzi",Fantasia 2000,1999,75,USA, 80000000,60655420,90874570,30219150,10874570,1
29552,49.0,"Comedy, Crime, Family","Scientist hold talking, super-intelligent babies captive, but things take a turn for the worse when a mix-up occurs between a baby genius and its twin.",6.0,Bob Clark,Baby Geniuses,1999,97,USA, 12000000,27250736,36450736,9200000,24450736,1
30406,187.0,"Adventure, Comedy, Drama",An abortion clinic worker with a special heritage is called upon to save the existence of humanity from being negated by two renegade angels trying to exploit a loop-hole and reenter Heaven.,62.0,Kevin Smith,Dogma,1999,130,USA, 10000000,30652890,31429330,776440,21429330,1
31439,93.0,"Drama, Romance, War","During the American Civil War, two friends join the Bushwhackers, a militant group loyal to the Confederacy.",69.0,Ang Lee,Ride with the Devil,1999,138,USA, 38000000,635096,635096,0,-37364904,0
31436,196.0,"Crime, Drama, Thriller","In late 1950s New York, Tom Ripley, a young underachiever, is sent to Italy to retrieve Dickie Greenleaf, a rich and spoiled millionaire playboy. But when the errand fails, Ripley takes extreme measures.",76.0,Anthony Minghella,The Talented Mr. Ripley,1999,139,USA, 40000000,81298265,128798265,47500000,88798265,1
31612,71.0,"Comedy, Drama, Romance","A collection of twentysomethings try to cope with relationships, loneliness, desire and their individual neuroses.",33.0,Risa Bramon Garcia,200 Cigarettes,1999,101,USA, 6000000,6852450,6852450,0,852450,1
31410,55.0,"Crime, Drama, Thriller",A seemingly simple plan to steal money goes increasingly awry.,40.0,Mike Barker,Best Laid Plans,1999,92,USA, 7000000,27816,27816,0,-6972184,0
30407,91.0,"Action, Adventure, History","A man, having fallen in love with the wrong woman, is sent by the sultan himself on a diplomatic mission to a distant land as an ambassador. Stopping at a Viking village port to restock on supplies, he finds himself unwittingly embroiled in a quest to banish a mysterious threat in a distant Viking land.",42.0,"John McTiernan, Michael Crichton",The 13th Warrior,1999,102,USA, 160000000,32698899,61698899,29000000,-98301101,0
35903,149.0,"Drama, Fantasy, Horror",A woman with extrasensory perception is asked to help find a young woman who has disappeared.,62.0,Sam Raimi,The Gift,2000,112,USA, 10000000,12008642,44567606,32558964,34567606,1
34290,171.0,"Action, Adventure, Thriller","When retired engineer Frank Corvin (Clint Eastwood) is called upon to rescue a failing satellite, he insists that his equally old teammates accompany him into space.",73.0,Clint Eastwood,Space Cowboys,2000,130,USA, 65000000,90464773,128884132,38419359,63884132,1
35906,87.0,"Comedy, Family, Fantasy",An unhappy and disliked image consultant gets a second shot at life when he is mysteriously confronted by an eight-year-old version of himself.,45.0,Jon Turteltaub,The Kid,2000,104,USA, 65000000,69691949,110317580,40625631,45317580,1
34384,48.0,"Drama, Sport","An ex-boxer, living with the knowledge that his fight career was cut short by a crooked manager, channels his bitter disappointment in a single-minded quest for boxing championships for his...",32.0,Carlos Avila,Price of Glory,2000,118,USA, 18000000,3440228,3548556,108328,-14451444,0
34214,69.0,"Action, Adventure, Crime","After assuming his dead cellmate's identity to get with the other man's girlfriend, an ex-con finds himself a reluctant participant in a casino heist.",37.0,John Frankenheimer,Reindeer Games,2000,104,USA, 42000000,23368995,32168970,8799975,-9831030,0
34562,118.0,"Comedy, Drama",A big-city newspaper columnist is forced to enter a drug and alcohol rehab center after ruining her sister's wedding and crashing a stolen limousine.,46.0,Betty Thomas,28 Days,2000,103,USA, 43000000,37170488,62198945,25028457,19198945,1
35901,125.0,"Action, Fantasy, Horror","A group of thieves breaks into a chamber expecting to find paintings, but instead they release the count himself, who travels to New Orleans to find his nemesis' daughter, Mary Van Helsing.",26.0,Patrick Lussier,Dracula 2000,2000,99,USA, 54000000,33022767,47053625,14030858,-6946375,0
35872,128.0,Comedy,A colorful array of characters compete at a national dog show.,78.0,Christopher Guest,Best in Show,2000,90,USA, 10000000,18715392,20789556,2074164,10789556,1
34145,114.0,"Biography, Drama","A film about the life and career of the American painter, Jackson Pollock.",77.0,Ed Harris,Pollock,2000,122,USA, 6000000,8598593,10994533,2395940,4994533,1
34616,3.0,"Comedy, Romance",Enemies tells the story of a playwright and sitcom writer Paul Halpern (Academy Award Nominee David Paymer) who can't buy a break!,47.0,Joey Travolta,Enemies of Laughter,2000,90,USA, 2500000,2000,2000,0,-2498000,0
34309,67.0,"Comedy, Drama, Romance",A young man wins and loses the first serious love of his life. Al Connelly falls in love with the girl of his dreams. After the summer she breaks up with him. As he tries to recover Al goes to desperate measures.,13.0,Kris Isacsson,Down to You,2000,91,USA, 11000000,20069008,24419914,4350906,13419914,1
34220,35.0,"Adventure, Comedy, Family","When a school in upstate New York is snowed in, a group of students hi-jack a plow to keep the school closed.",34.0,Chris Koch,Snow Day,2000,89,USA, 13000000,60020107,62464731,2444624,49464731,1
35876,131.0,"Comedy, Drama, Fantasy","A fast-lane investment broker, offered the opportunity to see how the other half lives, wakes up to find that his sports car and girlfriend have become a mini-van and wife.",42.0,Brett Ratner,The Family Man,2000,125,USA, 60000000,75793305,124745083,48951778,64745083,1
34315,141.0,"Action, Crime, Thriller",A retired master car thief must come back to the industry and steal fifty cars with his crew in one night to save his brother's life.,35.0,Dominic Sena,Gone in Sixty Seconds,2000,118,USA, 90000000,101648571,237202299,135553728,147202299,1
34238,184.0,"Action, Adventure, Sci-Fi","It's the year 3000 A.D.; the Earth is lost to the alien race of Psychlos. Humanity is enslaved by these gold-thirsty tyrants, whom are unaware that their 'man-animals' are about to ignite the rebellion of a lifetime.",9.0,Roger Christian,Battlefield Earth,2000,118,USA, 73000000,21471685,29725663,8253978,-43274337,0
34289,14.0,"Drama, Romance","In addition to declaring that Katharine's (Lynn Redgrave) head and heart line are hopelessly fused into one ""simian line"", eccentric palm reader/fortune-teller Arnita (Tyne Daly) makes a ...",46.0,Linda Yellen,The Simian Line,2000,106,USA, 2000000,19823,19823,0,-1980177,0
34488,51.0,"Comedy, Crime","A struggling dentist's life is turned upside down when a famous gangster moves in next door, and his wife convinces him to inform a notorious mob boss about the gangster's whereabouts.",47.0,Jonathan Lynn,The Whole Nine Yards,2000,98,USA, 41300000,57262492,106371651,49109159,65071651,1
34299,109.0,"Drama, Romance",A man switches plane tickets with another man who dies in that plane in a crash. The man falls in love with the deceased one's wife.,52.0,Don Roos,Bounce,2000,106,USA, 35000000,36805288,53425292,16620004,18425292,1
34274,132.0,"Crime, Drama, Mystery","An accidental cross-time radio link connects father and son across 30 years. The son tries to save his father's life, but then must fix the consequences.",67.0,Gregory Hoblit,Frequency,2000,118,USA, 31000000,45010278,68106245,23095967,37106245,1
34272,33.0,"Comedy, Crime, Mystery","When a woman drives a car into the river to her death, everyone in town becomes a suspect.",25.0,Nick Gomez,Drowning Mona,2000,96,USA, 37000000,15506764,15910104,403340,-21089896,0
34551,119.0,"Comedy, Sport","During a pro football strike, the owners hire substitute players.",30.0,Howard Deutch,The Replacements,2000,118,USA, 50000000,44737059,50054511,5317452,54511,1
34247,88.0,"Comedy, Fantasy","After two of the devil's three sons escape Hell to wreak havoc on Earth, the devil must send his third son, the mild-mannered Nicky, to bring them back before it's too late.",38.0,Steven Brill,Little Nicky,2000,90,USA, 85000000,39464775,58292295,18827520,-26707705,0
30317,22.0,"Crime, Drama, Thriller",A man who performs as a children's birthday party clown tries to piece his life back together after being gang-raped.,5.0,Bryan Johnson,Vulgar,2000,87,USA, 120000,15927,15927,0,-104073,0
34714,170.0,"Biography, Drama",An unemployed single mother becomes a legal assistant and almost single-handedly brings down a California power company accused of polluting a city's water supply.,73.0,Steven Soderbergh,Erin Brockovich,2000,131,USA, 52000000,125595205,256271286,130676081,204271286,1
35209,106.0,"Crime, Drama, Mystery",David is a serial killer of young women. Joel was in charge of catching him in LA. He moved to Chicago a broken man. So did David and sends him photos of his next victims 24 hours before the murders.,22.0,Joe Charbanic,The Watcher,2000,97,USA, 30000000,28946615,47267829,18321214,17267829,1
35231,3.0,"Crime, Drama, Thriller","Jimmy joins a corrupt LAPD police force as a crime scene photographer. Soon, however, his life takes a turn for the worse as he descends into madness, rearranging evidence and victims to ""...",39.0,Hamlet Sarkissian,Camera Obscura,2000,99,USA, 2000000,11384,114015,102631,-1885985,0
35232,121.0,"Comedy, Romance, Sport",A champion high school cheerleading squad discovers its previous captain stole all their best routines from an inner-city school and must scramble to compete at this year's championships.,52.0,Peyton Reed,Bring It On,2000,98,USA, 11000000,68379000,90449929,22070929,79449929,1
35762,23.0,"Crime, Drama, Action","Trying to bootstrap his way out of Brooklyn's mean streets is Diamond, a rap musician. With his long-time pal Gage acting as his manager, he's trying to lay down a demo tape with cut-rate ...",18.0,Robert Adetuyi,Turn It Up,2000,86,USA, 13000000,1247949,1247949,0,-11752051,0
35703,59.0,"Comedy, Drama, Music","A frustrated African-American TV writer proposes a blackface minstrel show in protest, but to his chagrin it becomes a hit.",50.0,Spike Lee,Bamboozled,2000,135,USA, 10000000,2274979,2463650,188671,-7536350,0
35686,105.0,"Adventure, Comedy",Four college buddies embark on a road trip to retrieve an illicit tape mistakenly mailed to a female friend.,55.0,Todd Phillips,Road Trip,2000,93,USA, 16000000,68540777,119754278,51213501,103754278,1
35301,73.0,"Comedy, Fantasy, Romance","Brazilian chef Isabella Oliveira moves to San Francisco when her husband, frustrated by her motion sickness, cheats on her.",41.0,Fina Torres,Woman on Top,2000,92,USA, 8000000,5020111,10194274,5174163,2194274,1
35341,154.0,"Comedy, Fantasy, Romance","After an accident, a chauvinistic executive gains the ability to hear what women are really thinking.",47.0,Nancy Meyers,What Women Want,2000,127,USA, 70000000,182811707,374111707,191300000,304111707,1
35408,105.0,"Action, Crime, Drama",A Las Vegas mob enforcer travels back to his hometown to investigate his brother's mysterious death.,24.0,Stephen Kay,Get Carter,2000,102,USA, 63600000,14967182,19412993,4445811,-44187007,0
35417,203.0,"Mystery, Thriller",A man with short-term memory loss attempts to track down his wife's murderer.,80.0,Christopher Nolan,Memento,2000,113,USA, 9000000,25544867,39723096,14178229,30723096,1
35629,60.0,Comedy,The Saturday Night Live character gets a big screen treatment.,22.0,Reginald Hudlin,The Ladies Man,2000,84,USA, 24000000,13616610,13743212,126602,-10256788,0
35453,97.0,"Drama, Sport","Diana, without her father knowing it, trains as a boxer and achieves impressive success, blazing new trails for female boxers.",70.0,Karyn Kusama,Girlfight,2000,110,USA, 1000000,1565852,1666028,100176,666028,1
35468,38.0,"Drama, Music","After being denied a promotion at the university where she teaches, Doctor Lily Penleric, a brilliant musicologist, impulsively visits her sister, who runs a struggling rural school in ...",63.0,Maggie Greenwald,Songcatcher,2000,109,USA, 1800000,3059834,3171273,111439,1371273,1
35482,71.0,"Drama, Music, Romance",A group of 12 teenagers from various backgrounds enroll at the American Ballet Academy in New York to make it as ballet dancers and each one deals with the problems and stress of training and getting ahead in the world of dance.,52.0,Nicholas Hytner,Center Stage,2000,115,USA, 29000000,17200925,26385941,9185016,-2614059,0
35505,158.0,"Biography, Drama, Sport",The true story of a newly appointed African-American coach and his high school team on their first season as a racially integrated unit.,48.0,Boaz Yakin,Remember the Titans,2000,113,USA, 30000000,115654751,136706683,21051932,106706683,1
35611,14.0,Drama,"While trying to help their widowed mother cope, each of four sisters begins to understand what is missing in their own lives and relationships, and the lessons they learn affect the entire family.",29.0,Anne De Salvo,The Amati Girls,2000,91,USA, 6000000,49136,49136,0,-5950864,0
35564,137.0,"Comedy, Romance","Male nurse Greg Focker meets his girlfriend's parents before proposing, but her suspicious father is every date's worst nightmare.",73.0,Jay Roach,Meet the Parents,2000,108,USA, 55000000,166244045,330444045,164200000,275444045,1
35190,67.0,"Comedy, Drama, Romance",A friendship is put to the ultimate test when two best friends wind up in bed together.,29.0,Robert Iscove,Boys and Girls,2000,94,USA, 35000000,21799652,25850615,4050963,-9149385,0
35187,58.0,"Crime, Drama","A young man goes to prison and a tough, older convict takes him under his wing as a mentor.",65.0,Steve Buscemi,Animal Factory,2000,94,USA, 3600000,43805,43805,0,-3556195,0
35812,85.0,"Comedy, Romance","A college student, branded a loser by his roommates and booted from the dorm, falls in love with a coed who has eyes for their condescending professor.",35.0,Amy Heckerling,Loser,2000,98,USA, 20000000,15618626,18404706,2786080,-1595294,0
34715,154.0,"Horror, Thriller","After a teenager has a terrifying vision of him and his friends dying in a plane crash, he prevents the accident only to have Death hunt them down, one by one.",36.0,James Wong,Final Destination,2000,98,USA, 23000000,53331147,112880294,59549147,89880294,1
34716,45.0,"Drama, Romance",A rich college kid is taught a lesson after a joy ride ends up destroying a country restaurant.,25.0,Mark Piznarski,Here on Earth,2000,96,USA, 15000000,10522168,10873148,350980,-4126852,0
34720,15.0,Comedy,Uncle Elroy and Day Day owe money on taxes so Craig finds a way to steal from the next door neighbors to pay off the taxes so Uncle Elroy's house doesn't get put up for auction.,41.0,Steve Carr,Next Friday,2000,98,USA, 11000000,57328603,59827328,2498725,48827328,1
34734,92.0,"Comedy, Crime",A loser of a crook and his wife strike it rich when a botched bank job's cover business becomes a spectacular success.,69.0,Woody Allen,Small Time Crooks,2000,94,USA, 25000000,17266359,29934477,12668118,4934477,1
34817,79.0,"Comedy, Drama, Romance","A pregnant 17-year-old rebuilds her life after being abandoned by her boyfriend at a Wal-Mart in Sequoyah, Oklahoma.",30.0,Matt Williams,Where the Heart Is,2000,120,USA, 15000000,33772838,40863718,7090880,25863718,1
34826,55.0,"Comedy, Crime",Four retired mobsters plan one last crime to save their retirement home.,37.0,Michael Dinner,The Crew,2000,88,USA, 38000000,13023075,13105853,82778,-24894147,0
37319,5.0,"Drama, Romance","After his mother dies, 15-year-old Charley must live with his unloving, bullying father. Out of loneliness, Charley strikes up an illicit romance with 29-year-old Eban. When their families find out, they must make a life-altering decision.",30.0,James Bolton,Eban and Charley,2000,86,USA, 30000,16918,16918,0,-13082,0
34872,13.0,Comedy,"Brian Hooks plays a character who is just released from jail. And the state adopts a ""3 strikes"" rule for felons that involves serious penalties. Hooks has 2 strikes, and wants to change ...",11.0,DJ Pooh,3 Strikes,2000,82,USA, 3400000,9832166,9832166,0,6432166,1
34661,54.0,"Comedy, Crime, Drama","Alex, a hit man, tries to get out of the family business, but his father won't let him do so. While seeking the help of a therapist, he meets a sexually charged 23-year-old woman with whom he falls in love.",77.0,Henry Bromell,Panic,2000,88,USA, 1000000,779137,779137,0,-220863,0
34900,69.0,"Drama, Romance, Sport",Monica and Quincy love and play basketball together through many life challenges from childhood to adulthood.,70.0,Gina Prince-Bythewood,Love & Basketball,2000,124,USA, 20000000,27459615,27728118,268503,7728118,1
34969,55.0,"Comedy, Drama",An oddly naive man-child stalks his childhood best friend and tries to reconnect with their past.,76.0,Miguel Arteta,Chuck & Buck,2000,96,USA, 250000,1055671,1182065,126394,932065,1
34971,158.0,"Comedy, Drama, Music","Aspiring songwriter Violet Sanford, after getting a job at a women-run NYC bar that teases its male patrons, comes out of her shell.",27.0,David McNally,Coyote Ugly,2000,100,USA, 45000000,60786269,113916474,53130205,68916474,1
35830,334.0,"Drama, Mystery, Sci-Fi",A man learns something extraordinary about himself after a devastating accident.,62.0,M. Night Shyamalan,Unbreakable,2000,106,USA, 75000000,95011339,248118121,153106782,173118121,1
35088,28.0,"Comedy, Drama, Romance",A modern-day remake of the Cyrano DeBergerac tale.,20.0,David Raynr,Whatever It Takes,2000,94,USA, 32000000,8745680,9902115,1156435,-22097885,0
35819,54.0,"Comedy, Sport",Two slacker wrestling fans are devastated by the ousting of their favorite character by an unscrupulous promoter.,23.0,Brian Robbins,Ready to Rumble,2000,107,USA, 24000000,12394327,12452362,58035,-11547638,0
35111,123.0,"Action, Crime, Drama",Two criminal drifters without sympathy get more than they bargained for after kidnapping and holding for ransom the surrogate mother of a powerful and shady man.,49.0,Christopher McQuarrie,The Way of the Gun,2000,119,USA, 8500000,6055661,13200972,7145311,4700972,1
35130,103.0,"Biography, Drama","The story of Carl Brashear, the first African-American U.S. Navy Diver, and the man who trained him.",56.0,George Tillman Jr.,Men of Honor,2000,129,USA, 32000000,48818921,82343495,33524574,50343495,1
35142,68.0,Drama,"A single mother's life is thrown into turmoil after her struggling, rarely seen younger brother returns to town.",85.0,Kenneth Lonergan,You Can Count on Me,2000,111,USA, 1200000,9416804,11242521,1825717,10042521,1
35846,35.0,Comedy,"Colm is a Catholic and George is a poetry-loving Protestant. In Belfast in the 1980s, they could have been enemies, but instead they became business partners. After persuading a mad wig ...",56.0,Barry Levinson,An Everlasting Piece,2000,103,USA, 14000000,75228,75228,0,-13924772,0
34133,191.0,"Adventure, Sci-Fi, Thriller","When the first manned mission to Mars meets with a catastrophic and mysterious disaster after reporting an unidentified structure, a rescue mission is launched to investigate the tragedy and bring back any survivors.",34.0,Brian De Palma,Mission to Mars,2000,114,USA, 100000000,60883407,110983407,50100000,10983407,1
35596,37.0,"Drama, Music",An inside look into one night in the San Francisco underground rave scene.,54.0,Greg Harrison,Groove,2000,86,USA, 500000,1115313,1162001,46688,662001,1
34063,37.0,Drama,A tour of The Anger Stage.,73.0,Jon Shear,Urbania,2000,103,USA, 225000,1032075,1032075,0,807075,1
31722,98.0,"Crime, Drama, Romance",Leo is released from prison after serving time for car theft. His plan to go straight falls apart when he meets his corrupt uncle for a job and later an old friend working there. It culminates at the (railroad) yards.,58.0,James Gray,The Yards,2000,115,USA, 24000000,889352,924036,34684,-23075964,0
36058,160.0,Drama,A young boy attempts to make the world a better place after his teacher gives him that chance.,40.0,Mimi Leder,Pay It Forward,2000,123,USA, 40000000,33519628,55707411,22187783,15707411,1
31707,86.0,"Animation, Adventure, Comedy","Two swindlers get their hands on a map to the fabled city of gold, El Dorado.",51.0,"Bibo Bergeron, Don Paul",The Road to El Dorado,2000,89,USA, 95000000,50863742,76432727,25568985,-18567273,0
32239,87.0,"Drama, Romance, Western","Two Texas cowboys head to Mexico in search of work, but soon find themselves in trouble with the law after one of them falls in love with a wealthy rancher's daughter.",55.0,Billy Bob Thornton,All the Pretty Horses,2000,116,USA, 57000000,15540353,18133495,2593142,-38866505,0
36706,65.0,"Comedy, Mystery, Sci-Fi",Two potheads wake up after a night of partying and cannot remember where they parked their car.,30.0,Danny Leiner,"Dude, Where's My Car?",2000,83,USA, 13000000,46729800,73180723,26450923,60180723,1
33094,71.0,"Action, Crime, Thriller",An avenging cop seeks out his brother's killer and falls for the daughter of a businessman who is involved in a money-deal with his father.,52.0,Andrzej Bartkowiak,Romeo Must Die,2000,115,USA, 25000000,55973336,91036760,35063424,66036760,1
30565,134.0,"Animation, Action, Adventure",A young man learns that he has to find a hidden Earth ship before an enemy alien species does in order to secure the survival of humanity.,48.0,"Don Bluth, Gary Goldman",Titan A.E.,2000,94,USA, 75000000,22753426,36754634,14001208,-38245366,0
30567,151.0,"Animation, Adventure, Comedy","Emperor Kuzco (David Spade) is turned into a llama by his ex-administrator Yzma (Eartha Kitt), and must now regain his throne with the help of Pacha (John Goodman), the gentle llama herder.",70.0,Mark Dindal,The Emperor's New Groove,2000,78,USA, 100000000,89302687,169327687,80025000,69327687,1
34130,158.0,Comedy,A nice-guy cop with dissociative identity disorder must protect a woman on the run from a corrupt ex-boyfriend and his associates.,49.0,"Bobby Farrelly, Peter Farrelly","Me, Myself & Irene",2000,116,USA, 51000000,90570999,149270999,58700000,98270999,1
36169,24.0,Drama,The story of a Californian couple expecting a child and their group of friends confronted with the tragedy of a big loss.,63.0,Marc Forster,Everything Put Together,2000,87,USA, 100000,2963,8741,5778,-91259,0
30666,52.0,"Comedy, Drama, Romance",A man who falls in love with the woman who received his wife's heart must decide which woman it is who holds his heart.,54.0,Bonnie Hunt,Return to Me,2000,115,USA, 24000000,32722798,36609995,3887197,12609995,1
31452,64.0,"Comedy, Drama, Music","A professional karaoke hustler reconnects with his daughter and a bored suburban businessman turns outlaw karaoke singer, among other plotlines.",40.0,Bruce Paltrow,Duets,2000,112,USA, 21000000,4739023,6620242,1881219,-14379758,0
32936,49.0,"Drama, Mystery, Thriller","A mentally disturbed young woman takes a job at a posh country club and falls in with a clique of wealthy college kids where she's taken under the wing of the clique's twisted leader, who harbors some dark secrets too terrifying to tell.",14.0,Mary Lambert,The In Crowd,2000,105,USA, 24000000,5280035,5280035,0,-18719965,0
36187,128.0,"Action, Drama, Thriller","Alice hires a professional negotiator to obtain the release of her engineer husband, who has been kidnapped by anti-government guerrillas in South America.",45.0,Taylor Hackford,Proof of Life,2000,135,USA, 65000000,32598931,62761005,30162074,-2238995,0
36206,170.0,"Adventure, Fantasy, Horror","A group of tourists arrives in Burkittsville, Maryland after seeing",15.0,Joe Berlinger,Book of Shadows: Blair Witch 2,2000,90,USA, 15000000,26437094,47737094,21300000,32737094,1
32516,29.0,"Comedy, Crime","A chauffeur kidnaps his rich boss's dog to hold it for ransom, but when she accidentally gets the dog back, she thinks that it's the chauffeur who's been kidnapped.",7.0,"Scott Alexander, Larry Karaszewski",Screwed,2000,81,USA, 10000000,7027345,7201701,174356,-2798299,0
32554,86.0,"Comedy, Drama, Family","A shy boy grows up in 1940s Mississippi with the help of his beloved dog, Skip.",61.0,Jay Russell,My Dog Skip,2000,95,USA, 6000000,34134641,35547761,1413120,29547761,1
28059,24.0,"Musical, Romance","A mysterious fair come to a small community in the countryside, which could make real the illusions of two kids.",48.0,Michael Ritchie,The Fantasticks,2000,86,USA, 10000000,49666,49666,0,-9950334,0
32558,85.0,"Comedy, Drama, Romance","Abbie, tired of failed relationships, has a one-night-stand with her gay friend; they agree to raise the resulting baby together.",25.0,John Schlesinger,The Next Best Thing,2000,108,USA, 25000000,14990582,24362772,9372190,-637228,0
32853,227.0,"Adventure, Drama, Romance",A FedEx executive undergoes a physical and emotional transformation after crash landing on a deserted island.,73.0,Robert Zemeckis,Cast Away,2000,143,USA, 90000000,233632142,429632142,196000000,339632142,1
31435,221.0,"Horror, Mystery","While Sidney and her friends visit the Hollywood set of Stab 3, the third film based on the Woodsboro murders, another Ghostface killer rises to terrorize them.",56.0,Wes Craven,Scream 3,2000,116,USA, 40000000,89143175,161834276,72691101,121834276,1
32802,197.0,"Drama, Fantasy, Horror",The wife of a university research scientist believes that her lakeside Vermont home is haunted by a ghost - or that she is losing her mind.,51.0,Robert Zemeckis,What Lies Beneath,2000,130,USA, 100000000,155464351,291420351,135956000,191420351,1
32759,102.0,"Drama, Horror, Thriller","A Catholic teacher meets an atheist journalist, whom a group of Catholics and Priests believes has been chosen by the devil to be the Antichrist.",16.0,Janusz Kaminski,Lost Souls,2000,97,USA, 50000000,16815253,31355910,14540657,-18644090,0
31255,149.0,"Animation, Adventure, Family",An orphaned dinosaur raised by lemurs joins an arduous trek to a sancturary after a meteorite shower destroys his family home.,56.0,"Eric Leighton, Ralph Zondag",Dinosaur,2000,82,USA, 127500000,137748063,349822765,212074702,222322765,1
36749,15.0,"Action, Drama, Crime","Estranged twin brothers - one a con man, the other an Episcopal deacon - accidentally switch places... and find God in the process.",28.0,Jon Gunn,Mercy Streets,2000,106,USA, 600000,173599,173599,0,-426401,0
30560,304.0,"Action, Adventure, Sci-Fi","In a world where mutants (evolved super-powered humans) exist and are discriminated against, two groups form for an inevitable clash: the supremacist Brotherhood, and the pacifist X-Men.",64.0,Bryan Singer,X-Men,2000,104,USA, 75000000,157299718,296339528,139039810,221339528,1
36549,39.0,Drama,Life as a Mormon missionary isn't what 19-year-old Brandon Allen expected: so many rules and so few successes. Los Angeles is as unrepentant as Sodom and Gomorrah. He's forced to share a ...,38.0,Richard Dutcher,God's Army,2000,108,USA, 300000,2637726,2637726,0,2337726,1
32161,126.0,"Drama, Fantasy, Sport",A down-and-out golfer attempts to recover his game and his life with help from a mystical caddy.,47.0,Robert Redford,The Legend of Bagger Vance,2000,126,USA, 80000000,30919168,39459427,8540259,-40540573,0
33191,53.0,"Adventure, Biography, Drama","Kuki, a divorced Italian socialite, changes her life after a serious car crash. She accepts a marriage proposal from Paolo Gallmann, a man she doesn't know well, and she moves to Kenya with...",33.0,Hugh Hudson,I Dreamed of Africa,2000,114,USA, 50000000,6651522,14400327,7748805,-35599673,0
34042,59.0,"Crime, Drama, Thriller","A college dropout, attempting to live up to his father's high standards, gets a job as a broker for a suburban investment firm which puts him on the fast track to success. But the job might not be as legitimate as it first appeared to be.",63.0,Ben Younger,Boiler Room,2000,120,USA, 7000000,16970581,28780255,11809674,21780255,1
34031,155.0,"Adventure, Comedy, Drama",A high-school boy is given the chance to write a story for Rolling Stone Magazine about an up-and-coming rock band as he accompanies them on their concert tour.,90.0,Cameron Crowe,Almost Famous,2000,122,USA, 60000000,32534850,47383689,14848839,-12616311,0
34024,28.0,"Action, Comedy, Fantasy",The sixth or seventh best superhero team in the world pursue their rightful place in the harshly competitive world of toy tie-ins and fighting evil.,38.0,Craig Mazin,The Specials,2000,82,USA, 1000000,13276,13276,0,-986724,0
32022,42.0,"Comedy, Drama",A young woman goes in search of her midlife crisis suffering husband who left her.,44.0,Lisa Krueger,Committed,2000,98,USA, 3000000,40361,40361,0,-2959639,0
37767,67.0,Drama,"A group of children, in a depressed small town, band together to cover up a tragic mistake one summer.",82.0,David Gordon Green,George Washington,2000,89,USA, 42000,247406,283846,36440,241846,1
33991,130.0,Drama,A young writing prodigy finds a mentor in a reclusive author.,62.0,Gus Van Sant,Finding Forrester,2000,136,USA, 43000000,51804714,80049764,28245050,37049764,1
33962,36.0,"Comedy, Sci-Fi",A human-looking alien from a highly advanced but emotionless all-male society is sent to Earth to impregnate a woman and bring the child back to their planet. The alien ends up falling in love there. A suspicious F.A.A. Agent targets him.,41.0,Mike Nichols,What Planet Are You From?,2000,105,USA, 60000000,6291602,14145677,7854075,-45854323,0
35918,49.0,"Drama, Romance",Four frames of simultaneous action that alternately follow a smitten lesbian lover as she obsesses over her partner's dalliances and the tense goings-on of a Hollywood film production company.,65.0,Mike Figgis,Timecode,2000,97,USA, 5000000,1057750,1431406,373656,-3568594,0
33872,245.0,Drama,The drug-induced utopias of four Coney Island people are shattered when their addictions run deep.,68.0,Darren Aronofsky,Requiem for a Dream,2000,102,USA, 4500000,3635482,7390108,3754626,2890108,1
33829,11.0,"Drama, Western","Valentine Casey is a U.S. Marshal in the desolate Tucson territory of the early 1900s. On Christmas Eve, his outlaw family pays him a disturbing visit. He must confront the sins of his past...",22.0,Dwight Yoakam,"South of Heaven, West of Hell",2000,131,USA, 4000000,28149,28149,0,-3971851,0
32048,96.0,"Comedy, Romance, Sci-Fi","Scientist Sherman Klump's inventions, his upcoming marriage to his pretty colleague Denise Gaines and his reputation are threatened by his evil clone Buddy Love.",38.0,Peter Segal,Nutty Professor II: The Klumps,2000,106,USA, 84000000,123309890,166339890,43030000,82339890,1
36034,18.0,"Comedy, Drama, Romance",An insight into the turbulent lives and loves of a gay clique based in Los Angeles.,51.0,Greg Berlanti,The Broken Hearts Club: A Romantic Comedy,2000,94,USA, 1000000,1746585,2019121,272536,1019121,1
33772,235.0,"Action, Adventure, Drama",An unusually intense storm pattern catches some commercial fishermen unaware and puts them in mortal danger.,59.0,Wolfgang Petersen,The Perfect Storm,2000,130,USA, 140000000,182618434,328718434,146100000,188718434,1
33629,104.0,Comedy,"A year after disposing of the body of a man they accidentally killed, a group of dumb teenagers are stalked by a bumbling serial killer.",48.0,Keenen Ivory Wayans,Scary Movie,2000,88,USA, 19000000,157019771,278019771,121000000,259019771,1
33602,109.0,"Drama, Romance","Romantic drama about an aging playboy who falls for a sweet, but terminally ill, young woman.",24.0,Joan Chen,Autumn in New York,2000,103,USA, 65000000,37761915,90726668,52964753,25726668,1
33599,47.0,"Comedy, Romance","Three egotistical swingers, who think they're God's gift to women, end up having their friendships tested when all three of them pick up and start dating the same woman.",10.0,Peter M. Cohen,Whipped,2000,82,USA, 3000000,4159986,4775009,615023,1775009,1
35565,146.0,"Action, Comedy, Crime",An F.B.I. Agent must go undercover in the Miss United States beauty pageant to prevent a group from bombing the event.,43.0,Donald Petrie,Miss Congeniality,2000,109,USA, 45000000,106807667,212742720,105935053,167742720,1
33449,145.0,"Comedy, Drama, Romance","Two friends, a priest and a rabbi, fall in love with the same woman they knew in their youth, but the religious position of both men denies them romance.",60.0,Edward Norton,Keeping the Faith,2000,128,USA, 29000000,37047880,59945183,22897303,30945183,1
33446,91.0,"Drama, Romance, Thriller",Modern-day New York City adaptation of Shakespeare's immortal story about Hamlet's plight to avenge his father's murder.,70.0,Michael Almereyda,Hamlet,2000,112,USA, 2000000,1577287,2046433,469146,46433,1
33444,39.0,"Comedy, Crime, Romance",An undercover DEA agent brings down the Mafia.,42.0,Eric Blakeney,Gun Shy,2000,101,USA, 14000000,1638202,3284444,1646242,-10715556,0
33404,5.0,"Action, Adventure, Drama","A young boy sets out to find his mother. After setting up camp in Central Park, he encounters a group of people even needier than himself.",22.0,John Leekley,Prince of Central Park,2000,109,USA, 7000000,7838,7838,0,-6992162,0
33387,130.0,"Comedy, Family, Fantasy","On the outskirts of Whoville, there lives a green, revenge-seeking Grinch (Jim Carrey), who plans on ruining Christmas for all of the citizens of the town.",46.0,Ron Howard,How the Grinch Stole Christmas,2000,104,USA, 123000000,260044825,345141403,85096578,222141403,1
32136,169.0,"Drama, History, Thriller","In October 1962, the Kennedy administration struggles to contain the Cuban Missile Crisis.",67.0,Roger Donaldson,Thirteen Days,2000,145,USA, 80000000,34592089,66579890,31987801,-13420110,0
33708,67.0,"Drama, Mystery, Thriller","Three college students base their class project around gossip and how fast it spreads, which soon spirals out of control.",31.0,Davis Guggenheim,Gossip,2000,90,USA, 24000000,5108820,12591270,7482450,-11408730,0
32656,61.0,"Comedy, Family, Romance","In this live-action prequel to The Flintstones (1994), the Flintstones and the Rubbles go on a trip to Rock Vegas, where Wilma Slaghoople (Kristen Johnston) is pursued by playboy Chip Rockefeller (Thomas Gibson).",27.0,Brian Levant,The Flintstones in Viva Rock Vegas,2000,90,USA, 83000000,35268275,59468275,24200000,-23531725,0
36661,120.0,"Comedy, Romance","A couple search for each other years after the night they first met, fell in love, and separated, convinced that one day they'd end up together.",52.0,Peter Chelsom,Serendipity,2001,90,USA, 28000000,50294317,77516304,27221987,49516304,1
36701,48.0,"Drama, History, Romance","In pre-Revolutionary France, a young aristocratic woman left penniless by the political unrest in the country, must avenge her family's fall from grace by scheming to steal a priceless necklace.",42.0,Charles Shyer,The Affair of the Necklace,2001,118,USA, 30000000,471210,1198113,726903,-28801887,0
36709,28.0,"Comedy, Crime, Drama",A basketball player strikes a deal with the mob to fix a basketball game.,49.0,James Toback,Harvard Man,2001,99,USA, 5500000,56653,56653,0,-5443347,0
36851,10.0,"Comedy, Romance, Drama","A painter who finds success (and true love) after a pickpocket steals one of his works, gives it a false authorship and promotes the imaginary artist to instant success so he can cash in on his ill-gotten gains.",47.0,P.J. Posner,The Next Big Thing,2001,87,USA, 1500000,14600,14600,0,-1485400,0
36731,139.0,"Horror, Mystery, Thriller",Five women are stalked by an unknown assailant while preparing for Valentine's Day.,18.0,Jamie Blanks,Valentine,2001,96,USA, 29000000,20384136,36684136,16300000,7684136,1
37075,174.0,"Biography, Drama, Sport","A biography of sports legend Muhammad Ali, focusing on his triumphs and controversies between 1964 and 1974.",65.0,Michael Mann,Ali,2001,157,USA, 107000000,58203105,87812729,29609624,-19187271,0
37019,104.0,"Comedy, Crime, Mystery","Five Vermont state troopers, avid pranksters with a knack for screwing up, try to save their jobs and out-do the local police department by solving a crime.",48.0,Jay Chandrasekhar,Super Troopers,2001,100,USA, 3000000,18492362,23182223,4689861,20182223,1
37008,177.0,"Crime, Drama",A New England couple's college-aged son dates an older woman who has two small children and an unwelcome ex-husband.,86.0,Todd Field,In the Bedroom,2001,130,USA, 1700000,35930604,44763181,8832577,43063181,1
37002,96.0,Drama,A young Jewish man develops a fiercely anti-Semitic philosophy. Based on the factual story of a K.K.K. member in the 1960s who was revealed to be Jewish by a New York Times reporter.,75.0,Henry Bean,The Believer,2001,98,USA, 1500000,416925,1309316,892391,-190684,0
36995,74.0,Comedy,"At the wedding of a friend, the remaining bachelors bet on staying single. 7 years later, one of the 2 remaining loses $51000 in Vegas. He must get the other guy married to cash in and pay his debt or die. A cute woman helps him.",15.0,Gregory Poirier,Tomcats,2001,95,USA, 11000000,13558739,23430766,9872027,12430766,1
37080,115.0,"Comedy, Drama, Music",A transgender punk-rock girl from East Berlin tours the U.S. with her band as she tells her life story and follows the former lover/band-mate who stole her songs.,85.0,John Cameron Mitchell,Hedwig and the Angry Inch,2001,95,USA, 6000000,3067312,3644200,576888,-2355800,0
37114,101.0,"Crime, Mystery, Thriller","When Danny witnesses his stepfather Rick murder a man, Danny's father Frank has to protect his son from the greatest danger.",29.0,Harold Becker,Domestic Disturbance,2001,89,USA, 75000000,45246095,54249294,9003199,-20750706,0
36714,67.0,"Crime, Drama","A 15-year-old Long Island boy loses everything and everyone he knows, soon becoming involved in a relationship with a much older man.",73.0,Michael Cuesta,L.I.E.,2001,97,USA, 700000,1138836,1846059,707223,1146059,1
36955,364.0,"Drama, Sci-Fi, Thriller","A troubled teenager is plagued by visions of a man in a large rabbit suit who manipulates him to commit a series of crimes, after he narrowly escapes a bizarre accident.",88.0,Richard Kelly,Donnie Darko,2001,113,USA, 6000000,1478493,4269636,2791143,-1730364,0
36877,80.0,"Adventure, Comedy, Drama","After being abandoned by his parents at the Grand Canyon, Joe Dirt tells the story of his journey to find his parents.",20.0,Dennie Gordon,Joe Dirt,2001,91,USA, 17700000,27087695,30987695,3900000,13287695,1
36842,59.0,"Action, Horror, Thriller",A young man gets embroiled in a war against vampires.,35.0,J.S. Cardone,The Forsaken,2001,90,USA, 15000000,7288451,8704851,1416400,-6295149,0
36833,53.0,"Comedy, Romance","After being jilted by her boyfriend, a talk show talent scout writes a column on the relationship habits of men which gains her national fame.",32.0,Tony Goldwyn,Someone Like You...,2001,97,USA, 23000000,27343067,38689940,11346873,15689940,1
36796,160.0,"Action, Crime, Thriller","A covert counter-terrorist unit called Black Cell led by Gabriel Shear wants the money to help finance their war against international terrorism, but it's all locked away. Gabriel brings in convicted hacker Stanley Jobson to help him.",32.0,Dominic Sena,Swordfish,2001,99,USA, 102000000,69772969,147080413,77307444,45080413,1
36788,25.0,"Comedy, Romance",Two people who have pledged never to fall in love again then discover each other in a gay bar.,30.0,Eric Schaeffer,Never Again,2001,98,USA, 500000,307631,307631,0,-192369,0
36784,43.0,"Action, Western","When a Midwest town learns that a corrupt railroad baron has captured the deeds to their homesteads without their knowledge, a group of young ranchers join forces to take back what is ...",25.0,Les Mayfield,American Outlaws,2001,94,USA, 35000000,13342790,13678913,336123,-21321087,0
36769,75.0,"Comedy, Romance","Set on the last day of camp, in the hot summer of 1981, a group of counselors try to complete their unfinished business before the day ends.",42.0,David Wain,Wet Hot American Summer,2001,97,USA, 5000000,295206,295206,0,-4704794,0
36907,35.0,"Comedy, Drama, Family",A group of old family members bands together when a despicable family member thankfully expires.,48.0,Doug McHenry,Kingdom Come,2001,94,USA, 7000000,23249649,23396049,146400,16396049,1
38476,56.0,Drama,Three old high school friends meet in a Michigan motel room to dissect painful memories from their past.,71.0,Richard Linklater,Tape,2001,86,USA, 100000,490475,515900,25425,415900,1
37716,178.0,Comedy,"The comic ""Bluntman and Chronic"" is based on real-life stoners Jay and Silent Bob, so when they get no profit from a big-screen adaptation, they set out to wreck the movie.",51.0,Kevin Smith,Jay and Silent Bob Strike Back,2001,104,USA, 22000000,30085147,33788161,3703014,11788161,1
37149,51.0,"Comedy, Drama",Four friends begin to question women and relationships when one of them announces impending nuptials.,50.0,Gary Hardwick,The Brothers,2001,106,USA, 6000000,27457409,27958191,500782,21958191,1
39067,155.0,"Drama, Romance","After a family tragedy, a racist prison guard reexamines his attitudes while falling in love with the African American wife of the last prisoner he executed.",69.0,Marc Forster,Monster's Ball,2001,111,USA, 4000000,31273922,45011434,13737512,41011434,1
38085,12.0,"Crime, Drama, Mystery",The sheriff of a small Utah community searches for a serial killer.,62.0,Richard Dutcher,Brigham City,2001,119,USA, 1000000,852206,852206,0,-147794,0
38104,63.0,"Animation, Action, Adventure",An eight year-old boy genius and his friends must rescue their parents after the adults are abducted by aliens.,65.0,John A. Davis,Jimmy Neutron: Boy Genius,2001,82,USA, 30000000,80936232,102992536,22056304,72992536,1
38802,13.0,"Drama, Romance","A man proposes to a woman he's met once, all in the same day.",54.0,Melissa Martin,"The Bread, My Sweet",2001,105,USA, 600000,1023156,1023156,0,423156,1
38117,80.0,Drama,"In New York City, the lives of a lawyer, an actuary, a house-cleaner, a professor and the people around them intersect as they ponder order and happiness in the face of life's cold unpredictability.",74.0,Jill Sprecher,Thirteen Conversations About One Thing,2001,104,USA, 4500000,3288164,3706652,418488,-793348,0
38715,16.0,"Comedy, Romance","Story of a 29-year-old Ivy League-educated, self-help author as she grudgingly falls for a shock-jock radio host with a reputation for hitting on his bimbo guests.",36.0,Julie Davis,Amy's Orgasm,2001,87,USA, 500000,119664,119664,0,-380336,0
38691,52.0,"Comedy, Drama","When Joe is beat up by a co-worker in front of his daughter on ""Bring Your Child To Work Day"", he decides to fight back.",42.0,John Pasquin,Joe Somebody,2001,98,USA, 38000000,22771646,24516772,1745126,-13483228,0
38130,207.0,"Biography, Drama",After,72.0,Ron Howard,A Beautiful Mind,2001,135,USA, 58000000,170742341,316791257,146048916,258791257,1
38131,130.0,"Drama, Romance","Set in 1951, a blacklisted Hollywood writer gets into a car accident, loses his memory and settles down in a small town where he is mistaken for a long-lost son.",27.0,Frank Darabont,The Majestic,2001,152,USA, 72000000,27807266,37317558,9510292,-34682442,0
40163,89.0,"Comedy, Horror, Sci-Fi","A bad scientist and wife, a mad scientist and skeleton, two aliens and their escaped pet are all searching for the elusive element ""atmospherium"".",45.0,Larry Blamire,The Lost Skeleton of Cadavra,2001,90,USA, 40000,143121,143121,0,103121,1
38143,39.0,"Comedy, Romance","An arrogant career woman plays a series of heartless mind-games with her boyfriend to ""put him in line,"" only to discover that he has a few tricks up his own sleeve.",35.0,Mark Brown,Two Can Play That Game,2001,90,USA, 13000000,22235901,22391450,155549,9391450,1
36654,206.0,"Crime, Thriller",Danny Ocean and his eleven accomplices plan to rob three Las Vegas casinos simultaneously.,74.0,Steven Soderbergh,Ocean's Eleven,2001,116,USA, 85000000,183417150,450717150,267300000,365717150,1
38215,9.0,"Comedy, Drama","A failed New Jersey inventor embarks on a career as a standup comic, turns to drink, and labors to keep his family together.",39.0,Frank Whaley,The Jimmy Show,2001,96,USA, 1500000,1000,1000,0,-1499000,0
38280,23.0,Thriller,Animator Thomas Kempton gets more than he bargained for when a snowmobile trip turns to terror in the wilds of Northern Michigan. Held prisoner by two cannibalistic sisters who try ...,43.0,John D. Hancock,Suspended Animation,2001,114,USA, 1900000,8169,8169,0,-1891831,0
38651,45.0,"Comedy, Family, Romance","A shy advertising employee meets his dream girl on the El train, but doesn't remember to get her phone number, resulting in an all-out search for the mystery girl",34.0,Eric Bross,On the Line,2001,85,USA, 16000000,4365455,4544601,179146,-11455399,0
38605,36.0,"Comedy, Fantasy","Two guys by the name of Silas and Jamal decided to one day smoke something magical, which eventually helps them to ace their college entrance exam.",29.0,Jesse Dylan,How High,2001,93,USA, 20000000,31178740,31283740,105000,11283740,1
38292,102.0,"Action, Drama, Thriller",A court-martialed General rallies together twelve hundred inmates to rise against a corrupt and sadistic warden.,43.0,Rod Lurie,The Last Castle,2001,131,USA, 72000000,18244060,27642707,9398647,-44357293,0
38544,94.0,Comedy,A sendup of all the teen movies that have accumulated in the past two decades.,32.0,Joel Gallen,Not Another Teen Movie,2001,89,USA, 15000000,38252284,66468332,28216048,51468332,1
38364,35.0,"Comedy, Crime, Family","Max Keeble, the victim of his 7th grade class, plots revenge when he learns he's moving; it backfires when he doesn't move after all.",40.0,Tim Hill,Max Keeble's Big Move,2001,86,USA, 25000000,17294293,18634654,1340361,-6365346,0
38532,122.0,Drama,A mentally handicapped man fights for custody of his 7-year-old daughter and in the process teaches his cold-hearted lawyer the value of love and family.,28.0,Jessie Nelson,I Am Sam,2001,132,USA, 22000000,40311852,97818139,57506287,75818139,1
38065,103.0,"Action, Sci-Fi, Thriller","A rogue Multiverse agent goes on a manhunt for versions of himself, getting stronger with each kill. With only one version remaining, he races against the clock to finish him and become ""The One.""",25.0,James Wong,The One,2001,87,USA, 49000000,43905746,74005691,30099945,25005691,1
37146,85.0,"Drama, Romance","At Pacific Palisades High, a poor Latino falls hard for a troubled girl from an affluent neighborhood.",61.0,John Stockwell,Crazy/Beautiful,2001,99,USA, 13000000,16937988,19937988,3000000,6937988,1
37957,231.0,"Comedy, Drama",The eccentric members of a dysfunctional family reluctantly gather under the same roof for various reasons.,76.0,Wes Anderson,The Royal Tenenbaums,2001,110,USA, 21000000,52364010,71441250,19077240,50441250,1
37916,49.0,"Adventure, Comedy, Fantasy","Martin Lawrence plays Jamal, an employee in Medieval World amusement park. After sustaining a blow to the head, he awakens to find himself in 14th century England.",32.0,Gil Junger,Black Knight,2001,95,USA, 50000000,33426971,39976235,6549264,-10023765,0
37153,61.0,"Comedy, Crime",The loser son of a Mafia honcho must go undercover for the FBI.,20.0,Rob Pritts,Corky Romano,2001,86,USA, 11000000,23980304,25272752,1292448,14272752,1
37155,94.0,"Crime, Drama, Mystery",A woman spirals out of control while trying to keep her son from being found culpable in a murder investigation.,78.0,"Scott McGehee, David Siegel",The Deep End,2001,101,USA, 3000000,8823109,10031529,1208420,7031529,1
37158,27.0,"Adventure, Biography, Drama","John Groberg, a farm kid from Idaho Falls, crosses an ocean to become a missionary in the remote and exotic Tongan islands during the 1950s.",38.0,Mitch Davis,The Other Side of Heaven,2001,113,USA, 7000000,4720371,4760014,39643,-2239986,0
37169,167.0,"Comedy, Romance","Elle Woods, a fashionable sorority queen is dumped by her boyfriend. She decides to follow him to law school, while she is there she figures out that there is more to her than just looks.",59.0,Robert Luketic,Legally Blonde,2001,96,USA, 18000000,96520674,141774679,45254005,123774679,1
37192,158.0,"Comedy, Sci-Fi","A fire-fighting cadet, two college professors, and a geeky but sexy government scientist work against an alien organism that has been rapidly evolving since its arrival on Earth inside a meteor.",40.0,Ivan Reitman,Evolution,2001,101,USA, 80000000,38345494,98376292,60030798,18376292,1
37282,54.0,"Drama, History, War","A Nazi doctor, along with the Sonderkommando, Jews who are forced to work in the crematoria of Auschwitz against their fellow Jews, find themselves in a moral grey zone.",58.0,Tim Blake Nelson,The Grey Zone,2001,108,USA, 5000000,517872,621592,103720,-4378408,0
37291,137.0,"Drama, Mystery",Widowed Liz Garfield (,55.0,Scott Hicks,Hearts in Atlantis,2001,101,USA, 31000000,24185781,30919415,6733634,-80585,0
39703,19.0,"Comedy, Drama, Family","Emily Lindstrom, 14, is an aspiring concert violinist; she's spending the summer practicing for a big audition while her girlfriends are at camp. She's also got a thriving neighborhood ...",52.0,Blair Treu,Little Secrets,2001,96,USA, 2500000,405792,750582,344790,-1749418,0
37312,141.0,Comedy,"Jim and his friends are now in college, and they decide to meet up at the beach house for some fun.",43.0,J.B. Rogers,American Pie 2,2001,108,USA, 30000000,145103595,287553595,142450000,257553595,1
37345,11.0,Thriller,A handsome and successful young man's life begins to unravel when he develops an acute sense of paranoia. Things escalate when Jackson is convinced that a tv ad holds sinister messages ...,63.0,Tim McCann,Revolution #9,2001,90,USA, 300000,10133,10133,0,-289867,0
37367,36.0,"Comedy, Sport",A snowboarder's plans for his own snowboard park go awry when an ex-girlfriend returns to town.,22.0,"Brendan Malloy, Emmett Malloy",Out Cold,2001,89,USA, 24000000,13906394,14782676,876282,-9217324,0
37492,76.0,"Comedy, Sci-Fi","After receiving organ transplants from various animal donors, a man finds himself taking on the traits of those animals.",43.0,Luke Greenfield,The Animal,2001,84,USA, 47000000,57743062,85191134,27448072,38191134,1
37493,43.0,"Crime, Drama, Romance","This is the story of Jody, an unemployed young black man, who's been living with his mother for several years, even though he's got a child of his own. Romantically, he's having ...",55.0,John Singleton,Baby Boy,2001,130,USA, 16000000,28734552,29381649,647097,13381649,1
37574,32.0,"Action, Adventure, Comedy","""The Man"" is baffled by a chill hero's invincible weapon: gibberish.",31.0,Louis C.K.,Pootie Tang,2001,81,USA, 7000000,3313583,3313583,0,-3686417,0
37583,71.0,"Comedy, Drama, Romance",Self-esteem and insecurity are at the heart of this comedy about the relationship between a mother and her three confused daughters.,75.0,Nicole Holofcener,Lovely & Amazing,2001,91,USA, 250000,4222923,4677852,454929,4427852,1
37588,47.0,"Adventure, Comedy, Romance",Bubble Boy's been in a bubble all his life due to no immune system. A cute blonde girl befriends BB. Her boyfriend proposes and BB decides to travel across USA to Niagara Falls to stop the wedding.,41.0,Blair Hayes,Bubble Boy,2001,84,USA, 13000000,5007898,5007898,0,-7992102,0
37745,148.0,"Horror, Mystery",Tensions rise within an asbestos cleaning crew as they work in an abandoned mental hospital with a horrific past that seems to be coming back.,58.0,Brad Anderson,Session 9,2001,100,USA, 1500000,378176,1612259,1234083,112259,1
37844,21.0,"Action, Adventure, Fantasy",Megiddo is a supernatural ride into a world teetering on the edge of the Apocalypse. It follows the rise of a Machiavellian leader bent on amassing the armies of the world for the battle of...,35.0,Brian Trenchard-Smith,Megiddo: The Omega Code 2,2001,104,USA, 22000000,6047691,6047691,0,-15952309,0
37903,110.0,"Comedy, Drama, Romance",A woman searching for the perfect man instead discovers the perfect woman.,72.0,Charles Herman-Wurmfeld,Kissing Jessica Stein,2001,97,USA, 1000000,7025722,10013424,2987702,9013424,1
39331,27.0,Comedy,Life at the car wash is a place where anything can and does happen to two friends (Dr. Dre and Snoop Dogg) trying to earn money to pay their rent.,18.0,DJ Pooh,The Wash,2001,93,USA, 7000000,10097538,10229331,131793,3229331,1
37905,98.0,Drama,"When a man is diagnosed with terminal cancer, he takes custody of his misanthropic teenage son, for whom quality time means getting high, engaging in small-time prostitution, and avoiding his father.",45.0,Irwin Winkler,Life as a House,2001,125,USA, 27000000,15667270,23903791,8236521,-3096209,0
37935,43.0,"Drama, Romance",A failed novelist's inability to pay the bills strains relations with his wife and leads him to work at an escort service where he becomes entwined with a wealthy woman whose husband is a successful writer.,57.0,George Hickenlooper,The Man from Elysian Fields,2001,106,USA, 6500000,1435016,2006391,571375,-4493609,0
36645,100.0,Comedy,"An unemployed cartoonist moves back in with his parents and younger brother Freddy. When his parents demand he leave, he begins to spread rumors that his father is sexually abusing Freddy.",13.0,Tom Green,Freddy Got Fingered,2001,87,USA, 14000000,14254993,14343028,88035,343028,1
37914,143.0,"Comedy, Romance",A movie publicist deals with the messy public split of his movie's co-stars while keeping reporters at bay while a reclusive director holds the film's print hostage.,44.0,Joe Roth,America's Sweethearts,2001,102,USA, 46000000,93607673,138307673,44700000,92307673,1
36619,66.0,"Comedy, Romance",The interlocking lives and loves of six New Yorkers.,49.0,Edward Burns,Sidewalks of New York,2001,108,USA, 1000000,2402652,3520373,1117721,2520373,1
35418,212.0,"Action, Adventure, Fantasy","The mummified body of Imhotep is shipped to a museum in London, where he once again wakes and begins his campaign of rage and terror.",48.0,Stephen Sommers,The Mummy Returns,2001,130,USA, 98000000,202019785,443280904,241261119,345280904,1
35295,156.0,"Mystery, Thriller","Three young people on a road trip from Colorado to New Jersey talk to a trucker on their CB radio, then must escape when he turns out to be a psychotic killer.",75.0,John Dahl,Joy Ride,2001,97,USA, 23000000,21974919,36642838,14667919,13642838,1
35291,91.0,"Drama, Music, Romance","A white midwestern girl moves to Chicago, where her new boyfriend is a black teen from the South Side with a rough, semi-criminal past.",53.0,Thomas Carter,Save the Last Dance,2001,112,USA, 13000000,91057006,131706809,40649803,118706809,1
35278,20.0,"Drama, Sport","A story about a man's personal struggle to victory in the 1971 Madison, Indiana hydro-plane regatta.",43.0,William Bindley,Madison,2001,94,USA, 13500000,517262,517262,0,-12982738,0
35171,104.0,"Comedy, Crime",Every man has a different recollection of the beautiful young woman who wreaked havoc on their lives during one heated night.,46.0,Harald Zwart,One Night at McCool's,2001,93,USA, 18000000,6290673,13578186,7287513,-4421814,0
35096,97.0,"Drama, Music",Lead singer of a tribute band becomes lead singer of the real band he idolizes.,54.0,Stephen Herek,Rock Star,2001,105,USA, 57000000,17008282,19334145,2325863,-37665855,0
34930,89.0,"Biography, Comedy, Drama","A single mother, with dreams of becoming a writer, has a son at the age of 15 in 1965, and goes through a failed marriage with the drug-addicted father.",43.0,Penny Marshall,Riding in Cars with Boys,2001,132,USA, 48000000,30165536,35743308,5577772,-12256692,0
34846,260.0,"Animation, Adventure, Comedy","In order to power the city, monsters have to scare children so that they scream. However, the children are toxic to the monsters, and after a child gets through, 2 monsters realize things may not be what they think.",78.0,"Pete Docter, David Silverman","Monsters, Inc.",2001,92,USA, 115000000,289916256,632316649,342400393,517316649,1
34635,29.0,"Action, Adventure, Drama","A ragtag group of youngsters band together after the American Civil War to form the Texas Rangers, a group charged with the dangerous, ruthless duty of cleaning up the West.",29.0,Steve Miner,Texas Rangers,2001,90,USA, 38000000,623374,763740,140366,-37236260,0
34577,61.0,"Comedy, Mystery, Romance",A young woman is attracted to a man despite her thinking she's seen him kill someone.,27.0,Mark Waters,Head Over Heels,2001,86,USA, 14000000,10424470,13127022,2702552,-872978,0
34574,61.0,"Comedy, Romance",A high school senior's girlfriend breaks up with him. His friends try to make him think of something else. His friend's sister Kelly helps him with the school musical. Spending time with Kelly has an effect.,52.0,Tommy O'Haver,Get Over It,2001,87,USA, 22000000,11576464,19900366,8323902,-2099634,0
34291,72.0,"Comedy, Crime",A popular high-school cheerleader becomes pregnant by the star quarterback and turns to crime to support her desired lifestyle.,48.0,Francine McDougall,Sugar & Spice,2001,81,USA, 27000000,13305101,16923761,3618660,-10076239,0
34210,89.0,"Drama, Romance, Thriller","An update of Shakespeare's 'Othello' with a young cast, set in an upper class prep school, & centered around basketball player Odin.",53.0,Tim Blake Nelson,O,2001,95,USA, 5000000,16025437,19260537,3235100,14260537,1
34152,168.0,"Action, Adventure, Romance","After his master dies, a peasant squire, fueled by his desire for food and glory, creates a new identity for himself as a knight.",56.0,Brian Helgeland,A Knight's Tale,2001,132,USA, 65000000,56569702,117487473,60917771,52487473,1
35601,194.0,"Action, Drama, History",A tale of war and romance mixed in with history. The story follows two lifelong friends and a beautiful nurse who are caught up in the horror of an infamous Sunday morning in 1941.,44.0,Michael Bay,Pearl Harbor,2001,183,USA, 140000000,198542554,449220945,250678391,309220945,1
34015,75.0,"Animation, Action, Adventure","A policeman white blood cell, with the help of a cold pill, must stop a deadly virus from destroying the human they live in, Frank.",57.0,"Bobby Farrelly, Peter Farrelly",Osmosis Jones,2001,95,USA, 70000000,13596911,14026418,429507,-55973582,0
33120,61.0,"Animation, Comedy, Fantasy","In a coma, a cartoonist finds himself trapped within his own underground creation and must find a way to get back, while racing against his popular but treacherous character, Monkeybone.",40.0,Henry Selick,Monkeybone,2001,93,USA, 75000000,5411999,7622365,2210366,-67377635,0
33105,55.0,"Crime, Horror","Over 20 years after his death by a gunshot, Jimmy Bones comes back as a ghost to wreak revenge on those who killed him and to clean up his neighborhood.",42.0,Ernest R. Dickerson,Bones,2001,96,USA, 16000000,7316658,8378853,1062195,-7621147,0
32899,222.0,"Action, Adventure, Sci-Fi","A decidedly odd couple with ulterior motives convince Dr. Grant to go to Isla Sorna for a holiday, but their unexpected landing startles the island's new inhabitants.",42.0,Joe Johnston,Jurassic Park III,2001,92,USA, 93000000,181171875,368780809,187608934,275780809,1
32803,67.0,"Comedy, Crime","A rich man catches a thief burglarizing his home and steals the thief's lucky ring, who then tries to get it back.",37.0,Sam Weisman,What's the Worst That Could Happen?,2001,94,USA, 60000000,32269834,38464131,6194297,-21535869,0
32748,83.0,"Drama, Mystery, Sci-Fi","In the future, an alien race uses androids as bombs to attack Earth. A government weapons specialist is accused of being one such android and sets out to prove his innocence.",33.0,Gary Fleder,Impostor,2001,95,USA, 30000000,6285176,8694320,2409144,-21305680,0
32684,136.0,"Action, Drama, Thriller",A Navy navigator is shot down over enemy territory and is ruthlessly pursued by a secret police enforcer and the opposing troops. Meanwhile his commanding officer goes against orders in an attempt to rescue him.,49.0,John Moore,Behind Enemy Lines,2001,106,USA, 40000000,58856790,91753202,32896412,51753202,1
31904,61.0,"Comedy, Romance","Porter Stoddard is a well-known New York architect who is at a crossroads... a nexus where twists and turns lead to myriad missteps, some with his wife Ellie, others with longtime friends ...",34.0,Peter Chelsom,Town & Country,2001,104,USA, 90000000,6719973,10372291,3652318,-79627709,0
31775,121.0,"Crime, Drama, Thriller","On his first day on the job as a Los Angeles narcotics officer, a rookie cop goes beyond a full work day in training within the narcotics division of the L.A.P.D. with a rogue detective who isn't what he appears to be.",69.0,Antoine Fuqua,Training Day,2001,122,USA, 45000000,76631907,104876233,28244326,59876233,1
31387,240.0,"Action, Adventure, Sci-Fi","In 2029, an Air Force astronaut crash-lands on a mysterious planet where evolved, talking apes dominate a race of primitive humans.",50.0,Tim Burton,Planet of the Apes,2001,119,USA, 100000000,180011740,362211740,182200000,262211740,1
30955,222.0,"Animation, Adventure, Comedy","A mean lord exiles fairytale creatures to the swamp of a grumpy ogre, who must go on a quest and rescue a princess for the lord in order to get his land back.",84.0,"Andrew Adamson, Vicky Jenson",Shrek,2001,90,USA, 60000000,267665011,484409218,216744207,424409218,1
30886,120.0,"Comedy, Crime, Romance",A mother and daughter con team seduce and scam wealthy men.,47.0,David Mirkin,Heartbreakers,2001,123,USA, 35000000,40336607,57756408,17419801,22756408,1
29517,74.0,"Drama, Music, Romance","A young singer dates a disc jockey who helps her get into the music business, but their relationship become complicated as she ascends to super stardom.",14.0,Vondie Curtis-Hall,Glitter,2001,104,USA, 22000000,4274407,5271666,997259,-16728334,0
4115,127.0,"Comedy, Fantasy, Romance",An English Duke from 1876 is inadvertedly dragged to modern day New York where he falls for a plucky advertising executive.,44.0,James Mangold,Kate & Leopold,2001,118,USA, 48000000,47121859,76019048,28897189,28019048,1
36640,91.0,"Comedy, Family, Fantasy",Dolittle must save a forest and a bear's life.,49.0,Steve Carr,Dr. Dolittle 2,2001,87,USA, 70000000,112952899,176104344,63151445,106104344,1
35861,67.0,"Horror, Mystery, Thriller",A co-ed is caught between the world of the living and the dead.,20.0,Stephen Carpenter,Soul Survivors,2001,84,USA, 17000000,3111545,4299141,1187596,-12700859,0
30421,189.0,"Horror, Mystery, Thriller","In Victorian-era London, a troubled clairvoyant police detective investigates the murders of Jack the Ripper.",54.0,"Albert Hughes, Allen Hughes",From Hell,2001,122,USA, 35000000,31602566,74558115,42955549,39558115,1
35912,136.0,"Comedy, Crime, Drama",Two bank robbers fall in love with the girl they've kidnapped.,60.0,Barry Levinson,Bandits,2001,123,USA, 75000000,41575141,67631903,26056762,-7368097,0
35869,129.0,"Action, Crime, Drama",A computer programmer's dream job at a hot Portland-based firm turns nightmarish when he discovers his boss has a secret and ruthless means of dispatching anti-trust problems.,31.0,Peter Howitt,Antitrust,2001,105,USA, 30000000,11328094,18195610,6867516,-11804390,0
36227,153.0,"Animation, Action, Adventure",A young adventurer named Milo Thatch joins an intrepid group of explorers to find the mysterious lost continent of Atlantis.,52.0,"Gary Trousdale, Kirk Wise",Atlantis: The Lost Empire,2001,95,USA, 120000000,84056472,186053725,101997253,66053725,1
36406,50.0,"Comedy, Drama, Romance",A rich girl whose family summers on Cape Cod has a romance with a local poor boy who hopes to become a major league baseball player.,21.0,Michael Tollin,Summer Catch,2001,104,USA, 34000000,19753553,19772447,18894,-14227553,0
36384,84.0,"Comedy, Crime, Drama",A dentist finds himself a murder suspect after a sexy patient seduces him & steals all of the drugs from his practice.,45.0,David Atkins,Novocaine,2001,95,USA, 8000000,2036682,2534372,497690,-5465628,0
36271,97.0,"Drama, Romance","A workaholic executive, and an unconventional woman agree to a personal relationship for a short period. In this short period she changes his life.",27.0,Pat O'Connor,Sweet November,2001,119,USA, 40000000,25288103,65754228,40466125,25754228,1
36130,82.0,"Comedy, Crime, Drama","Two aspiring boxers, lifelong friends, get involved in a money-laundering scheme through a low-level organized crime group.",62.0,Jon Favreau,Made,2001,95,USA, 5000000,5313300,5480653,167353,480653,1
36129,24.0,Drama,"This movie tells five stories set in a single day at the famed Chelsea Hotel in New York City, involving an ensemble cast of some 30-35 characters.",34.0,Ethan Hawke,Chelsea Walls,2001,109,USA, 100000,60902,60902,0,-39098,0
36574,46.0,"Action, Comedy, Crime","A man on the run takes another man's passport, only to find himself stuck with the identity of a street hustler.",25.0,George Gallo,Double Take,2001,88,USA, 24000000,29831583,31603059,1771476,7603059,1
36171,192.0,"Action, Horror, Sci-Fi","In 2176, a Martian police unit is sent to pick up a highly dangerous criminal at a remote mining post. Upon arrival, the cops find that the post has become a charnel house.",35.0,John Carpenter,Ghosts of Mars,2001,98,USA, 28000000,8709640,14010832,5301192,-13989168,0
35978,101.0,"Crime, Drama, Mystery",An orphaned teenager is taken in by a Malibu couple but discovers they aren't the caring friends they seemed to be.,34.0,Daniel Sackheim,The Glass House,2001,106,USA, 30000000,18150259,23619609,5469350,-6380391,0
36080,114.0,"Drama, Romance","A mysterious man is drawn to a feisty female police officer and a unusual relationship ensues, as not everything is as it seems.",39.0,Luis Mandoki,Angel Eyes,2001,102,USA, 53000000,24174218,29715606,5541388,-23284394,0
36616,86.0,"Comedy, Romance",Jo and Gilly date. They find out they're brother and sister. Jo moves away. Gilly finds out that he's not Jo's brother and that Jo's getting married. Can he stop the wedding in time?,21.0,J.B. Rogers,Say It Isn't So,2001,95,USA, 25000000,5520393,12320393,6800000,-12679607,0
36529,154.0,"Crime, Drama, Mystery",A retiring police detective pledges to catch the killer of a young child.,71.0,Sean Penn,The Pledge,2001,124,USA, 35000000,19733089,29419291,9686202,-5580709,0
35973,19.0,"Comedy, Family, Romance",A classic comedy of mistaken identity and romance set during the holiday season at a ski resort that is owned and operated by a Native American Nation. Shot on location at The Sundance ...,56.0,Kate Montgomery,Christmas in the Clouds,2001,96,USA, 3000000,279225,279225,0,-2720775,0
35969,152.0,"Biography, Crime, Drama","The story of how George Jung, along with the Medell√≠n Cartel headed by Pablo Escobar, established the American cocaine market in the 1970s in the United States.",52.0,Ted Demme,Blow,2001,124,USA, 53000000,52990775,83282296,30291521,30282296,1
36330,108.0,"Action, Comedy, Crime",A gang of ex-cons rob a casino during Elvis convention week.,21.0,Demian Lichtenstein,3000 Miles to Graceland,2001,125,USA, 62000000,15749959,18720175,2970216,-43279825,0
36146,122.0,"Action, Adventure, Comedy",The children of secret-agent parents must save them from danger.,71.0,Robert Rodriguez,Spy Kids,2001,88,USA, 35000000,112719001,147934180,35215179,112934180,1
30564,202.0,"Action, Adventure, Comedy",Agent J is sent to find Agent K and restore his memory after the re-appearance of a case from K's past.,49.0,Barry Sonnenfeld,Men in Black II,2002,88,USA, 140000000,193735288,445135288,251400000,305135288,1
39044,11.0,"Drama, Thriller","A famous psychiatrist (Ty Adams) takes on the job of trying to cure patients at the Sedah State Hospital, run by its folksy doctor (Sam Delazo). All this takes a strange turn when a ...",33.0,Eriq La Salle,Crazy as Hell,2002,113,USA, 1800000,21679,21679,0,-1778321,0
39012,5.0,"Comedy, Drama, Romance",A dramedy that centers on a self-procalimed anarchist and his like-minded friends.,36.0,Jordan Susman,The Anarchist Cookbook,2002,101,USA, 2500000,14369,14369,0,-2485631,0
39087,221.0,"Drama, Mystery, Sci-Fi",A family living on a farm finds mysterious crop circles in their fields which suggests something more frightening to come.,59.0,M. Night Shyamalan,Signs,2002,106,USA, 72000000,227966634,408247917,180281283,336247917,1
38990,30.0,"Drama, Romance","Michael, a young mechanic, is forced to choose between a daring tryst with an alluring stranger and the habitual comfort of his bittersweet obsession: his beautiful young tenant.",72.0,Eric Byler,Charlotte Sometimes,2002,85,USA, 80000,150445,247554,97109,167554,1
39091,31.0,Drama,"A Catholic boy tries to convert a terminally ill Jewish boy, so he will be able to go to Heaven.",36.0,Pete Jones,Stolen Summer,2002,91,USA, 1800000,134736,163348,28612,-1636652,0
39092,55.0,"Drama, Romance","A woman and her new husband returns to her hometown roots in coastal northern Florida, and must deal with family, business, and encroaching real estate development.",69.0,John Sayles,Sunshine State,2002,141,USA, 5600000,3065921,3369654,303733,-2230346,0
38935,83.0,Drama,An idealistic prep school teacher attempts to redeem an incorrigible student.,49.0,Michael Hoffman,The Emperor's Club,2002,109,USA, 12500000,14118751,16318449,2199698,3818449,1
39064,29.0,"Biography, Crime, Drama",Biopic about notorious American serial killer,63.0,David Jacobson,Dahmer,2002,101,USA, 250000,144008,144008,0,-105992,0
30609,310.0,"Action, Adventure, Fantasy","Ten years after initially meeting, Anakin Skywalker shares a forbidden romance with Padm√© Amidala, while Obi-Wan Kenobi investigates an assassination attempt on the senator and discovers a secret clone army crafted for the Jedi.",54.0,George Lucas,Star Wars: Episode II - Attack of the Clones,2002,142,USA, 115000000,310676740,649436358,338759618,534436358,1
38900,70.0,"Drama, Family, Fantasy",A young woman meets and falls in love with a young man who is part of a family of immortals.,66.0,Jay Russell,Tuck Everlasting,2002,90,USA, 15000000,19161999,19344615,182616,4344615,1
38661,73.0,"Action, Comedy","When ""The Man"" tries to derail a black candidate's presidential campaign, Undercover Brother and his fellow secret agents come to the rescue.",69.0,Malcolm D. Lee,Undercover Brother,2002,86,USA, 25000000,39089928,41604473,2514545,16604473,1
38682,94.0,Drama,"After years of mother-daughter tension, Siddalee receives a scrapbook detailing the wild adventures of the ""Ya-Yas"", her mother's girlhood friends.",48.0,Callie Khouri,Divine Secrets of the Ya-Ya Sisterhood,2002,116,USA, 27000000,69599016,73839240,4240224,46839240,1
38684,53.0,Comedy,"Three rowdy college students are kicked out of their dorm and dress up in drag to live in the DOG house, where the girls deemed unattractive live.",25.0,Wallace Wolodarsky,Sorority Boys,2002,93,USA, 12000000,10200032,12517488,2317456,517488,1
36557,154.0,"Action, Drama, Sci-Fi","In an oppressive future where all forms of feeling are illegal, a man in charge of enforcing the law rises to overthrow the system and state.",33.0,Kurt Wimmer,Equilibrium,2002,107,USA, 20000000,1203794,5368217,4164423,-14631783,0
36571,79.0,"Comedy, Drama","A group of Catholic school friends, after being caught drawing an obscene comic book, plan a heist that will outdo their previous prank and make them local legends.",69.0,Peter Care,The Dangerous Lives of Altar Boys,2002,104,USA, 12000000,1815864,2036599,220735,-9963401,0
38721,93.0,"Comedy, Drama","Lavinia and Suzette, former rock groupies and best friends, reconnect after twenty years; one is still as wild as ever, while the other has adopted a more conservative lifestyle.",48.0,Bob Dolman,The Banger Sisters,2002,98,USA, 10000000,30307416,38068353,7760937,28068353,1
38724,48.0,"Crime, Drama, Romance",A group of over-achieving Asian-American high school seniors enjoy a power trip when they dip into extra-curricular criminal activities.,67.0,Justin Lin,Better Luck Tomorrow,2002,101,USA, 250000,3802390,3809226,6836,3559226,1
38908,104.0,Drama,A teenager journeys through a series of foster homes after her mother goes to prison for committing a crime of passion.,61.0,Peter Kosminsky,White Oleander,2002,109,USA, 16000000,16357770,21672284,5314514,5672284,1
38732,118.0,"Comedy, Romance","A sweet-natured, small-town guy inherits a controlling stake in a media conglomerate and begins to do business his way.",24.0,Steven Brill,Mr. Deeds,2002,96,USA, 50000000,126293452,171269535,44976083,121269535,1
38750,126.0,"Comedy, Drama",A young man's peculiar upbringing renders him unable to competently cope with the struggle of growing up.,72.0,Burr Steers,Igby Goes Down,2002,98,USA, 9000000,4777465,6919198,2141733,-2080802,0
38791,79.0,"Drama, Romance","The story of two North Carolina teens, Landon Carter and Jamie Sullivan, who are thrown together after Landon gets into trouble and is made to do community service.",35.0,Adam Shankman,A Walk to Remember,2002,101,USA, 11800000,41281092,47494916,6213824,35694916,1
38803,152.0,"Comedy, Fantasy, Horror","Elvis Presley and a black ""JFK"" stay in a nursing home where nothing happens - until a wayward Egyptian mummy comes and sucks out the old people's souls thru their a-holes. The two decide to fight back.",57.0,Don Coscarelli,Bubba Ho-Tep,2002,92,USA, 1000000,1239183,1239183,0,239183,1
38822,38.0,"Animation, Adventure, Comedy","Eliza and Debbie are two sisters who don't always get along. But their relationship is put to the test when Debbie's life is in danger, and Eliza might have to give up her power to talk to animals....",69.0,"Cathy Malkasian, Jeff McGrath",The Wild Thornberrys Movie,2002,85,USA, 25000000,40108697,60694737,20586040,35694737,1
38862,85.0,"Comedy, Romance","A reporter interviews a psychic, who tells her that she's going to die and her life is meaningless.",31.0,Stephen Herek,Life or Something Like It,2002,103,USA, 40000000,14448589,16872671,2424082,-23127329,0
39190,105.0,"Action, Adventure, Comedy","The Cortez siblings set out for a mysterious island, where they encounter a genetic scientist and a set of rival spy kids.",66.0,Robert Rodriguez,Spy Kids 2: Island of Lost Dreams,2002,100,USA, 38000000,85846429,119723358,33876929,81723358,1
38891,93.0,"Comedy, Crime, Drama","A drug dealer introduces one of his customers, a 'speed freak', to the man who runs the meth lab. A crazy three-day adventure ensues.",41.0,Jonas √Ökerlund,Spun,2002,101,USA, 2000000,411119,685608,274489,-1314392,0
38893,86.0,"Drama, Thriller",A high school senior with a promising swimming career has a one-night stand with consequences.,29.0,John Polson,Swimfan,2002,85,USA, 10000000,28564995,34411240,5846245,24411240,1
38741,7.0,Comedy,"Andy works in marketing but wants to create something ""real"" so he gets a job in research with huge pay cut. He teams with 3 nerds to develop a $99 PC for 3rd world students. Then comes the dot-com crash.",20.0,Mick Jackson,The First $20 Million Is Always the Hardest,2002,105,USA, 17000000,5491,5491,0,-16994509,0
39268,50.0,"Animation, Action, Adventure",The movie shows the origin of the Powerpuff Girls before the cartoon series. It explains why they were born and why they dedicated their lives to fighting crime and the forces of evil.,65.0,Craig McCracken,The Powerpuff Girls Movie,2002,73,USA, 11000000,11412414,16426471,5014057,5426471,1
39616,58.0,"Drama, Romance",Three women's escapes from their afflicted lives. Each struggles to flee from the men who confine their personal freedom.,70.0,Rebecca Miller,Personal Velocity: Three Portraits,2002,86,USA, 125000,811299,890502,79203,765502,1
39314,87.0,"Action, Comedy, Sci-Fi",A hapless chauffeur must take a comatose Secret Agent's place using his special gadget-laden tuxedo.,30.0,Kevin Donovan,The Tuxedo,2002,98,USA, 60000000,50547998,104391623,53843625,44391623,1
40053,82.0,"Comedy, Family, Fantasy","Scott Calvin has been a humble Santa Claus for nearly ten years, but it might come to an end if he doesn't find a Mrs. Claus.",48.0,Michael Lembeck,The Santa Clause 2,2002,104,USA, 65000000,139236327,172855065,33618738,107855065,1
36690,47.0,Comedy,A high school senior branded uncool in the ninth grade gets himself expelled so he changes his image to cool kid at the town's other high school.,24.0,Ed Decter,The New Guy,2002,88,USA, 13000000,29760152,31167388,1407236,18167388,1
40177,205.0,"Drama, Mystery, Romance",A troubled psychologist is sent to investigate the crew of an isolated research station orbiting a bizarre planet.,65.0,Steven Soderbergh,Solaris,2002,99,USA, 47000000,14973382,30002758,15029376,-16997242,0
40194,215.0,Drama,"Cornered by the DEA, convicted New York drug dealer Montgomery Brogan reevaluates his life in the 24 remaining hours before facing a seven-year jail term.",67.0,Spike Lee,25th Hour,2002,135,USA, 5000000,13084595,23932055,10847460,18932055,1
40226,33.0,Drama,"Almost forty years after the John F. Kennedy assassination, an ex-Marine named Walter Ohlinger has come forward with a startling claim.",60.0,Neil Burger,Interview with the Assassin,2002,88,USA, 750000,48058,48058,0,-701942,0
40231,39.0,"Comedy, Family, Fantasy","A 14-year-old orphan becomes an NBA superstar after trying on a pair of sneakers with the faded initials ""M.J."" inside.",47.0,John Schultz,Like Mike,2002,99,USA, 30000000,51432760,62274780,10842020,32274780,1
40259,151.0,"Action, Crime, Drama","Still recovering from a heart transplant, retired F.B.I. profiler Terry McCaleb (Clint Eastwood) returns to service when his own blood analysis offers clues to the identity of a serial killer.",64.0,Clint Eastwood,Blood Work,2002,110,USA, 50000000,26235081,31794718,5559637,-18205282,0
40264,4.0,Drama,"The L.A. dog walking scene provides a colorful backdrop for the story of Ellie Moore, damaged goods on the run from her latest abusive boyfriend and on the verge of transformation. She's ...",45.0,Jacques Thelemaque,The Dogwalker,2002,99,USA, 425000,12024,12024,0,-412976,0
40464,33.0,"Animation, Adventure, Comedy","Based on the TV Series, Within the next seven days, the two boys must get the documents they need to stop the neighborhood from being bulldozed with their only help from Helga or it will be blown up.",47.0,Tuck Tucker,Hey Arnold! The Movie,2002,76,USA, 3000000,13728902,15249308,1520406,12249308,1
42647,14.0,Drama,"This powerful, hard-edged crime drama explores the dark side of the American immigrant experience and dares to ask, ""How far would you go to survive?"" Lana's only chance to escape the ...",40.0,Michael S. Ojeda,Lana's Rain,2002,107,USA, 215000,44287,44287,0,-170713,0
40946,11.0,"Drama, Thriller, Crime",Women prisoners strike up a friendship with a young law student who works as a part-time prison guard. Together they discover that a corporation funds and is profitting from the ...,29.0,Neema Barnette,Civil Brand,2002,95,USA, 500000,254293,254293,0,-245707,0
42353,22.0,Drama,Two troubled adolescents chronicle the events that ultimately lead up to a terrifying assault on their school.,69.0,Ben Coccio,Zero Day,2002,92,USA, 20000,8466,8466,0,-11534,0
41278,14.0,"Action, Drama","A tribute to graffiti art and the city where it all began. Blest, a 19-year-old graffiti writer, has just graduated from high school. With no ambition toward mainstream goals of work and ...",52.0,Adam Bhala Lough,Bomb the System,2002,91,USA, 500000,15520,15520,0,-484480,0
40014,63.0,"Comedy, Drama, Romance",A band director recruits a Harlem street drummer to play at a Southern university.,63.0,Charles Stone III,Drumline,2002,118,USA, 20000000,56399184,57588485,1189301,37588485,1
39295,107.0,"Comedy, Crime","Mobster Paul Vitti is released into Dr. Ben Sobol's care, where only more chaos ensues.",37.0,Harold Ramis,Analyze That,2002,96,USA, 60000000,32130627,55003135,22872508,-4996865,0
40010,265.0,Horror,"Five college graduates rent a cabin in the woods and begin to fall victim to a horrifying flesh-eating virus, which attracts the unwanted attention of the homicidal locals.",56.0,Eli Roth,Cabin Fever,2002,93,USA, 1500000,21158188,30553394,9395206,29053394,1
39993,124.0,"Drama, Horror",A socially awkward veterinary assistant with a lazy eye and obsession with perfection descends into depravity after developing a crush on a boy with perfect hands.,58.0,Lucky McKee,May,2002,93,USA, 500000,150277,264349,114072,-235651,0
39316,44.0,Drama,A troubled young woman is encouraged by a teacher to enter a poetry contest.,76.0,Karen Moncrieff,Blue Car,2002,96,USA, 1000000,465310,476551,11241,-523449,0
39320,108.0,"Comedy, Romance","A day in the life of a group of men and women in Hollywood, in the hours leading up to a friend's birthday party.",45.0,Steven Soderbergh,Full Frontal,2002,101,USA, 2000000,2512846,3438804,925958,1438804,1
39324,10.0,Comedy,A once-idealistic writer inadvertently ignites a feeding frenzy in Hollywood with the mention of a mysterious new screenplay and its illusive author.,53.0,Fran√ßois Velle,New Suit,2002,94,USA, 1000000,71743,71743,0,-928257,0
39551,25.0,"Comedy, Drama",Two cousins work nights at a local mall as security guards. When their house is robbed on Christmas Eve they team up to track the robber down.,35.0,Marcus Raboy,Friday After Next,2002,85,USA, 10000000,33253609,33526835,273226,23526835,1
39611,173.0,"Action, Adventure, Comedy","Upon learning that his father has been kidnapped, Austin Powers must travel to 1975 and defeat the aptly named villain Goldmember, who is working with Dr. Evil.",62.0,Jay Roach,Austin Powers in Goldmember,2002,94,USA, 63000000,213307889,296655431,83347542,233655431,1
39630,51.0,"Adventure, Comedy, Family",An Italian waiter fights off a criminal mastermind with his inherited powers of disguise.,12.0,Perry Andelin Blake,The Master of Disguise,2002,80,USA, 16000000,40388794,43411001,3022207,27411001,1
39653,188.0,"Action, Adventure, Thriller","An extreme sports athlete, Xander Cage, is recruited by the government on a special mission.",48.0,Rob Cohen,xXx,2002,124,USA, 70000000,142109382,277448382,135339000,207448382,1
39656,16.0,"Drama, Fantasy, Sci-Fi",A Bible professor from 1890 comes forward in time to the present via a time machine and cannot believe the things that he sees!,26.0,Rich Christiano,Time Changer,2002,95,USA, 825000,1305964,1305964,0,480964,1
39676,72.0,"Comedy, Drama","This is the story of Ana, a first generation Mexican-American teenager on the verge of becoming a woman. She lives in the predominately Latino community of East Los Angeles. Freshly ...",71.0,Patricia Cardoso,Real Women Have Curves,2002,90,USA, 3000000,5853194,7777790,1924596,4777790,1
39709,36.0,"Romance, Comedy, Drama","Friends since childhood, a magazine editor and a hip-hop record executive stumble into romantic territory.",58.0,Rick Famuyiwa,Brown Sugar,2002,109,USA, 8000000,27363891,28316451,952560,20316451,1
39758,28.0,"Drama, Family","Fifteen years ago, their Washington Heights neighborhood was dubbed the crack-cocaine capital of the world, but today it is transforming into one of the most vibrant, Spanish-speaking ...",71.0,Eric Eason,Manito,2002,78,USA, 24000,11000,11000,0,-13000,0
39759,8.0,"Crime, Drama, Romance","A Banker, Husband, and Father, Mr. Smith must leave it behind him. He's made a mistake and he's trying to pay for it but he doesn't know if there is enough money in the world. Or so he ...",22.0,Ian McCrudden,Mr. Smith Gets a Hustler,2002,91,USA, 200000,1915,1915,0,-198085,0
39796,102.0,"Biography, Crime, Drama",The life of TV star,66.0,Paul Schrader,Auto Focus,2002,105,USA, 7000000,2063196,2704951,641755,-4295049,0
39800,40.0,"Comedy, Drama, Thriller","After a martini-induced rampage, a fantasy-prone young woman is placed under house arrest.",51.0,Finn Taylor,Cherish,2002,99,USA, 1500000,179751,179751,0,-1320249,0
39991,8.0,"Drama, Music","Seymour Polatkin is a successful, gay Native American poet from Spokane who confronts his past when he returns to his childhood home on the reservation to attend the funeral of a dear ...",49.0,Sherman Alexie,The Business of Fancydancing,2002,103,USA, 200000,175710,175710,0,-24290,0
40004,89.0,"Comedy, Drama",A day in the life of a South Side Chicago barbershop.,66.0,Tim Story,Barbershop,2002,102,USA, 12000000,75782105,77063924,1281819,65063924,1
38628,87.0,"Comedy, Romance","A director is forced to work with his ex-wife, who left him for the boss of the studio bankrolling his new film. But the night before the first day of shooting, he develops a case of psychosomatic blindness.",46.0,Woody Allen,Hollywood Ending,2002,112,USA, 16000000,4850753,14569744,9718991,-1430256,0
39765,290.0,"Horror, Mystery",A journalist must investigate a mysterious videotape which seems to cause the death of anyone one week to the day after they view it.,57.0,Gore Verbinski,The Ring,2002,115,USA, 48000000,129128133,249348933,120220800,201348933,1
37547,221.0,"Comedy, Drama","A man upon retirement, embarks on a journey to his estranged daughter's wedding, only to discover more about himself and life than he ever expected.",85.0,Alexander Payne,About Schmidt,2002,125,USA, 30000000,65016287,105834556,40818269,75834556,1
35933,158.0,"Horror, Thriller","Three years after he last terrorized his sister, Michael Myers confronts her again, before traveling to Haddonfield to deal with the cast and crew of a reality show which is being broadcast from his old home.",19.0,Rick Rosenthal,Halloween: Resurrection,2002,94,USA, 13000000,30354442,37664855,7310413,24664855,1
38103,195.0,"Animation, Adventure, Comedy","Set during the Ice Age, a sabertooth tiger, a sloth, and a wooly mammoth find a lost human infant, and they try to return him to his tribe.",60.0,"Chris Wedge, Carlos Saldanha",Ice Age,2002,81,USA, 59000000,176387405,383257136,206869731,324257136,1
38080,250.0,"Comedy, Drama",A lovelorn screenwriter becomes desperate as he tries and fails to adapt 'The Orchid Thief' by,83.0,Spike Jonze,Adaptation.,2002,115,USA, 19000000,22498520,32801173,10302653,13801173,1
36855,7.0,Comedy,"An actor holds a burglar hostage on New Year's Eve, after his girlfriend leaves him and his cat dies.",33.0,Steve Guttenberg,P.S. Your Cat Is Dead!,2002,92,USA, 2000000,28454,28454,0,-1971546,0
38028,17.0,"Drama, Sport","A young man finds solace with a young woman, his mother, and a high-school football coach who recruits him to quarterback a six-man team.",65.0,"Alex Smith, Andrew J. Smith",The Slaughter Rule,2002,112,USA, 500000,13411,13411,0,-486589,0
37562,114.0,"Crime, Drama, Mystery","High powered lawyer Claire Kubik finds her world turned upside down when her husband, who has been living under a false name, is arrested by military police and placed on trial for the murder of villagers while he was in the Marines.",48.0,Carl Franklin,High Crimes,2002,115,USA, 42000000,41543917,63781810,22237893,21781810,1
37966,51.0,"Comedy, Crime",A middle-class man turns to a life of crime in order to finance his niece's first year at Harvard University.,25.0,Bruce McCulloch,Stealing Harvard,2002,85,USA, 25000000,14036406,14277032,240626,-10722968,0
33159,107.0,"Animation, Adventure, Drama","A wild stallion is captured by humans and slowly loses the will to resist training, yet, throughout his struggles for freedom, the stallion refuses to let go of the hope of one day returning home to his herd.",52.0,"Kelly Asbury, Lorna Cook",Spirit: Stallion of the Cimarron,2002,83,USA, 80000000,73280117,122563539,49283422,42563539,1
37956,93.0,"Drama, Family, Sport",A Texas baseball coach makes the major league after agreeing to try out if his high school team made the playoffs.,72.0,John Lee Hancock,The Rookie,2002,127,USA, 22000000,75600072,80693537,5093465,58693537,1
37943,212.0,"Drama, Thriller",A mentally unstable photo developer targets a middle-class family after his obsession with them becomes more sick and disturbing than any of them could imagine.,64.0,Mark Romanek,One Hour Photo,2002,96,USA, 12000000,31597131,52223306,20626175,40223306,1
32953,37.0,"Crime, Drama, Thriller","A con man (Matt Dillon) travels to Cambodia (also on the run from law enforcement in the U.S.) to collect his share in an insurance scam, but discovers more than he bargained for.",57.0,Matt Dillon,City of Ghosts,2002,116,USA, 17500000,357197,1277187,919990,-16222813,0
37940,171.0,"Drama, Horror, Mystery","A reporter is drawn to a small West Virginia town to investigate a series of strange events, including psychic visions and the appearance of bizarre entities.",52.0,Mark Pellington,The Mothman Prophecies,2002,119,USA, 32000000,35746370,55305279,19558909,23305279,1
36948,90.0,"Comedy, Crime, Thriller","The lives of several Miami denizens, from ad agents to gunrunners to street thugs to law enforcement to school-children, intersect with humorous and dangerous results.",47.0,Barry Sonnenfeld,Big Trouble,2002,85,USA, 40000000,7267307,8493890,1226583,-31506110,0
34144,203.0,"Crime, Thriller","Publicist Stuart Shepard finds himself trapped in a phone booth, pinned down by an extortionist's sniper rifle. Unable to leave or receive outside help, Stuart's negotiation with the caller leads to a jaw-dropping climax.",56.0,Joel Schumacher,Phone Booth,2002,81,USA, 13000000,46566212,97837138,51270926,84837138,1
37362,181.0,"Action, Adventure, Sci-Fi","The Enterprise is diverted to the Romulan homeworld Romulus, supposedly because they want to negotiate a peace treaty. Captain Picard and his crew discover a serious threat to the Federation once Praetor Shinzon plans to attack Earth.",51.0,Stuart Baird,Star Trek: Nemesis,2002,116,USA, 60000000,43254409,67336470,24082061,7336470,1
37373,101.0,"Comedy, Romance",A girl finds she is forced to educate herself on the etiquette of wooing the opposite sex when she finally meets Mr. Right.,32.0,Roger Kumble,The Sweetest Thing,2002,84,USA, 43000000,24718164,69319426,44601262,26319426,1
33310,118.0,"Biography, Drama","Antwone Fisher, a young navy man, is forced to see a psychiatrist after a violent outburst against a fellow crewman. During the course of treatment a painful past is revealed and a new hope begins.",62.0,Denzel Washington,Antwone Fisher,2002,120,USA, 12500000,21078145,23367586,2289441,10867586,1
37763,54.0,"Crime, Drama, Thriller",A successful South Bronx drug dealer turns his back on his roots and gives money to a Wall Street broker to invest for him.,38.0,Franc. Reyes,Empire,2002,90,USA, 4000000,17600423,18591272,990849,14591272,1
36867,157.0,"Action, Drama, War","Two U.S. Marines in World War II are assigned to protect Navajo Marines, who use their native language as an unbreakable radio cypher.",51.0,John Woo,Windtalkers,2002,134,USA, 115000000,40914068,77628265,36714197,-37371735,0
37908,133.0,"Crime, Mystery, Thriller","Two gifted high school students execute a ""perfect"" murder - then become engaged in an intellectual contest with a seasoned homicide detective.",50.0,Barbet Schroeder,Murder by Numbers,2002,115,USA, 50000000,31945749,56714147,24768398,6714147,1
34010,268.0,"Action, Crime, Mystery","In a future where a special police unit is able to arrest murderers before they commit their crimes, an officer from that unit is himself accused of a future murder.",80.0,Steven Spielberg,Minority Report,2002,145,USA, 102000000,132072926,358372926,226300000,256372926,1
33811,112.0,"Drama, Romance","As he copes with the death of his fianc√©e, a young man befriends her parents and must figure out what he wants out of life.",59.0,Brad Silberling,Moonlight Mile,2002,117,USA, 21000000,6835856,10011050,3175194,-10988950,0
37890,162.0,"Drama, Thriller","The story of what happens one day in New York City, when a young lawyer and a businessman share a small automobile accident on F.D.R. Drive, and their mutual road rage escalates into a feud.",69.0,Roger Michell,Changing Lanes,2002,98,USA, 45000000,66818548,94935764,28117216,49935764,1
37250,113.0,"Comedy, Drama, Romance","A Senatorial candidate falls for a hotel maid, thinking she is a socialite, when he sees her trying on a wealthy woman's dress.",45.0,Wayne Wang,Maid in Manhattan,2002,105,USA, 55000000,94011225,154906693,60895468,99906693,1
36770,137.0,"Comedy, Romance","After a brutal break-up, a young man vows to stay celibate during the forty days of Lent, but finds the girl of his dreams and is unable to do anything about it.",53.0,Michael Lehmann,40 Days and 40 Nights,2002,96,USA, 17000000,37950822,95146283,57195461,78146283,1
37197,114.0,"Drama, War","A law student becomes a lieutenant during World War II, is captured and asked to defend a black prisoner of war falsely accused of murder.",49.0,Gregory Hoblit,Hart's War,2002,125,USA, 70000000,19077641,32287044,13209403,-37712956,0
38136,99.0,"Crime, Drama, Mystery","Vincent Lamarca, whose father was executed for a 1950s kidnapping of a child, grew up to become a police officer, only to see his own son become a murder suspect.",50.0,Michael Caton-Jones,City by the Sea,2002,108,USA, 40000000,22449000,29676703,7227703,-10323297,0
38603,90.0,"Crime, Drama, Thriller","After running away fails, a terrified woman empowers herself in order to battle her abusive husband.",25.0,Michael Apted,Enough,2002,115,USA, 38000000,40007742,51801187,11793445,13801187,1
31399,136.0,"Animation, Adventure, Family","A Disney animated version of ""Treasure Island"". The only difference is that the film is set in outer space with alien worlds and other galactic wonders.",60.0,"Ron Clements, John Musker",Treasure Planet,2002,95,USA, 140000000,38176783,110041363,71864580,-29958637,0
37572,239.0,"Crime, Drama, Thriller","A divorced woman and her diabetic daughter take refuge in their newly-purchased house's safe room, when three men break-in, searching for a missing fortune.",65.0,David Fincher,Panic Room,2002,112,USA, 48000000,96397334,197079546,100682212,149079546,1
38520,44.0,"Action, Horror, Mystery",Strange happenings occur on a WW II submarine.,55.0,David Twohy,Below,2002,105,USA, 40000000,605562,2622015,2016453,-37377985,0
38489,38.0,"Comedy, Family, Music",Beary Barrington goes on an adventure to save Country Bear Hall by getting the Country Bears back together for a reunion concert.,37.0,Peter Hastings,The Country Bears,2002,88,USA, 35000000,16990825,18012097,1021272,-16987903,0
38479,195.0,"Animation, Adventure, Comedy",A Hawaiian girl adopts an unusual pet who is actually a notorious extra-terrestrial fugitive.,73.0,"Dean DeBlois, Chris Sanders",Lilo & Stitch,2002,85,USA, 80000000,145794338,273144151,127349813,193144151,1
36451,69.0,"Crime, Drama, Mystery","After a tragic incident, a man drifts into a world populated by thugs and speed junkies.",41.0,D.J. Caruso,The Salton Sea,2002,103,USA, 18000000,764554,1073198,308644,-16926802,0
38439,116.0,"Comedy, Drama, Romance","Three childhood best friends, and a guy they just met, take a road trip across the country, finding themselves and their friendship in the process.",27.0,Tamra Davis,Crossroads,2002,93,USA, 12000000,37191304,61141030,23949726,49141030,1
38426,171.0,"Comedy, Drama, Romance","A young woman, recently released from a mental hospital, gets a job as a secretary to a demanding lawyer, where their employer-employee relationship turns into a sexual, sadomasochistic one.",63.0,Steven Shainberg,Secretary,2002,107,USA, 4000000,4059680,9304609,5244929,5304609,1
38381,42.0,"Comedy, Drama, Sport","A talented pool hustler who has stayed out of the game for years, must go back to his old ways when his little brother gets involved with his enemy, the very man who held him back from greatness.",36.0,Mars Callahan,Poolhall Junkies,2002,99,USA, 4000000,563711,563711,0,-3436289,0
38378,114.0,"Comedy, Drama",A guidance counselor mistakenly sends out the wrong transcripts to Stanford University under the name of an over-achieving high schooler.,48.0,Jake Kasdan,Orange County,2002,82,USA, 18000000,41076018,43325009,2248991,25325009,1
32877,14.0,Drama,Six Anton Chekhov short stories set in modern day Cleveland during a three day rain storm.,52.0,Michael Meredith,Three Days of Rain,2002,98,USA, 3500000,2841,2841,0,-3497159,0
37536,214.0,"Crime, Drama, Thriller","A mob enforcer's son witnesses a murder, forcing him and his father to take to the road, and his father down a path of redemption and revenge.",72.0,Sam Mendes,Road to Perdition,2002,117,USA, 80000000,104454762,181001478,76546716,101001478,1
32108,313.0,"Action, Adventure, Sci-Fi","When bitten by a genetically modified spider, a nerdy, shy, and awkward high school student gains spider-like abilities that he eventually must use to fight evil as a superhero after tragedy befalls his family.",73.0,Sam Raimi,Spider-Man,2002,121,USA, 139000000,407022860,825025036,418002176,686025036,1
32606,65.0,"Action, Adventure, Comedy",A teenager accidentally activates a machine that enables him to speed up his body so that other people seem to be standing still.,40.0,Jonathan Frakes,Clockstoppers,2002,94,USA, 26000000,36989956,38793283,1803327,12793283,1
38253,18.0,Drama,"""Joshua"" tells the story of a possible second coming of Christ to a small U.S. town.",38.0,Jon Purdy,Joshua,2002,91,USA, 9000000,1461635,1461635,0,-7538365,0
38234,191.0,"Action, Adventure, Comedy",Venomous spiders get exposed to a noxious chemical that causes them to grow to monumental proportions.,53.0,Ellory Elkayem,Eight Legged Freaks,2002,99,USA, 30000000,17322606,45867333,28544727,15867333,1
38228,65.0,"Animation, Comedy, Musical","Davey Stone, an alcoholic with a criminal record, is sentenced to community service under the supervision of an elderly referee. Davey is then faced with trying to reform and abandon his bad habits.",23.0,Seth Kearsley,Eight Crazy Nights,2002,76,USA, 34000000,23586598,23833131,246533,-10166869,0
38225,90.0,"Comedy, Drama, Romance","Coming-of-age story about a suave 15-year-old prep school student who falls in love with his stepmother. When her best friend responds to his advances, he suddenly finds himself in way over his head.",71.0,Gary Winick,Tadpole,2002,78,USA, 150000,2891288,3200241,308953,3050241,1
36763,71.0,"Animation, Adventure, Comedy",Stuart and Snowbell set out across town to rescue a friend.,66.0,Rob Minkoff,Stuart Little 2,2002,77,USA, 120000000,64956806,169956806,105000000,49956806,1
37517,74.0,"Comedy, Romance","A young woman who's reinvented herself as a New York City socialite must return home to Alabama to obtain a divorce from her husband, after seven years of separation.",45.0,Andy Tennant,Sweet Home Alabama,2002,108,USA, 30000000,127223418,180622424,53399006,150622424,1
37202,118.0,"Crime, Drama, Thriller",John Quincy Archibald takes a hospital emergency room hostage when his insurance won't cover his son's heart transplant.,30.0,Nick Cassavetes,John Q,2002,116,USA, 36000000,71756802,102244770,30487968,66244770,1
38314,278.0,"Comedy, Drama, Romance","A psychologically troubled novelty supplier is nudged towards a romance with an English woman, all the while being extorted by a phone-sex line run by a crooked mattress salesman, and purchasing stunning amounts of pudding.",78.0,Paul Thomas Anderson,Punch-Drunk Love,2002,95,USA, 25000000,17844216,24665649,6821433,-334351,0
37010,30.0,"Comedy, Drama, Romance","A basketball star is booted out of the NBA when his on-court antics go too far, so he poses as a woman and joins the WUBA.",24.0,Jesse Vaughan,Juwanna Mann,2002,91,USA, 15600000,13670733,13802599,131866,-1797401,0
40891,46.0,Comedy,"When a presidential candidate dies unexpectedly in the middle of the campaign, Washington, D.C. alderman, Mays Gilliam is unexpectedly picked as his replacement.",44.0,Chris Rock,Head of State,2003,95,USA, 35200000,38125247,38620484,495237,3420484,1
40912,286.0,"Action, Adventure, Fantasy","Blacksmith Will Turner teams up with eccentric pirate ""Captain"" Jack Sparrow to save his love, the governor's daughter, from Jack's former pirate allies, who are now undead.",63.0,Gore Verbinski,Pirates of the Caribbean: The Curse of the Black Pearl,2003,143,USA, 140000000,305413918,654264015,348850097,514264015,1
40942,64.0,"Action, Drama",A son of the leader of a legendary group of an urban biker gang tries to retain his championship title.,36.0,Reggie Rock Bythewood,Biker Boyz,2003,110,USA, 24000000,22076772,23510601,1433829,-489399,0
40965,83.0,"Comedy, Drama, Family","A coming-of-age story about a shy, young boy sent by his irresponsible mother to spend the summer with his wealthy, eccentric uncles in Texas.",52.0,Tim McCanlies,Secondhand Lions,2003,111,USA, 30000000,42070939,47913828,5842889,17913828,1
40999,156.0,"Action, Adventure, Comedy",A tough aspiring chef is hired to bring home a mobster's son from the Amazon but becomes involved in the fight against an oppressive town operator and the search for a legendary treasure.,59.0,Peter Berg,The Rundown,2003,104,USA, 85000000,47726342,80981914,33255572,-4018086,0
40950,51.0,"Comedy, Drama, Family","An intergalactic dog pilot from Sirius (the dog star), visits Earth to verify the rumors that dogs have failed to take over the planet.",49.0,John Hoffman,Good Boy!,2003,87,USA, 18000000,37667746,45490616,7822870,27490616,1
38638,76.0,"Biography, Drama, History","The rise and fall of legendary war hero Thomas ""Stonewall"" Jackson as he leads the Confederacy to great success against the Union from 1861 to 1863.",30.0,Ron Maxwell,Gods and Generals,2003,219,USA, 56000000,12882934,12923936,41002,-43076064,0
40872,8.0,"Comedy, Romance","April's Shower is a comedy about love, romance and expectation. The story follows unpredictable twists and turns until it climaxes with a madcap finale. The hilarity belies the poignancy of...",38.0,Trish Doolan,April's Shower,2003,100,USA, 1000000,16377,16377,0,-983623,0
40857,248.0,Horror,"After picking up a traumatized young hitchhiker, five friends find themselves stalked and hunted by a deformed chainsaw-wielding loon and his family of equally psychopathic killers.",38.0,Marcus Nispel,The Texas Chainsaw Massacre,2003,98,USA, 9500000,80571655,107362708,26791053,97862708,1
40845,26.0,"Crime, Thriller","A group of hustlers encounter ""The Dean"" and pull off a successful sting that results in their pursuit by a vengeful gangster.",40.0,Damian Nieman,Shade,2003,101,USA, 10000000,25032,459098,434066,-9540902,0
40795,20.0,"Drama, Mystery","The film follows fictional movie star Gray Evans through the disintegration of his marriage, his gradual mental breakdown, and his increasing obsession with a young film student who reminds...",39.0,Adam Goldberg,I Love Your Work,2003,111,USA, 1650000,3264,3264,0,-1646736,0
40793,61.0,"Drama, Fantasy","Set in 1955, the residents of a small Montana community are forced to move their homes to make way for a new dam.",64.0,Michael Polish,Northfork,2003,103,USA, 1900000,1420578,1599804,179226,-300196,0
40781,132.0,"Comedy, Family, Fantasy","An overworked mother and her daughter do not get along. When they switch bodies, each is forced to adapt to the other's life for one freaky Friday.",70.0,Mark Waters,Freaky Friday,2003,97,USA, 20000000,110230332,160846332,50616000,140846332,1
40694,45.0,"Comedy, Drama, Romance","A teenager (Moore), disillusioned by too many examples of love gone wrong, refuses to believe that true love exists. Then this new guy (Ford) comes along...",45.0,Clare Kilner,How to Deal,2003,101,USA, 16000000,14195227,14308132,112905,-1691868,0
40689,167.0,"Comedy, Family, Fantasy","After discovering he is a human, a man raised as an elf at the North Pole decides to travel to New York City to locate his real father.",64.0,Jon Favreau,Elf,2003,97,USA, 33000000,173840591,220885524,47044933,187885524,1
40679,248.0,"Adventure, Drama, Fantasy",A frustrated son tries to determine the fact from fiction in his dying father's life.,58.0,Tim Burton,Big Fish,2003,125,USA, 70000000,66809693,122919055,56109362,52919055,1
40649,141.0,"Drama, Romance","In an old school Las Vegas casino, its top gambling jinx breaks his curse when he falls in love, much to his boss' consternation.",69.0,Wayne Kramer,The Cooler,2003,101,USA, 3200000,8291572,10464788,2173216,7264788,1
40646,73.0,"Comedy, Romance",A writer must turn out a novel in thirty days or face the wrath of loan sharks.,32.0,Rob Reiner,Alex & Emma,2003,96,USA, 30000000,14218698,15368897,1150199,-14631103,0
40612,37.0,Comedy,An orthodox Jewish blaxploitation hero saves Hanukkah from the clutches of Santa Claus' evil son.,41.0,Jonathan Kesselman,The Hebrew Hammer,2003,85,USA, 2000000,82157,94615,12458,-1905385,0
40599,84.0,"Comedy, Family",Two men get laid off and have to become stay-at-home dads when they can't find jobs. This inspires them to open their own day-care center.,39.0,Steve Carr,Daddy Day Care,2003,92,USA, 60000000,104297061,164433867,60136806,104433867,1
42688,33.0,"Action, Drama, War",Four American soldiers and one Brit fighting in Europe during World War II struggle to return to Allied territory after being separated from U.S. forces during the historic Malmedy Massacre.,56.0,Ryan Little,Saints and Soldiers,2003,90,USA, 780000,1310470,1310470,0,530470,1
40887,70.0,Comedy,A thirty-something former child star hires a foster family to re-create the childhood he never had.,36.0,Sam Weisman,Dickie Roberts: Former Child Star,2003,98,USA, 17000000,22738671,23727734,989063,6727734,1
40786,97.0,"Drama, Music, Romance","Honey is a sexy, tough music video choreographer who shakes up her life after her mentor gives her an ultimatum: sleep with him or be blacklisted within their industry.",37.0,Bille Woodruff,Honey,2003,94,USA, 18000000,30308417,62228395,31919978,44228395,1
41301,40.0,"Animation, Adventure, Comedy","The Rugrats get tangled in an exotic adventure, where they're helped by the Thornberrys, a family that travels the world making nature documentaries.",38.0,"John Eng, Norton Virgien",Rugrats Go Wild,2003,80,USA, 25000000,39402572,55250496,15847924,30250496,1
41006,36.0,"Comedy, Crime","A senator arranges for his son, a rich white kid who fancies himself black, to be kidnapped by a couple of black actors pretending to be murderers to try and shock him out of his plans to become a rapper.",43.0,John Whitesell,Malibu's Most Wanted,2003,86,USA, 15000000,34432201,34622504,190303,19622504,1
41746,109.0,"Comedy, Family","With his wife doing a book tour, a father of twelve must handle a new job and his unstable brood.",46.0,Shawn Levy,Cheaper by the Dozen,2003,98,USA, 40000000,138614544,190538630,51924086,150538630,1
42014,27.0,"Drama, Romance, Comedy","2 high school guys, reenacting historic battles, use the learned strategy and team for war on a school bully. One falls for the other's sister/A.Smart.",33.0,"Efram Potelle, Kyle Rankin",The Battle of Shaker Heights,2003,79,USA, 1000000,280351,280351,0,-719649,0
42054,6.0,"Comedy, Fantasy, Romance",A struggling musician happens upon a nightclub that's frozen in time.,36.0,Martin Guigui,Swing,2003,98,USA, 2500000,2509,2509,0,-2497491,0
41610,35.0,"Comedy, Drama, Romance","A promiscuous gay party animal falls for a young Mormon missionary, leading to crisis, clich√©, and catastrophe.",45.0,C. Jay Cox,Latter Days,2003,107,USA, 850000,834685,865028,30343,15028,1
42120,22.0,"Comedy, Drama","""Assisted Living"" chronicles a day in the life of Todd, a janitor who ""Assisted Living"" is shot and staged in a real nursing home and gains",57.0,Elliot Greenebaum,Assisted Living,2003,78,USA, 500000,49048,49048,0,-450952,0
41491,161.0,"Comedy, Drama","When his only friend dies, a man born with dwarfism moves to rural New Jersey to live a life of solitude, only to meet a chatty hot dog vendor and a woman dealing with her own personal loss.",81.0,Tom McCarthy,The Station Agent,2003,89,USA, 500000,5739376,8701337,2961961,8201337,1
41449,10.0,"Comedy, Drama, Fantasy","An eclectic cast of characters intertwines and collides around themes of faith, religion and race in a small East Texas town. Screen Door Jesus tells the story of the church-going, but not ...",61.0,Kirk Davis,Screen Door Jesus,2003,119,USA, 3000000,59000,59000,0,-2941000,0
41431,19.0,"Crime, Drama, Romance","Sensitive, somewhat effeminate farm-boy Duncan Mudge can barely cope with grim, since Ma's death even gloomier father Edgar's manly expectations, and seeks comfort in petting a chicken he ...",62.0,Michael Burke,The Mudge Boy,2003,94,USA, 800000,62852,62852,0,-737148,0
41402,61.0,"Comedy, Musical, Romance","A waitress from Texas and a college student from Pennsylvania meet during spring break in Fort Lauderdale, Florida and come together through their shared love of singing.",14.0,Robert Iscove,From Justin to Kelly,2003,81,USA, 12000000,4928883,4928883,0,-7071117,0
41004,47.0,"Drama, Horror, Romance","The twisted tale of Kenneth, socially insecure technical writer who forms an obsessive relationship with ""Nikki"", an anatomically accurate silicone sex doll he orders over the Internet. ...",45.0,Robert Parigi,Love Object,2003,88,USA, 1000000,6028,6028,0,-993972,0
41375,5.0,Drama,"In the film, ""Wake"", the fateful reunion of four brothers quickly dissolves into a night of drinking, deceit, perversions, and death. They don't realize until it is too late that the party ...",34.0,Roy Finch,Wake,2003,90,USA,1000,7212,7212,0,6212,1
41363,93.0,"Action, Adventure, Comedy","Carmen's caught in a virtual reality game designed by the Kids' new nemesis, the Toymaker. It's up to Juni to save his sister, and ultimately the world.",57.0,Robert Rodriguez,Spy Kids 3: Game Over,2003,84,USA, 38000000,111761982,197101678,85339696,159101678,1
42232,213.0,"Crime, Drama, Thriller",Several ordinary high school students go through their daily routine as two others prepare for something more malevolent.,70.0,Gus Van Sant,Elephant,2003,81,USA, 3000000,1266955,10012022,8745067,7012022,1
41348,130.0,"Adventure, Thriller, Western","In 1885 New Mexico, a frontier medicine woman forms an uneasy alliance with her estranged father when her daughter is kidnapped by an Apache brujo.",55.0,Ron Howard,The Missing,2003,137,USA, 60000000,27011180,38364277,11353097,-21635723,0
41339,130.0,"Comedy, Family, Fantasy","A realtor and his wife and children are summoned to a mansion, which they soon discover is haunted, and while they attempt to escape, he learns an important lesson about the family he has neglected.",34.0,Rob Minkoff,The Haunted Mansion,2003,88,USA, 90000000,75847266,182290266,106443000,92290266,1
41335,28.0,"Adventure, Comedy, Sport","Four skaters follow their idol on his summer tour in an attempt to get noticed, get sponsored, and become stars themselves.",30.0,Casey La Scala,Grind,2003,105,USA, 6000000,5123696,5141166,17470,-858834,0
41307,147.0,"Comedy, Drama, Romance",A swinger on the cusp of being a senior citizen with a taste for young women falls in love with an accomplished woman closer to his age.,66.0,Nancy Meyers,Something's Gotta Give,2003,128,USA, 80000000,124728738,265328738,140600000,185328738,1
42731,235.0,"Adventure, Drama, Horror",Based on the true story of two scuba divers accidentally stranded in shark infested waters after their tour boat has left.,63.0,Chris Kentis,Open Water,2003,79,USA, 500000,30610863,54667954,24057091,54167954,1
41221,138.0,Comedy,"Elle Woods heads to Washington, D.C. to join the staff of a Representative in order to pass a bill to ban animal testing.",47.0,Charles Herman-Wurmfeld,"Legally Blonde 2: Red, White & Blonde",2003,95,USA, 45000000,90186328,124914842,34728514,79914842,1
42478,111.0,Drama,"Johnny is a successful banker who lives happily in a San Francisco townhouse with his fianc√©e, Lisa. One day, inexplicably, she gets bored with him and decides to seduce his best friend, Mark. From there, nothing will be the same again.",9.0,Tommy Wiseau,The Room,2003,99,USA, 6000000,549602,5581201,5031599,-418799,0
41082,133.0,"Action, Comedy, Crime",Two LAPD detectives who moonlight in other fields investigate the murder of an up-and-coming rap group.,47.0,Ron Shelton,Hollywood Homicide,2003,116,USA, 75000000,30940691,51142659,20201968,-23857341,0
42491,10.0,Drama,"When a teenager finds herself pregnant, with no memory of having had sex, she determines that she is carrying the child of God.",48.0,Deborah Kampmeier,Virgin,2003,114,USA, 50000,9614,9614,0,-40386,0
41075,164.0,"Drama, History, Sport",True story of the undersized Depression-era racehorse whose victories lifted not only the spirits of the team behind it but also those of their nation.,72.0,Gary Ross,Seabiscuit,2003,140,USA, 87000000,120277854,148336445,28058591,61336445,1
41046,86.0,Comedy,Set back in the 80s when Harry met Lloyd in high school where they cross paths with a mean principal and a bunch of other outcasts much like themselves.,19.0,Troy Miller,Dumb and Dumberer: When Harry Met Lloyd,2003,85,USA, 19000000,26276465,39267515,12991050,20267515,1
41037,119.0,"Animation, Adventure, Comedy","When a young Inuit hunter needlessly kills a bear, he is magically changed into a bear himself as punishment with a talkative cub being his only guide to changing back.",48.0,"Aaron Blaise, Robert Walker",Brother Bear,2003,85,USA, 128000000,85336277,250397798,165061521,122397798,1
41364,124.0,Comedy,Conjoined twins from Martha's Vineyard move to Los Angeles so that one of them can pursue an acting career.,62.0,"Bobby Farrelly, Peter Farrelly",Stuck on You,2003,118,USA, 55000000,33832741,65784503,31951762,10784503,1
40554,77.0,"Biography, Drama, Sport",The story of a high school coach and the developmentally challenged man who he took under his wing.,38.0,Michael Tollin,Radio,2003,109,USA, 35000000,52333738,53293628,959890,18293628,1
40530,200.0,"Crime, Drama, Thriller","A freak accident brings together a critically ill mathematician, a grieving mother, and a born-again ex-con.",70.0,Alejandro G. I√±√°rritu,21 Grams,2003,124,USA, 20000000,16290476,60427839,44137363,40427839,1
40538,160.0,"Crime, Drama",An abandoned wife is evicted from her house and starts a tragic conflict with her house's new owners.,71.0,Vadim Perelman,House of Sand and Fog,2003,126,USA, 16500000,13040288,16763804,3723516,263804,1
40040,141.0,Drama,A free-thinking art professor teaches conservative 1950s Wellesley girls to question their traditional social roles.,45.0,Mike Newell,Mona Lisa Smile,2003,117,USA, 65000000,63860942,141337989,77477047,76337989,1
37537,147.0,"Action, Adventure, Crime","An imprisoned drug kingpin offers a huge cash reward to anyone that can break him out of police custody, and only the L.A.P.D.'s Special Weapons and Tactics team can prevent it.",45.0,Clark Johnson,S.W.A.T.,2003,117,USA, 80000000,116934650,207725639,90790989,127725639,1
39970,117.0,Comedy,Three friends attempt to recapture their glory days by opening up a fraternity near their alma mater.,54.0,Todd Phillips,Old School,2003,88,USA, 24000000,75585093,87055349,11470256,63055349,1
39919,175.0,Horror,"Set a few days after the original, a championship basketball team's bus is attacked by The Creeper, the winged, flesh-eating terror, on the last day of his 23-day feeding frenzy.",36.0,Victor Salva,Jeepers Creepers 2,2003,104,USA, 17000000,35667218,63102666,27435448,46102666,1
39878,129.0,"Action, Adventure, Sci-Fi",A group of archaeologists become trapped in the past when they go there to retrieve a friend. The group must survive in 14th century France before they can escape back to the 21st Century.,28.0,Richard Donner,Timeline,2003,116,USA, 80000000,19481943,43935763,24453820,-36064237,0
39846,127.0,"Comedy, Crime, Romance",Larry Gigli is assigned by a crime boss to kidnap the brother of a prominent district attorney. A beautiful woman known only as Ricki is sent to stay with him to make sure he doesn't mess up the job.,18.0,Martin Brest,Gigli,2003,121,USA, 54000000,6087542,7266209,1178667,-46733791,0
39825,90.0,"Drama, Romance",Small-town love story of a young man with a reputation for womanizing and his best friend's sister.,71.0,David Gordon Green,All the Real Girls,2003,108,USA, 2500000,549666,579986,30320,-1920014,0
37850,73.0,"Comedy, Drama, Romance","A grown-up woman, who kept her childish instincts and behavior, starts working as a nanny of a 8-year-old girl, who actually acts like an adult. But in the end everything turns to its right places.",33.0,Boaz Yakin,Uptown Girls,2003,92,USA, 20000000,37182494,44617342,7434848,24617342,1
40549,162.0,"Action, Drama, Romance",A former gunslinger is forced to take up arms again when he and his cattle crew are threatened by a corrupt lawman.,67.0,Kevin Costner,Open Range,2003,139,USA, 22000000,58331254,68296293,9965039,46296293,1
33483,102.0,"Action, Comedy, Crime",Two loose-cannon narcotics cops investigate the flow of Ecstasy into Florida from a Cuban drug cartel.,38.0,Michael Bay,Bad Boys II,2003,147,USA, 130000000,138608444,273339556,134731112,143339556,1
39620,78.0,"Comedy, Romance",A soon-to-be husband wakes up on the morning after his bachelor party in bed with another woman.,27.0,Chris Koch,A Guy Thing,2003,101,USA, 20000000,15545431,17432163,1886732,-2567837,0
39474,148.0,"Action, Thriller",A brilliant young CIA trainee is asked by his mentor to help find a mole in the Agency.,56.0,Roger Donaldson,The Recruit,2003,115,USA, 46000000,52802140,101191884,48389744,55191884,1
39202,285.0,"Action, Crime",A man blinded by toxic waste which also enhanced his remaining senses fights crime as an acrobatic martial arts superhero.,42.0,Mark Steven Johnson,Daredevil,2003,103,USA, 78000000,102543518,179179718,76636200,101179718,1
39126,277.0,"Action, Sci-Fi","Bruce Banner, a genetics researcher with a tragic past, suffers an accident that causes him to transform into a raging green monster when he gets angry.",54.0,Ang Lee,Hulk,2003,138,USA, 137000000,132177234,245285165,113107931,108285165,1
36377,286.0,"Action, Sci-Fi","Neo and his allies race against time before the machines discover the city of Zion and destroy it. While seeking the truth about the Matrix, Neo must save Trinity from a dark fate within his dreams.",62.0,"Lana Wachowski, Lilly Wachowski",The Matrix Reloaded,2003,138,USA, 150000000,281576461,828770175,547193714,678770175,1
33096,100.0,"Animation, Adventure, Family","The sailor of legend is framed by the goddess Eris for the theft of the Book of Peace, and must travel to her realm at the end of the world to retrieve it and save the life of his childhood friend Prince Proteus.",48.0,"Patrick Gilmore, Tim Johnson",Sinbad: Legend of the Seven Seas,2003,86,USA, 60000000,26483452,80767884,54284432,20767884,1
38144,138.0,"Action, Crime, Drama",An FBI deep-woods tracker attempts to capture a trained assassin who has made a sport of hunting humans.,40.0,William Friedkin,The Hunted,2003,94,USA, 55000000,34244097,45496534,11252437,-9503466,0
38209,56.0,"Comedy, Romance","After a man is asked to house sit for his boss, he becomes determined to get closer to the boss's daughter, but events keep unfolding that stop him from achieving his goal.",15.0,David Zucker,My Boss's Daughter,2003,86,USA, 14000000,15550605,18191005,2640400,4191005,1
36722,259.0,"Action, Sci-Fi",The human city of Zion defends itself against the massive invasion of the machines as Neo fights to end the war at another front while also opposing the rogue Agent Smith.,47.0,"Lana Wachowski, Lilly Wachowski",The Matrix Revolutions,2003,129,USA, 150000000,139313948,427344031,288030083,277344031,1
31679,166.0,"Comedy, Crime, Romance",A beautiful gold digger matches wits with a shrewd Beverly Hills divorce lawyer who is increasingly attracted to her.,71.0,"Joel Coen, Ethan Coen",Intolerable Cruelty,2003,100,USA, 60000000,35327628,119898783,84571155,59898783,1
40079,73.0,Comedy,"Dave Buznik is a businessman who is wrongly sentenced to an anger management program, where he meets an aggressive instructor.",52.0,Peter Segal,Anger Management,2003,106,USA, 75000000,135645823,195745823,60100000,120745823,1
40083,112.0,"Action, Adventure, Comedy",The Angels investigate a series of murders which occur after the theft of a witness protection profile database.,48.0,McG,Charlie's Angels: Full Throttle,2003,106,USA, 120000000,100830111,259175788,158345677,139175788,1
37869,87.0,"Comedy, Romance",A small-town woman tries to achieve her goal of becoming a flight attendant.,27.0,Bruno Barreto,View from the Top,2003,87,USA, 30000000,15614000,19526014,3912014,-10473986,0
40428,127.0,"Crime, Drama, Mystery",A Florida police chief must solve a vicious double homicide before he himself falls under suspicion.,63.0,Carl Franklin,Out of Time,2003,105,USA, 50000000,41088845,55495563,14406718,5495563,1
40096,122.0,Comedy,"When a lonely guy meets a woman on the internet who happens to be in prison, she breaks out to get him to prove her innocence, and proceeds to wreak havoc on his middle-class life.",39.0,Adam Shankman,Bringing Down the House,2003,105,USA, 33000000,132716677,164729679,32013002,131729679,1
40433,166.0,"Crime, Drama, Thriller",A juror on the inside and a woman on the outside manipulate a court trial involving a major gun manufacturer.,61.0,Gary Fleder,Runaway Jury,2003,127,USA, 60000000,49443628,80154140,30710512,20154140,1
37233,214.0,Horror,Two young couples traveling across the backwoods of Texas searching for urban legends of murder end up as prisoners of a bizarre and sadistic backwater family of serial killers.,31.0,Rob Zombie,House of 1000 Corpses,2003,89,USA, 7000000,12634962,16829545,4194583,9829545,1
40360,132.0,"Comedy, Drama",A wayward daughter invites her dying mother and the rest of her estranged family to her apartment for Thanksgiving dinner.,70.0,Peter Hedges,Pieces of April,2003,80,USA, 300000,2528664,3282321,753657,2982321,1
40473,97.0,"Action, Drama, Thriller",A Special-Ops commander leads his team into the Nigerian jungle in order to rescue a doctor who will only join them if they agree to save 70 refugees too.,48.0,Antoine Fuqua,Tears of the Sun,2003,121,USA, 75000000,43734876,86468162,42733286,11468162,1
40341,105.0,"Adventure, Comedy, Drama",A wrongfully convicted boy is sent to a brutal desert detention camp where he joins the job of digging holes for some mysterious reason.,71.0,Andrew Davis,Holes,2003,117,USA, 20000000,67406573,71406573,4000000,51406573,1
40494,64.0,"Comedy, Crime, Musical","From his hospital bed, a writer suffering from a skin disease hallucinates musical numbers and paranoid plots.",45.0,Keith Gordon,The Singing Detective,2003,109,USA, 8000000,337174,435625,98451,-7564375,0
40519,193.0,"Comedy, Drama, Fantasy",A guy who complains about God too often is given almighty powers to teach him how difficult it is to run the world.,46.0,Tom Shadyac,Bruce Almighty,2003,101,USA, 81000000,242829261,484592874,241763613,403592874,1
40337,257.0,"Action, Adventure, Drama","During the Napoleonic Wars, a brash British captain pushes his ship and crew to their limits in pursuit of a formidable French war vessel around South America.",81.0,Peter Weir,Master and Commander: The Far Side of the World,2003,138,USA, 150000000,93927920,210327920,116400000,60327920,1
40273,143.0,"Mystery, Thriller","Stranded at a desolate Nevada motel during a nasty rain-storm, ten strangers become acquainted with each other when they realize that they're being killed off one by one.",64.0,James Mangold,Identity,2003,90,USA, 28000000,52159536,90259536,38100000,62259536,1
40392,115.0,"Adventure, Comedy, Family",Two bored children have their lives turned upside down when a talking cat comes to visit them.,19.0,Bo Welch,The Cat in the Hat,2003,82,USA, 109000000,101149285,133960541,32811256,24960541,1
34540,37.0,"Comedy, Drama, Music",A New York advertising executive travels to a small Southern town to collect an inheritance but finds he must create a gospel choir and lead it to success before he can collect.,53.0,Jonathan Lynn,The Fighting Temptations,2003,123,USA, 30000000,30250745,32445215,2194470,2445215,1
40141,107.0,"Action, Crime, Drama","A jewel thief's daughter is kidnapped after he steals a collection of prized black diamonds, which aren't at all what they seem.",36.0,Andrzej Bartkowiak,Cradle 2 the Grave,2003,101,USA, 25000000,34712347,56489558,21777211,31489558,1
40149,68.0,"Adventure, Comedy, Family","Lizzie McGuire has graduated from middle school and takes a trip to Rome, Italy with her class. And what was supposed to be only a normal trip, becomes a teenager's dream come true.",56.0,Jim Fall,The Lizzie McGuire Movie,2003,94,USA, 17000000,42734455,55534455,12800000,38534455,1
43268,77.0,"Comedy, Drama","Fired from his job for exposing corrupt business practices, a former biotech executive turns to impregnating wealthy lesbians for profit.",28.0,Spike Lee,She Hate Me,2004,138,USA, 8000000,366037,1526951,1160914,-6473049,0
41905,57.0,"Action, Crime, Drama",A drug kingpin's return home touches off a turf war.,38.0,Ernest R. Dickerson,Never Die Alone,2004,88,USA, 3000000,5645298,5923000,277702,2923000,1
43817,26.0,"Comedy, Drama, Romance","High school senior Dorian begins a gay man's odyssey when he determines that he's gay and decides to come out. Chief among concerns is the reaction of his father, who has never liked him.",52.0,Tennyson Bardwell,Dorian Blues,2004,88,USA, 185000,72234,72234,0,-112766,0
42215,69.0,"Comedy, Crime, Family","Two very different twin sisters haven't spent a day together in years. That changes the day they have to go to NYC and everything goes wrong - chased by a truancy officer, a killer wanting a chip back and two nice young guys.",33.0,Dennie Gordon,New York Minute,2004,91,USA, 30000000,14071441,21289826,7218385,-8710174,0
41979,172.0,"Drama, Mystery, Sci-Fi","After being told that their children never existed, a man and woman soon discover there is a much bigger enemy at work.",43.0,Joseph Ruben,The Forgotten,2004,91,USA, 42000000,67133509,117592831,50459322,75592831,1
41980,119.0,"Animation, Comedy, Family","Jon Arbuckle buys a second pet, a dog named Odie. However, Odie is then abducted and it is up to Jon's cat, Garfield, to find and rescue the canine.",27.0,Peter Hewitt,Garfield,2004,80,USA, 50000000,75369589,198964901,123595312,148964901,1
44695,99.0,"Drama, Mystery, Thriller","A man in his early 30s (Keane) struggles with the supposed loss of his daughter from the Port Authority Bus Terminal in New York, while fighting serious battles with schizophrenia. We can ...",79.0,Lodge Kerrigan,Keane,2004,100,USA, 850000,33256,476630,443374,-373370,0
42671,15.0,"Comedy, Drama, Romance","After getting dumped by his slutty girlfriend, Caleb falls in love with Gwen. However, thanks to Caleb's roommate, Gwen thinks he's gay and sets him up with her roommate, Marc.",28.0,Q. Allan Brocka,Eating Out,2004,90,USA, 50000,155212,155212,0,105212,1
42012,185.0,Comedy,"Ron Burgundy is San Diego's top-rated newsman in the male-dominated broadcasting of the 1970s, but that's all about to change for Ron and his cronies when an ambitious woman is hired as a new anchor.",63.0,Adam McKay,Anchorman: The Legend of Ron Burgundy,2004,94,USA, 26000000,85288303,90517748,5229445,64517748,1
43719,60.0,"Animation, Comedy, Family","Fat Albert and the Cosby Kids come to life and step out of their animated, inner-city Philadelphia world.",39.0,Joel Zwick,Fat Albert,2004,93,USA, 26000000,48116322,48551322,435000,22551322,1
42167,269.0,"Action, Adventure, Comedy","With a plan to exact revenge on a mythical shark that killed his partner, Oceanographer Steve Zissou rallies a crew that includes his estranged wife, a journalist, and a man who may or may not be his son.",62.0,Wes Anderson,The Life Aquatic with Steve Zissou,2004,119,USA, 50000000,24020403,34808403,10788000,-15191597,0
42781,216.0,Comedy,"A listless and alienated teenager decides to help his new friend win the class presidency in their small western high school, while he must deal with his bizarre family life back home.",64.0,Jared Hess,Napoleon Dynamite,2004,96,USA, 400000,44540956,46138887,1597931,45738887,1
42163,157.0,"Comedy, Drama, Romance","An Eastern European tourist unexpectedly finds himself stranded in JFK airport, and must take up temporary residence there.",55.0,Steven Spielberg,The Terminal,2004,128,USA, 60000000,77872883,218685607,140812724,158685607,1
42144,74.0,"Comedy, Romance, Drama","A woman snoops through her boyfriend's palm pilot and reveals his former girlfriends, which causes her to question why they're still listed in his little black book.",36.0,Nick Hurran,Little Black Book,2004,107,USA, 35000000,20698668,22034832,1336164,-12965168,0
42138,44.0,"Family, Music, Musical",A girl from a small town heads to the big city of Los Angeles to spend the summer at a performing arts high school.,33.0,Sean McNamara,Raise Your Voice,2004,103,USA, 15000000,10411980,14867514,4455534,-132486,0
42791,24.0,"Biography, Drama, Romance","Jim Caviezel stars as golf legend Bobby Jones, the icon who retired from competition at the tender age of 28.",45.0,Rowdy Herrington,Bobby Jones: Stroke of Genius,2004,120,USA, 20000000,2694071,2707913,13842,-17292087,0
43812,9.0,"Animation, Adventure, Comedy","Worried that he costs too much to feed, Clifford runs away to join a carnival act and help win a lifetime supply of Tummy Yummies.",49.0,"Robert C. Ramirez, Steve Trenbirth",Clifford's Really Big Movie,2004,74,USA, 70000,2922354,3255426,333072,3185426,1
44063,284.0,"Drama, Sport",A determined woman works with a hardened boxing trainer to become a professional.,86.0,Clint Eastwood,Million Dollar Baby,2004,132,USA, 30000000,100492203,216763646,116271443,186763646,1
42074,44.0,Comedy,AAA can't help the roadside emergency that is the JOHNSON FAMILY VACATION. Even the on-board navigation system has a meltdown on Nate Johnson and his family's cross-country trek to their ...,29.0,Christopher Erskin,Johnson Family Vacation,2004,97,USA, 12000000,31203964,31326183,122219,19326183,1
42072,48.0,"Drama, Romance",A boy who has experienced many losses in his life grows to manhood and enters into a love triangle with a woman and his boyhood friend.,59.0,Michael Mayer,A Home at the End of the World,2004,97,USA, 6500000,1029872,1644653,614781,-4855347,0
42060,86.0,"Action, Horror, Sci-Fi","Blade, now a wanted man by the FBI, must join forces with the Nightstalkers to face his most challenging enemy yet: Dracula.",38.0,David S. Goyer,Blade: Trinity,2004,113,USA, 65000000,52411906,129241130,76829224,64241130,1
42033,117.0,"Comedy, Drama, Music","A romantic comedy where a bored, overworked Estate Lawyer, upon first sight of a beautiful instructor, signs up for ballroom dancing lessons.",47.0,Peter Chelsom,Shall We Dance,2004,106,USA, 50000000,57890460,170128460,112238000,120128460,1
42130,53.0,"Comedy, Drama, Romance",The daughter of the U.S. President heads off to college where she falls for a graduate student with a secret.,31.0,Forest Whitaker,First Daughter,2004,106,USA, 30000000,9055921,10592180,1536259,-19407820,0
43423,314.0,"Horror, Mystery, Thriller","Two strangers, who awaken in a room with no recollection of how they got there, soon discover they're pawns in a deadly game perpetrated by a notorious serial killer.",46.0,James Wan,Saw,2004,103,USA, 1200000,56000369,103911669,47911300,102711669,1
42248,198.0,"Drama, Mystery, Thriller",A successful writer in the midst of a painful divorce is stalked at his remote lake house by a would-be scribe who accuses him of plagiarism.,46.0,David Koepp,Secret Window,2004,96,USA, 40000000,48022900,92913171,44890271,52913171,1
42546,308.0,"Crime, Drama, Thriller",A cab driver finds himself the hostage of an engaging contract killer as he makes his rounds from hit to hit during one night in Los Angeles.,71.0,Michael Mann,Collateral,2004,120,USA, 65000000,101005703,217663246,116657543,152663246,1
42533,54.0,"Comedy, Family, Romance","Four best friends, desperate to improve their social status, enter into an all-night scavenger hunt against the popular clique in their school.",33.0,Joe Nussbaum,Sleepover,2004,89,USA, 10000000,9436390,9784050,347660,-215950,0
42530,77.0,"Comedy, Family, Romance","Now settled in Genovia, Princess Mia faces a new revelation: she is being primed for an arranged marriage to an English suitor.",43.0,Garry Marshall,The Princess Diaries 2: Royal Engagement,2004,113,USA, 40000000,95170481,134734481,39564000,94734481,1
42524,195.0,"Action, Adventure, Mystery",A historian races to find the legendary Templar Treasure before a team of mercenaries.,39.0,Jon Turteltaub,National Treasure,2004,131,USA, 100000000,173008894,347512318,174503424,247512318,1
42493,281.0,"Drama, Mystery, Thriller",A series of events tests the beliefs of a small isolated countryside village.,44.0,M. Night Shyamalan,The Village,2004,108,USA, 60000000,114197520,256697520,142500000,196697520,1
42593,127.0,"Comedy, Drama, Romance","A woman and her daughter emigrate from Mexico for a better life in America, where they start working for a family where the patriarch is a newly celebrated chef with an insecure wife.",48.0,James L. Brooks,Spanglish,2004,131,USA, 80000000,42726869,55041367,12314498,-24958633,0
42883,117.0,"Action, Adventure, Drama",Survivors of a plane crash in the Mongolian desert work together to build a new plane.,47.0,John Moore,Flight of the Phoenix,2004,113,USA, 45000000,21009180,34586268,13577088,-10413732,0
42869,49.0,"Comedy, Drama, Mystery",The discovery of a corpse threatens to unravel a bumbling local politician's campaign for governor of Colorado.,47.0,John Sayles,Silver City,2004,128,USA, 5000000,1020656,1384395,363739,-3615605,0
43478,112.0,"Comedy, Family","With their daughter away, the Kranks decide to skip Christmas altogether until she decides to come home, causing an uproar when they have to celebrate the holiday at the last minute.",22.0,Joe Roth,Christmas with the Kranks,2004,99,USA, 60000000,73780539,96593018,22812479,36593018,1
42892,121.0,"Crime, Drama","When a teen is bullied, his brother and friends lure the bully into the woods to seek revenge.",74.0,Jacob Estes,Mean Creek,2004,90,USA, 500000,603951,802948,198997,302948,1
42941,317.0,"Action, Crime, Thriller","The Bride continues her quest of vengeance against her former boss and lover Bill, the reclusive bouncer Budd, and the treacherous, one-eyed Elle.",83.0,Quentin Tarantino,Kill Bill: Vol. 2,2004,137,USA, 30000000,66208183,152159461,85951278,122159461,1
42476,44.0,"Drama, Mystery, Thriller","Sophie Jacobs is going through the most difficult time of her life. Now, she just has to find out if it's real.",47.0,Greg Harrison,November,2004,73,USA, 1500000,192186,192186,0,-1307814,0
42471,214.0,"Drama, Mystery, Sci-Fi","In the midst of the Gulf War, soldiers are kidnapped and brainwashed for sinister purposes.",76.0,Jonathan Demme,The Manchurian Candidate,2004,129,USA, 80000000,65955630,96105910,30150280,16105910,1
42249,144.0,"Crime, Mystery, Thriller",An FBI profiler is called in by French Canadian police to catch a serial killer who takes on the identity of each new victim.,38.0,D.J. Caruso,Taking Lives,2004,103,USA, 45000000,32682342,65470529,32788187,20470529,1
42286,145.0,"Comedy, Sport",A group of misfits enter a Las Vegas dodgeball tournament in order to save their cherished local gym from the onslaught of a corporate health fitness chain.,55.0,Rawson Marshall Thurber,Dodgeball: A True Underdog Story,2004,92,USA, 20000000,114326736,167722310,53395574,147722310,1
43923,19.0,"Comedy, Drama","A high school baseball coach (Krumholtz) and a down-on-his-luck private investigator (Burns) form a bond as they scour New York City for the coach's wife, who's run away with a second-rate ...",43.0,Edward Burns,Looking for Kitty,2004,95,USA, 250000,4480,4480,0,-245520,0
42303,85.0,Comedy,"An uptight, middle-aged, repressed woman turns into a sex addict after getting hit on the head, and she then falls into an underground subculture of sex addicts in suburban Baltimore.",56.0,John Waters,A Dirty Shame,2004,89,USA, 15000000,1339668,1808166,468498,-13191834,0
42642,40.0,"Comedy, Drama","By working through problems stemming from his past, Tom Warshaw, an American artist living in Paris, begins to discover who he really is, and returns to his home to reconcile with his family and friends.",33.0,David Duchovny,House of D,2004,97,USA, 6000000,388532,389866,1334,-5610134,0
43122,71.0,"Comedy, Crime",Two disgraced FBI agents go way undercover in an effort to protect hotel heiresses the Wilson Sisters from a kidnapping plot.,41.0,Keenen Ivory Wayans,White Chicks,2004,109,USA, 37000000,70831760,113086475,42254715,76086475,1
43461,63.0,"Crime, Horror, Mystery","It's ten years after the kidnapping of Martin Bristol. Taken from a backyard swing at his home at the age of six, he is forced to witness unspeakable crimes of a deranged madman. For years, Martin's whereabouts have remained a mystery...until now.",43.0,Stevan Mena,Malevolence,2004,90,USA, 200000,127287,258782,131495,58782,1
42352,56.0,"Drama, Music","In order to achieve their dream of opening a recording studio, two friends (Omarion, Houston) must first win their city's dance contest -- a fierce competition that pits them against a group of tough street dancers.",37.0,Chris Stokes,You Got Served,2004,95,USA, 8000000,40363810,48631561,8267751,40631561,1
42356,48.0,"Action, Adventure, Horror","A scientific expedition sets out for Borneo to seek a flower called the Blood Orchid, which could grant longer life. Meanwhile, they run afoul of snakes and each other.",40.0,Dwight H. Little,Anacondas: The Hunt for the Blood Orchid,2004,97,USA, 20000000,32238923,70992898,38753975,50992898,1
42366,12.0,"Drama, Mystery, Romance","An aging trainer and a young fighter, both in need of a second chance, team-up to overcome the demons of their past...and chase the dreams of their future.",53.0,Eddie O'Flaherty,Fighting Tommy Riley,2004,109,USA, 300000,10514,10514,0,-289486,0
42421,72.0,Comedy,"Things get raucously funny aboard the maiden flight of a black-owned airline, thanks to some last-minute passenger additions.",33.0,Jessy Terrero,Soul Plane,2004,86,USA, 16000000,14190750,14821824,631074,-1178176,0
42445,118.0,"Action, Comedy, Crime","The story of what happens after a master thief achieves his last big score, when the F.B.I. Agent who promised he'd capture him, is about to do just that.",38.0,Brett Ratner,After the Sunset,2004,97,USA, 60000000,28331233,61347797,33016564,1347797,1
42455,51.0,"Action, Comedy, Romance","Plaid-skirted schoolgirls are groomed by a secret government agency to become the newest members of the elite national-defense group, D.E.B.S.",42.0,Angela Robinson,D.E.B.S.,2004,91,USA, 3500000,97446,97446,0,-3402554,0
44499,6.0,Comedy,"Two real-life lesbian actresses meet by chance when they are cast as lovers in a local stage play, and end up actually falling in love.",37.0,Lee Friedlander,Girl Play,2004,80,USA, 1000000,11523,11523,0,-988477,0
43305,139.0,"Comedy, Drama, Romance",A middle-aged ad exec is faced with a new boss who's nearly half his age... and who also happens to be sleeping with his daughter.,66.0,Paul Weitz,In Good Company,2004,109,USA, 26000000,45806659,61315215,15508556,35315215,1
40565,316.0,"Action, Adventure, Sci-Fi",Peter Parker is beset with troubles in his failing personal life as he battles a brilliant scientist named Doctor Otto Octavius.,83.0,Sam Raimi,Spider-Man 2,2004,127,USA, 200000000,373585825,783766341,410180516,583766341,1
40861,100.0,"Drama, Mystery, Romance","A young Chicago advertising executive believes a woman he sees in a caf√© is his long-lost love. His belief leads to obsession, as he puts his life on hold in order to trail her.",40.0,Paul McGuigan,Wicker Park,2004,114,USA, 30000000,13001257,21741598,8740341,-8258402,0
41818,124.0,"Action, Crime","A former U.S. soldier returns to his hometown to find it overrun by crime and corruption, which prompts him to clean house.",44.0,Kevin Bray,Walking Tall,2004,86,USA, 46000000,46437717,57223890,10786173,11223890,1
40949,81.0,Comedy,A man becomes increasingly jealous of his friend's newfound success.,31.0,Barry Levinson,Envy,2004,99,USA, 40000000,13562325,14494036,931711,-25505964,0
40968,173.0,"Comedy, Horror, Sci-Fi",The secret to a Stepford wife lies behind the doors of the Men's Association of how women become different and immobilized robots.,42.0,Frank Oz,The Stepford Wives,2004,93,USA, 90000000,59484742,101297248,41812506,11297248,1
40975,74.0,"Comedy, Crime, Thriller","Jimmy the Tulip's (Willis) quiet new life is shaken up by his old pal Oz (Perry), whose wife (Henstridge) has been kidnapped by a Hungarian mob. The Tulip and his wife Jill (Peet) spring into action.",24.0,Howard Deutch,The Whole Ten Yards,2004,98,USA, 40000000,16328471,25449487,9121016,-14550513,0
40986,126.0,"Action, Crime, Fantasy","A shy woman, endowed with the speed, reflexes, and senses of a cat, walks a thin line between criminal and hero, even as a detective doggedly pursues her, fascinated by both of her personas.",27.0,Pitof,Catwoman,2004,104,USA, 100000000,40202379,82102379,41900000,-17897621,0
41080,86.0,"Action, Comedy, Crime",A biker returns from Thailand to set things straight with his girlfriend. One gang leader wants him for delivery of 2 motorbikes filled with crystal meth and another gang leader wants him for murdering his brother.,41.0,Joseph Kahn,Torque,2004,84,USA, 40000000,21215059,46546197,25331138,6546197,1
40684,247.0,"Action, Adventure, Sci-Fi","Jack Hall, paleoclimatologist, must make a daring trek from Washington, D.C. to New York City to reach his son, trapped in the cross-hairs of a sudden international storm which plunges the planet into a new Ice Age.",47.0,Roland Emmerich,The Day After Tomorrow,2004,124,USA, 125000000,186740799,542771772,356030973,417771772,1
41185,178.0,"Drama, Romance","A poor yet passionate young man falls in love with a rich young woman, giving her a sense of freedom, but they are soon separated because of their social differences.",53.0,Nick Cassavetes,The Notebook,2004,123,USA, 29000000,81001787,115533700,34531913,86533700,1
41220,215.0,"Comedy, Drama, Romance",A quietly troubled young man returns home for his mother's funeral after being estranged from his family for a decade.,67.0,Zach Braff,Garden State,2004,102,USA, 2500000,26782316,35825316,9043000,33325316,1
41247,194.0,"Comedy, Crime, Thriller","An eccentric, if not charming Southern professor and his crew pose as a classical ensemble in order to rob a casino, all under the nose of his unsuspecting but sharp old landlady.",56.0,"Ethan Coen, Joel Coen",The Ladykillers,2004,104,USA, 35000000,39799191,76665191,36866000,41665191,1
41251,395.0,Drama,"Depicts the final twelve hours in the life of Jesus of Nazareth, on the day of his crucifixion in Jerusalem.",47.0,Mel Gibson,The Passion of the Christ,2004,127,USA, 30000000,370782930,610061517,239278587,580061517,1
41255,178.0,"Comedy, Crime","Two streetwise cops bust criminals in their red and white Ford Gran Torino, with the help of a police snitch called ""Huggy Bear"".",55.0,Todd Phillips,Starsky & Hutch,2004,101,USA, 60000000,88237754,170268750,82030996,110268750,1
41256,83.0,"Comedy, Romance","A small-town girl wins a date with a male celebrity through a contest. When the date goes better than expected, a love triangle forms between the girl, the male celebrity, and the girl's best friend.",52.0,Robert Luketic,Win a Date with Tad Hamilton!,2004,95,USA, 22000000,17071962,20862484,3790522,-1137516,0
41274,78.0,"Comedy, Fantasy, Romance","A girl makes a wish on her thirteenth birthday, and wakes up the next day as a thirty-year-old woman.",57.0,Gary Winick,13 Going on 30,2004,98,USA, 37000000,57231747,96455697,39223950,59455697,1
41204,32.0,Comedy,"A trio of young men (Griffin, Anderson, and Imperioli) are forced to grow up quick when their girlfriends all become pregnant around the same time.",23.0,Cheryl Dunye,My Baby's Daddy,2004,86,USA, 12000000,17669317,18364273,694956,6364273,1
40674,100.0,"Drama, History, War","Based on the 1836 standoff between a group of Texan and Tejano men, led by Davy Crockett and Jim Bowie, and Mexican dictator Santa Anna's forces at the Alamo in San Antonio Texas.",47.0,John Lee Hancock,The Alamo,2004,137,USA, 107000000,22414961,25819961,3405000,-81180039,0
40616,295.0,"Animation, Action, Adventure","A family of undercover superheroes, while trying to live the quiet suburban life, are forced into action to save the world.",90.0,Brad Bird,The Incredibles,2004,115,USA, 92000000,261441092,631606713,370165621,539606713,1
36939,16.0,Thriller,Tom (Speedman) and Dan's (Marsden) one-night stand turns into an intense power-play between captor and captive.,29.0,Tony Piccirillo,The 24th Day,2004,92,USA, 1000000,14460,14460,0,-985540,0
35192,171.0,"Horror, Mystery, Thriller","Years before Father Lankester Merrin helped save Regan MacNeil's soul, he first encounters the demon Pazuzu in East Africa. This is the tale of Father Merrin's initial battle with Pazuzu and the rediscovery of his faith.",30.0,Renny Harlin,Exorcist: The Beginning,2004,114,USA, 80000000,41821986,76899937,35077951,-3100063,0
37247,86.0,"Comedy, Romance","A lonely, obnoxious young millionaire pays a family to spend Christmas with him.",19.0,Mike Mitchell,Surviving Christmas,2004,91,USA, 45000000,11663156,14614892,2951736,-30385108,0
45187,16.0,Drama,"Peter, a married psychotherapist, and Suzanne, a professional dominatrix, have been engaged in an affair of sensual dominance and submission in an S&M dungeon where they must abide by the ...",37.0,Eric Werthman,Going Under,2004,98,USA, 50000,3917,3917,0,-46083,0
37929,121.0,"Comedy, Drama, Romance",A teenager's dreams come true when a former porn star moves in next door and they fall in love.,47.0,Luke Greenfield,The Girl Next Door,2004,109,USA, 25000000,14589444,30381722,15792278,5381722,1
33188,236.0,"Action, Adventure, Fantasy","A demon, raised from infancy after being conjured by and rescued from the Nazis, grows up to become a defender against the forces of darkness.",72.0,Guillermo del Toro,Hellboy,2004,122,USA, 66000000,59623958,99378985,39755027,33378985,1
39308,135.0,"Comedy, Romance",All hell breaks loose when the Byrnes family meets the Focker family for the first time.,41.0,Jay Roach,Meet the Fockers,2004,115,USA, 80000000,279261160,514837517,235576357,434837517,1
39683,210.0,"Action, Adventure, Sci-Fi","The wanted criminal Riddick arrives on a planet called Helion Prime, and finds himself up against an invading empire called the Necromongers, an army that plans to convert or kill all humans in the universe.",38.0,David Twohy,The Chronicles of Riddick,2004,119,USA, 105000000,57761012,115772733,58011721,10772733,1
39767,214.0,"Animation, Adventure, Comedy",Princess Fiona's parents invite her and Shrek to dinner to celebrate her marriage. If only they knew the newlyweds were both ogres.,75.0,"Andrew Adamson, Kelly Asbury",Shrek 2,2004,93,USA, 150000000,441226247,923075336,481849089,773075336,1
39820,99.0,"Animation, Adventure, Comedy","To save their farm, the resident animals go bounty hunting for a notorious outlaw.",50.0,"Will Finn, John Sanford",Home on the Range,2004,76,USA, 110000000,50030461,103951461,53921000,-6048539,0
39853,121.0,"Comedy, Drama, Romance","After his career is sidelined by an unexpected tragedy and a personal blow-up, a single man must take care of his precocious daughter.",43.0,Kevin Smith,Jersey Girl,2004,102,USA, 35000000,25268157,35492921,10224764,492921,1
40174,146.0,"Animation, Adventure, Comedy","When a son of a gangster shark boss is accidentally killed while on the hunt, his would-be prey and his vegetarian brother decide to use the incident to their own advantage.",48.0,"Bibo Bergeron, Vicky Jenson",Shark Tale,2004,90,USA, 75000000,160861908,363530196,202668288,288530196,1
40532,76.0,"Comedy, Crime","A small-time con artist and a Hawaiian real estate developer's mischevious, enterprising mistress team up for a potential $200,000 score.",42.0,George Armitage,The Big Bounce,2004,88,USA, 50000000,6489476,6801716,312240,-43198284,0
41277,54.0,"Comedy, Drama","The owner of an historic South Side Chicago barbershop is pressured to sell out to a land developer, but must face the impact this would have on his close-knit community.",59.0,Kevin Rodney Sullivan,Barbershop 2: Back in Business,2004,106,USA, 30000000,65111277,65991448,880171,35991448,1
41331,287.0,"Drama, Romance, Sci-Fi","When their relationship turns sour, a couple undergoes a medical procedure to have each other erased from their memories.",89.0,Michel Gondry,Eternal Sunshine of the Spotless Mind,2004,108,USA, 20000000,34400301,72258126,37857825,52258126,1
43574,128.0,"Drama, Sci-Fi, Thriller","Four friends/fledgling entrepreneurs, knowing that there's something bigger and more innovative than the different error-checking devices they've built, wrestle over their new invention.",68.0,Shane Carruth,Primer,2004,77,USA, 7000,424760,545436,120676,538436,1
41721,144.0,"Comedy, Drama",A writer's young assistant becomes both pawn and catalyst in his boss's disintegrating household.,67.0,Tod Williams,The Door in the Floor,2004,111,USA, 7500000,3854624,6715067,2860443,-784933,0
41576,149.0,"Comedy, Drama, Romance","Henry Roth is a man afraid of commitment up until he meets the beautiful Lucy. They hit it off and Henry think he's finally found the girl of his dreams, until he discovers she has short-term memory loss and forgets him the next day.",48.0,Peter Segal,50 First Dates,2004,99,USA, 75000000,120908074,196482882,75574808,121482882,1
41773,210.0,"Crime, Thriller",Daniel Ocean recruits one more team member so he can pull off three major European heists in this sequel to Ocean's 11.,58.0,Steven Soderbergh,Ocean's Twelve,2004,125,USA, 110000000,125544280,362744280,237200000,252744280,1
41744,38.0,"Comedy, Romance","Inspired by his fianc√©e (who dumped him), a man publishes a break-up hand-book for men, becoming a best-selling author in the process.",46.0,Daniel Taplitz,Breakin' All the Rules,2004,85,USA, 10000000,12264319,12544254,279935,2544254,1
41764,114.0,"Drama, Thriller","A firefighter, injured and trapped in a burning building, has flashbacks of his life as he drifts in and out of consciousness. Meanwhile, fellow firefighters led by the Chief attempt to rescue him.",47.0,Jay Russell,Ladder 49,2004,115,USA, 55000000,74541707,100572044,26030337,45572044,1
41565,56.0,"Comedy, Romance",A buttoned up newlywed finds his too organized life falling into chaos when he falls in love with an old classmate.,44.0,John Hamburg,Along Came Polly,2004,90,USA, 42000000,88097164,171171424,83074260,129171424,1
41604,65.0,"Comedy, Crime, Music","A mob mix-up in Chicago sends two chanteuses screaming for L.A., where they score a perfect gig: posing as drag queens on the dinner theater/cabaret circuit. Things get extra-weird when a guy falls for one of the girls.",44.0,Michael Lembeck,Connie and Carla,2004,108,USA, 27000000,8085771,11341016,3255245,-15658984,0
41623,86.0,"Animation, Adventure, Comedy",SpongeBob SquarePants takes leave from the town of Bikini Bottom in order to track down King Neptune's stolen crown.,66.0,"Stephen Hillenburg, Mark Osborne",The SpongeBob SquarePants Movie,2004,87,USA, 30000000,85417988,141035926,55617938,111035926,1
41776,93.0,"Comedy, Drama, Romance","After her sister and brother-in-law die in a car accident, a young woman becomes the guardian of their three children.",38.0,Garry Marshall,Raising Helen,2004,119,USA, 50000000,37486512,49718611,12232099,-281389,0
41674,24.0,Comedy,The satirical journey of two guys in Los Angeles making their film as they go through the twisted world that is: Hollywood.,29.0,Sven Pape,L.A. Twister,2004,92,USA, 450000,54000,54000,0,-396000,0
41341,70.0,"Drama, Music, Romance","High school senior Katey moves to Havana in November 1958, when her dad gets a promotion at Ford. She meets a local waiter, who introduces her to sensual Cuban music/dance. They enter a big dance contest for the prize when he gets fired.",39.0,Guy Ferland,Dirty Dancing: Havana Nights,2004,86,USA, 25000000,14161590,27685016,13523426,2685016,1
41430,65.0,"Comedy, Drama, Romance","Aging baseball star who goes by the nickname, Mr. 3000, finds out many years after retirement that he didn't quite reach 3,000 hits. Now at age 47 he's back to try and reach that goal.",57.0,Charles Stone III,Mr 3000,2004,104,USA, 30000000,21811187,21839377,28190,-8160623,0
41357,179.0,"Animation, Adventure, Comedy","On Christmas Eve, a young boy embarks on a magical adventure to the North Pole on the Polar Express, while learning about friendship, bravery, and the spirit of Christmas.",61.0,Robert Zemeckis,The Polar Express,2004,100,USA, 165000000,187224490,313500433,126275943,148500433,1
41787,196.0,"Biography, Drama, Music",The story of the life and career of the legendary rhythm and blues musician,73.0,Taylor Hackford,Ray,2004,152,USA, 40000000,75331600,123971376,48639776,83971376,1
41355,72.0,"Action, Crime, Drama",A rising Hollywood actor decides to take personal revenge against a group of four persistent photographers to make them pay for almost causing a personal tragedy involving his wife and son.,38.0,Paul Abascal,Paparazzi,2004,84,USA, 20000000,15714234,16796512,1082278,-3203488,0
41784,33.0,"Animation, Adventure, Comedy","Spot (Lane) is a dog who can talk and read. Posing as a human, he sneaks into school with his master Leonard (Flemming). Educational adventures ensue.",74.0,Timothy Bj√∂rklund,Teacher's Pet,2004,73,USA, 10000000,6491969,6491969,0,-3508031,0
43909,2.0,"Comedy, Drama","A young artist (Peter Paige), desperate to replace the relationship he had with his recently relocated godson, is targeted by a neighborhood mom (Kathy Najimy) as a potential threat to the community.",31.0,Peter Paige,Say Uncle,2005,91,USA, 650000,5361,5361,0,-644639,0
45392,40.0,"Comedy, Drama, Romance",Josh Sagers drives cross-country on a mission to deliver his father's birthday gift - a giant purple LazyBoy.,73.0,"Jay Duplass, Mark Duplass",The Puffy Chair,2005,85,USA, 15000,194523,195254,731,180254,1
43876,117.0,"Comedy, Crime, Drama","A shady lawyer attempts a Christmas Eve crime, hoping to swindle the local mob out of some money. But his partner, a strip club owner, might have different plans for the cash.",62.0,Harold Ramis,The Ice Harvest,2005,92,USA, 16000000,9016782,10156968,1140186,-5843032,0
43922,7.0,"Comedy, Drama","Giorgio's Lobster Farm has been a tradition in Brooklyn for over 65 years. Manned by an eccentric crew and serving the best seafood in the state, the renowned establishment now faces grave ...",55.0,Kevin Jordan,Brooklyn Lobster,2005,94,USA, 200000,138267,138267,0,-61733,0
43952,18.0,"Comedy, Drama, Romance",The Great New Wonderful weaves five stories against the backdrop of an anxious and uncertain post-9-11 New York City.,57.0,Danny Leiner,The Great New Wonderful,2005,87,USA, 500000,150142,193968,43826,-306032,0
43930,380.0,"Crime, Thriller","A film that explores the dark and miserable town, Basin City, and tells the story of three different people, all caught up in violent corruption.",74.0,"Frank Miller, Robert Rodriguez",Sin City,2005,124,USA, 40000000,74103820,158733820,84630000,118733820,1
45946,24.0,"Drama, Music","This is a story about a successful young R&B singer that has an unlikely homecoming when his father, the bishop, becomes ill.",46.0,Rob Hardy,The Gospel,2005,105,USA, 4000000,15778152,15778152,0,11778152,1
43873,118.0,"Adventure, Comedy, Family","Maggie Peyton, the new owner of Herbie, Number 53, the free-wheelin' Volkswagen bug with a mind of its own, puts the car through its paces on the road to becoming a NASCAR competitor.",47.0,Angela Robinson,Herbie Fully Loaded,2005,101,USA, 50000000,66023816,144146816,78123000,94146816,1
43980,40.0,"Action, Drama, Romance","Faced with the suspicious death of their father, two brothers must motivate one another to get back on their bikes and take the Las Vegas Motocross Championships by storm.",26.0,Steve Boyum,Supercross,2005,80,USA, 16000000,3102550,3344431,241881,-12655569,0
44006,90.0,"Comedy, Drama, Romance",Four best girlfriends hatch a plan to stay connected with one another as their lives start off in different directions: they pass around a pair of secondhand jeans that fits each of their bodies perfectly.,66.0,Ken Kwapis,The Sisterhood of the Traveling Pants,2005,119,USA, 25000000,39053061,42013878,2960817,17013878,1
44027,98.0,"Comedy, Drama","A young Jewish American man endeavors to find the woman who saved his grandfather during World War II in a Ukrainian village, that was ultimately razed by the Nazis, with the help of an eccentric local.",58.0,Liev Schreiber,Everything Is Illuminated,2005,106,USA, 7000000,1712337,3601974,1889637,-3398026,0
45054,42.0,"Drama, Romance","In 1920, Inge, a German national, travels from Norway to rural Minnesota for her arranged marriage to Olaf, a Norwegian farmer; bureaucracy and prejudice cause major complications.",75.0,Ali Selim,Sweet Land,2005,110,USA, 1000000,1706325,1843537,137212,843537,1
43849,49.0,"Adventure, Biography, Drama",Two people come to the end of a spear in order to realize that the divisions between them are not real.,45.0,Jim Hanon,End of the Spear,2005,108,USA, 10000000,11967000,12128105,161105,2128105,1
44913,115.0,"Comedy, Drama, Fantasy",A lonely landscape architect falls for the spirit of the beautiful woman who used to live in his new apartment.,47.0,Mark Waters,Just Like Heaven,2005,95,USA, 58000000,48318130,102854431,54536301,44854431,1
45645,144.0,"Animation, Comedy, Crime","Little Red Riding Hood, the Wolf, the Woodsman, and Granny all tell the police the events that led up to their encounter.",45.0,"Cory Edwards, Todd Edwards",Hoodwinked!,2005,80,USA, 30000000,61530390,133791324,72260934,103791324,1
45264,74.0,Comedy,"To improve its relations with Muslim countries, the United States government sends comedian Albert Brooks to south Asia to write a report on what makes followers of Islam laugh.",53.0,Albert Brooks,Looking for Comedy in the Muslim World,2005,98,USA, 10000000,888975,915649,26674,-9084351,0
43599,112.0,"Comedy, Drama, Romance",Unaquainted Emily and Oliver join the mile high club together on the way from LAX to NYC - end of story except they meet on and off the next 7 years. Are they meant for each other?,48.0,Nigel Cole,A Lot Like Love,2005,107,USA, 30000000,21845719,42886719,21041000,12886719,1
44743,219.0,"Action, Mystery, Thriller","A woman is kidnapped by a stranger on a routine flight. Threatened by the potential murder of her father, she is pulled into a plot to assist her captor in offing a politician.",71.0,Wes Craven,Red Eye,2005,85,USA, 26000000,57891803,95577774,37685971,69577774,1
43631,252.0,"Action, Crime, Drama",A teenage loner pushes his way into the underworld of a high school crime ring to investigate the disappearance of his ex-girlfriend.,72.0,Rian Johnson,Brick,2005,110,USA, 475000,2075743,3947579,1871836,3472579,1
43664,162.0,"Comedy, Musical","After putting together another Broadway flop, down-on-his-luck Producer Max Bialystock teams up with timid accountant Leo Bloom in a get-rich-quick scheme to put on the world's worst show.",52.0,Susan Stroman,The Producers,2005,134,USA, 45000000,19398532,38058335,18659803,-6941665,0
43675,40.0,"Drama, Music, Romance",A Russian woman living in Memphis with a much older rock-'n'-roll legend experiences a personal awakening when her husband's estranged son comes to visit.,74.0,Ira Sachs,Forty Shades of Blue,2005,108,USA, 1500000,75828,172569,96741,-1327431,0
43693,157.0,Drama,"A fictionalized account of the first major successful sexual harassment case in the United States, Jenson vs. Eveleth Mines, where a woman who endured a range of abuse while working as a miner filed and won the landmark 1984 lawsuit.",68.0,Niki Caro,North Country,2005,126,USA, 35000000,18337722,25211175,6873453,-9788825,0
44733,13.0,"Comedy, Romance","In this provocative teen comedy, Luke, a young man insecure about his masculinity discovers he's a Zerophiliac, with the ability to change sex at will. Join Luke as he journeys into the ...",41.0,Martin Curland,Zerophilia,2005,90,USA, 450000,7763,7763,0,-442237,0
45863,82.0,"Drama, Horror, Thriller","Years before Father Lankester Merrin helped save Regan MacNeil's soul, he first encounters the demon Pazuzu in East Africa. Merrin's initial battle with Pazuzu leads to the rediscovery of his faith.",55.0,Paul Schrader,Dominion: Prequel to the Exorcist,2005,117,USA, 30000000,251495,251495,0,-29748505,0
43708,183.0,"Comedy, Romance","John Beckwith and Jeremy Grey, a pair of committed womanizers who sneak into weddings to take advantage of the romantic tinge in the air, find themselves at odds with one another when John meets and falls for Claire Cleary.",64.0,David Dobkin,Wedding Crashers,2005,119,USA, 40000000,209255921,285176741,75920820,245176741,1
45272,118.0,"Action, Crime, Drama",A tough-minded drama about two friends in South Central Los Angeles and the violence that comes between them.,56.0,David Ayer,Harsh Times,2005,116,USA, 2000000,3337931,5969708,2631777,3969708,1
44029,243.0,"Drama, Horror, Thriller",A lawyer takes on a negligent homicide case involving a priest who performed an exorcism on a young girl.,46.0,Scott Derrickson,The Exorcism of Emily Rose,2005,119,USA, 19000000,75072454,144216468,69144014,125216468,1
43788,138.0,"Comedy, Crime, Sport",Prison inmates form a football team to challenge the prison guards.,48.0,Peter Segal,The Longest Yard,2005,113,USA, 82000000,158119460,190320568,32201108,108320568,1
45137,127.0,"Action, Crime, Drama",When their adopted mother is gunned down in a store robbery the 'four brothers' investigated the murder for themselves & look for the killers but not all is what it seems.,49.0,John Singleton,Four Brothers,2005,109,USA, 45000000,74494381,92374674,17880293,47374674,1
43827,262.0,"Action, Sci-Fi, Thriller","A man living in a futuristic sterile colony begins to question his circumscribed existence when his friend is chosen to go to the Island, the last uncontaminated place on earth.",50.0,Michael Bay,The Island,2005,136,USA, 126000000,35818913,162949164,127130251,36949164,1
43782,69.0,"Drama, Romance, Thriller","Set in the present-day San Fernando Valley, the project revolves around a delusional man who believes he's a cowboy and the relationship that he starts with a rebellious young woman.",65.0,David Jacobson,Down in the Valley,2005,108,USA, 8000000,568932,855009,286077,-7144991,0
44070,135.0,"Adventure, Comedy, Family","Set in an era where superheroes are commonly known and accepted, young William Stronghold, the son of the Commander and Jetstream, tries to find a balance between being a normal teenager and an extraordinary being.",62.0,Mike Mitchell,Sky High,2005,100,USA, 35000000,63946815,86369815,22423000,51369815,1
45636,87.0,"Drama, Thriller",A fortune-tellers teasing rumination sends Edmond Burke lurching into New York City's hellish underworld.,61.0,Stuart Gordon,Edmond,2005,82,USA, 10000000,131719,243524,111805,-9756476,0
44854,241.0,"Drama, Thriller",A teenage girl raids a man's home in order to expose him under suspicion that he is a pedophile.,58.0,David Slade,Hard Candy,2005,104,USA, 950000,1024640,7022209,5997569,6072209,1
44989,136.0,"Action, Comedy, Horror",Patrons locked inside a bar are forced to fight monsters.,43.0,John Gulager,Feast,2005,95,USA, 3200000,56131,719135,663004,-2480865,0
44955,31.0,"Drama, Thriller","Against the anxieties and fears of post-9/11 America, an Arab cab driver picks up a troubled professional woman with unexpected results.",43.0,Jeff Stanzler,"Sorry, Haters",2005,83,USA, 200000,7129,7129,0,-192871,0
45618,74.0,"Comedy, Family, Fantasy","A widowed Coast Guard Admiral and a widow handbag designer fall in love and marry, much to the dismay of her 10 and his 8 children.",38.0,Raja Gosnell,"Yours, Mine & Ours",2005,88,USA, 45000000,53412862,72028752,18615890,27028752,1
44590,75.0,"Drama, Family, Sport","Cale Crane catalyzes the rescue and rehabilitation of Sonador, a race horse with a broken leg.",59.0,John Gatins,Dreamer: Inspired by a True Story,2005,106,USA, 32000000,32751093,38741732,5990639,6741732,1
45478,34.0,"Comedy, Romance","A romantic comedy about our amazing capacity to rebound and fall in love at any age. Lois, Harry, Marilyn ,Sandy and Jack live in an ""Active Adult"" community in Boynton Beach, Florida. ...",61.0,Susan Seidelman,The Boynton Beach Bereavement Club,2005,105,USA, 1500000,3127472,3572758,445286,2072758,1
46045,14.0,Comedy,Shawn is the founder of the Mesa Frozen Entree Enthusiasts Club. He has inspired this group of fanatical collectors to attempt to host the world's first Frozen Entree Enthusiasts Convention...,41.0,Sean Anders,Never Been Thawed,2005,87,USA, 35000,47219,47219,0,12219,1
45484,20.0,"Crime, Drama, Thriller",Two gangbangers-turned-cops try and cover up a scandal within the LAPD.,37.0,Chris Fisher,Dirty,2005,97,USA, 3000000,274245,274245,0,-2725755,0
44399,58.0,"Crime, Drama, Thriller","Following the unexpected death of her father, a deaf and mute teenager moves in with her godparents, where she discovers the cruel behavior of their daughter may be indicative of a dark secret within the family.",29.0,Jamie Babbit,The Quiet,2005,96,USA, 900000,381420,381420,0,-518580,0
44878,68.0,"Action, Adventure, Comedy",A young boy is recruited by his imaginary friends Sharkboy and Lavagirl to help save their planet.,38.0,Robert Rodriguez,The Adventures of Sharkboy and Lavagirl 3-D,2005,93,USA, 50000000,39177684,69425966,30248282,19425966,1
44534,62.0,Drama,"After his twin brother is accidentally killed by vengeful bullies, a 12-year old boy and his friends face the harsh realities of death, teenage hormones, and family dysfunction.",65.0,Michael Cuesta,12 and Holding,2005,94,USA, 400000,96464,119195,22731,-280805,0
44437,15.0,"Crime, Drama, Mystery","Robbie Levinson and Trey McCoy suddenly encounter intolerance and hostility at the hands of their new neighbor, Chris Boyd, the son of a fundamentalist preacher. One evening, Trey sets out ...",41.0,Tommy Stovall,Hate Crime,2005,103,USA, 500000,40758,40758,0,-459242,0
44903,33.0,"Comedy, Drama, Sport","Combining real and fictional events, this movie centers around the historic 1986 World Series, and a day in the life of a playwright who skips opening night to watch the momentous game.",56.0,Michael Hoffman,Game 6,2005,87,USA, 1000000,129664,129664,0,-870336,0
46127,106.0,"Crime, Drama, Mystery","Set against the backdrop of a decaying Midwestern town, a murder becomes the focal point of three people who work in a doll factory.",63.0,Steven Soderbergh,Bubble,2005,73,USA, 1600000,145626,260925,115299,-1339075,0
44527,109.0,"Drama, Sport, Thriller","After suffering a career-ending knee injury, a former college football star aligns himself with one of the most renowned touts in the sports-gambling business.",50.0,D.J. Caruso,Two for the Money,2005,122,USA, 35000000,22991379,30526509,7535130,-4473491,0
44515,120.0,"Comedy, Romance","A forty-something preschool teacher looks to the personals for a change of pace and a relationship, with hilarious results.",46.0,Gary David Goldberg,Must Love Dogs,2005,98,USA, 30000000,43894863,58231520,14336657,28231520,1
46288,13.0,"Comedy, Drama, Romance","The complex relationship between a wealthy French woman and her best friend a, gay black American, is thrown into turmoil when her estranged daughter comes to visit them with her new ...",64.0,John G. Young,The Reception,2005,80,USA, 5000,18389,18389,0,13389,1
45638,32.0,Comedy,"The story of Scotty Pelk, a socially inept video store clerk who gets fired from his job and becomes a sensation as an online film critic.",35.0,James Westby,Film Geek,2005,78,USA, 10000,17341,17341,0,7341,1
44242,147.0,"Crime, Drama, Music","With help from his friends, a Memphis pimp in a mid-life crisis attempts to become a successful hip-hop emcee.",68.0,Craig Brewer,Hustle & Flow,2005,116,USA, 2800000,22202809,23563727,1360918,20763727,1
44208,37.0,"Comedy, Drama, Musical",A widowed man's life turns upside down when he embarks on a journey to find a dying man's long lost love.,40.0,Randall Miller,Marilyn Hotchkiss' Ballroom Dancing & Charm School,2005,103,USA, 2500000,349132,410602,61470,-2089398,0
45397,14.0,"Comedy, Drama",A beauty-shop owner finds romance as she struggles to save her business.,26.0,Mark Brown,The Salon,2005,90,USA, 1500000,139084,139084,0,-1360916,0
45051,99.0,"Comedy, Drama, Romance","After much drama, cheating, and trial separations, two men fight to save their respective relationships.",43.0,Bart Freundlich,Trust the Man,2005,103,USA, 9000000,1530535,7353118,5822583,-1646882,0
44075,186.0,"Comedy, Romance","Goaded by his buddies, a nerdy guy who's never ""done the deed"" only finds the pressure mounting when he meets a single mother.",73.0,Judd Apatow,The 40 Year Old Virgin,2005,116,USA, 26000000,109449237,177378645,67929408,151378645,1
44092,27.0,"Horror, Thriller",Two teenage girls on a mission to find drugs at a rave get more than they bargained for. One is sexually assaulted and they are both tortured in horrific ways. The attackers seek refuge in the parents' of one of the victims' homes.,1.0,David DeFalco,Chaos,2005,74,USA, 1000000,10289,20166,9877,-979834,0
45048,241.0,"Comedy, Drama","Satirical comedy follows the machinations of Big Tobacco's chief spokesman, Nick Naylor, who spins on behalf of cigarettes while trying to remain a role model for his twelve-year-old son.",71.0,Jason Reitman,Thank You for Smoking,2005,92,USA, 6500000,24793509,39323027,14529518,32823027,1
44093,19.0,Drama,Three overlapping stories of estranged families in three regions of North Carolina.,62.0,Tim Kirkman,Loggerheads,2005,95,USA, 500000,115314,115314,0,-384686,0
44097,50.0,"Biography, Drama","In order to support her ten children, Evelyn Ryan enters a commercial jingle-writing contest.",58.0,Jane Anderson,"The Prize Winner of Defiance, Ohio",2005,99,USA, 12000000,627844,750212,122368,-11249788,0
44105,126.0,"Action, Adventure, Comedy",Two young brothers are drawn into an intergalactic adventure when their house is hurled through the depths of space by the magical board game they are playing.,67.0,Jon Favreau,Zathura: A Space Adventure,2005,101,USA, 65000000,29258869,64321501,35062632,-678499,0
45446,7.0,"Comedy, Drama, Romance",A young woman fumbles with love and ethics as she navigates a career with one of corporate America's darlings...the pharmaceutical industry.,46.0,Kathleen Slattery-Moschkau,Side Effects,2005,90,USA, 30000000,2216,2216,0,-29997784,0
44672,60.0,Drama,"Captives of the very relationships that define and sustain them, nine women resiliently meet the travails and disappointments of life.",80.0,Rodrigo Garc√≠a,Nine Lives,2005,115,USA, 500000,478830,1591523,1112693,1091523,1
44144,176.0,"Adventure, Comedy, Drama","A preoperative transgender woman takes an unexpected journey when she learns that she fathered a son, now a teenage runaway hustling on the streets of New York.",66.0,Duncan Tucker,Transamerica,2005,103,USA, 1000000,9015303,15151744,6136441,14151744,1
44147,409.0,"Adventure, Sci-Fi","As Earth is invaded by alien tripod fighting machines, one family fights for survival in this sci-fi action film.",73.0,Steven Spielberg,War of the Worlds,2005,116,USA, 132000000,234280354,591745532,357465178,459745532,1
44191,105.0,"Comedy, Sport",A grizzled little league coach tries to turn his team of misfits into champs.,65.0,Richard Linklater,Bad News Bears,2005,113,USA, 35000000,32868349,34252847,1384498,-747153,0
44195,226.0,"Drama, Mystery, Thriller","A bereaved woman and her daughter are flying home from Berlin to America. At 30,000 feet, the child vanishes, and nobody will admit she was ever on the plane.",53.0,Robert Schwentke,Flightplan,2005,98,USA, 55000000,89707299,223387299,133680000,168387299,1
44200,14.0,Comedy,A diverse group of high school students band together to peacefully stick it to their overbearing principal.,38.0,Josh Stolberg,Kids in America,2005,91,USA, 750000,537667,537667,0,-212333,0
44597,138.0,"Comedy, Drama","A dealer in ""outsider"" art travels from Chicago to North Carolina to meet her new in-laws, challenging the equilibrium of this middle class Southern home.",80.0,Phil Morrison,Junebug,2005,106,USA, 1000000,2678691,3399228,720537,2399228,1
44138,45.0,"Animation, Comedy, Family","A Heffalump is heard trumpeting in the hundred acre woods. Winnie the Pooh, Tigger, and Piglet are scared and rush to Rabbit's house for advice. Roo joins them and they all agree that ...",64.0,Frank Nissen,Pooh's Heffalump Movie,2005,68,USA, 20000000,18098433,52858433,34760000,32858433,1
44768,55.0,"Comedy, Drama, Romance",A couple's seemingly solid marriage begins to crumble when the wife discovers that her husband intends to divorce her.,36.0,Darren Grant,Diary of a Mad Black Woman,2005,116,USA, 5500000,50633099,50652203,19104,45152203,1
41516,39.0,"Biography, Drama",A pill-popping mom has her drug-abusing teen son abducted into a private intervention facility that means well.,51.0,Monty Lapica,Self Medicated,2005,107,USA, 400000,100610,100610,0,-299390,0
45242,145.0,Horror,"A thick mist full of vengeful spirits haunts a prosperous island town off the coast of Oregon, as its inhabitants try to learn their town's dark secret in order to stop it.",27.0,Rupert Wainwright,The Fog,2005,100,USA, 18000000,29550869,46201432,16650563,28201432,1
41450,16.0,"Comedy, Drama, Music","In small town Tennessee, a ne'er-do-well man (Knoxville) wrestling for control over his fading golf club is reunited with his estranged daughter, a 14-year-old musical prodigy.",30.0,Katrina Holden Bronson,Daltry Calhoun,2005,100,USA, 3000000,12551,12551,0,-2987449,0
42639,104.0,"Comedy, Romance","A young woman, Theresa, brings her boyfriend, Simon, home to meet her parents and surprise them with the news of their engagement. Another surprise: Simon is white.",49.0,Kevin Rodney Sullivan,Guess Who,2005,105,USA, 35000000,68915888,101866030,32950142,66866030,1
41352,16.0,"Comedy, Crime, Drama",A desperate man ventures into a dangerous and sordid underworld of crime and pornography in search of his severed genitalia which is held for ransom by his disgruntled former girlfriend.,41.0,Tim McCann,Nowhere Man,2005,78,USA, 250000,3105,3105,0,-246895,0
42690,33.0,"Action, Comedy, Crime",A young detective goes undercover at an elite private school to destroy an international stolen car ring.,19.0,Marcos Siega,Underclassman,2005,95,USA, 25000000,5655459,5758522,103063,-19241478,0
42693,240.0,"Action, Comedy, Crime","A murder mystery brings together a private eye, a struggling actress, and a thief masquerading as an actor.",72.0,Shane Black,Kiss Kiss Bang Bang,2005,103,USA, 15000000,4243756,15785148,11541392,785148,1
41173,60.0,"Comedy, Crime",A Texas Ranger must protect a group of cheerleaders who have witnessed a murder.,35.0,Stephen Herek,Man of the House,2005,100,USA, 40000000,19699706,21577624,1877918,-18422376,0
42762,170.0,"Comedy, Fantasy, Romance","Thinking he can overshadow an unknown actress in the part, an egocentric actor unknowingly gets a witch cast in an upcoming television remake of the classic sitcom",34.0,Nora Ephron,Bewitched,2005,102,USA, 85000000,63313159,131426169,68113010,46426169,1
42835,77.0,"Adventure, Comedy, Drama","An abandoned zebra grows up believing he is a racehorse, and, with the help of his barnyard friends and a teenage girl, sets out to achieve his dream of racing with thoroughbreds.",43.0,Frederik Du Chau,Racing Stripes,2005,102,USA, 30000000,49772522,90754475,40981953,60754475,1
42139,37.0,"Adventure, Drama, Family",An orphaned cheetah becomes the best friend and pet of a young boy living in South Africa.,82.0,Carroll Ballard,Duma,2005,100,USA, 12000000,870067,994790,124723,-11005210,0
41086,62.0,"Action, Adventure, Crime","Darius Stone, a new agent in the xXx program, is sent to Washington, D.C. to stop a coup attempt against the President of the United States.",37.0,Lee Tamahori,xXx: State of the Union,2005,101,USA, 60000000,26873932,71022693,44148761,11022693,1
42844,39.0,"Drama, Mystery, Thriller","A district attorney is involved in a 24-hour showdown with a gang leader and is, at the same time, being manipulated by an attractive assistant district attorney and a cryptic stranger.",34.0,Wayne Beach,Slow Burn,2005,93,USA, 15500000,1237615,1797256,559641,-13702744,0
42895,135.0,"Drama, Mystery","The daughter of a brilliant but mentally disturbed mathematician, recently deceased, tries to come to grips with her possible inheritance: his insanity. Complicating matters are one of her father's ex-students, who wants to search through his papers, and her estranged sister, who shows up to help settle his affairs.",64.0,John Madden,Proof,2005,100,USA, 20000000,7535331,14189860,6654529,-5810140,0
42896,204.0,"Horror, Mystery, Thriller","6 months after the incidents involving the lethal videotape, new clues prove that there is a new evil lurking in the darkness.",44.0,Hideo Nakata,The Ring Two,2005,110,USA, 50000000,76231249,160864957,84633708,110864957,1
42906,162.0,"Comedy, Crime, Drama","Disenchanted with the movie industry, Chili Palmer tries the music industry, meeting and romancing a widow of a music executive on the way.",37.0,F. Gary Gray,Be Cool,2005,118,USA, 53000000,56046979,95226116,39179137,42226116,1
42926,145.0,Comedy,"Cousins Bo, Luke, and Daisy Duke, and their uncle Jesse, egg on the authorities of Hazzard County, Boss Hogg and Sheriff Coltrane.",33.0,Jay Chandrasekhar,The Dukes of Hazzard,2005,104,USA, 50000000,80270227,111069515,30799288,61069515,1
42618,38.0,"Crime, Drama, Horror","An elusive serial killer known as the Zodiac terrorizes the San Francisco Bay in the late 1960s, while detectives aim to stop him before he claims more victims. Based on a true story.",21.0,Alexander Bulkley,The Zodiac,2005,92,USA, 1000000,45148,86872,41724,-913128,0
42939,120.0,"Action, Adventure, Crime",A group of divers find themselves in deep trouble with a drug lord after they come upon the illicit cargo of a sunken airplane.,45.0,John Stockwell,Into the Blue,2005,110,USA, 50000000,18801234,44434439,25633205,-5565561,0
42608,156.0,"Animation, Adventure, Comedy","After ruining his reputation with the town, a courageous chicken must come to the rescue of his fellow citizens when aliens start an invasion.",48.0,Mark Dindal,Chicken Little,2005,81,USA, 150000000,135386665,314432837,179046172,164432837,1
42594,121.0,"Drama, Mystery, Thriller",This movie focuses on the attempts of a psychiatrist to prevent one of his patients from committing suicide while trying to maintain his own grip on reality.,41.0,Marc Forster,Stay,2005,99,USA, 50000000,3626883,8342132,4715249,-41657868,0
42092,15.0,"Comedy, Drama, Romance",Standing Still is the story of a popular yet drunken actor who reconnects with a group of his college friends for a wedding several years after graduation.,38.0,Matthew Cole Weiss,Standing Still,2005,90,USA, 1700000,30142,30142,0,-1669858,0
42224,12.0,"Comedy, Drama, Romance","A man with a boring personality, job, life, and dumped by girlfriend, auditions at the community theater and gets the lead role as Cyrano despite no acting experience. It changes his life forever.",21.0,Al Corley,Bigger Than the Sky,2005,106,USA, 750000,21398,21398,0,-728602,0
42031,165.0,"Animation, Adventure, Comedy","In a robot world, a young idealistic inventor travels to the big city to join his inspiration's company, only to find himself opposing its sinister new management.",64.0,"Chris Wedge, Carlos Saldanha",Robots,2005,91,USA, 75000000,128200012,260696994,132496982,185696994,1
42000,60.0,Drama,A father and daughter isolated on an island off the East Coast and living on a once-thriving commune grapple with the limits of family and sexuality.,59.0,Rebecca Miller,The Ballad of Jack and Rose,2005,112,USA, 1500000,712275,916051,203776,-583949,0
41989,232.0,"Action, Comedy, Crime",A bored married couple is surprised to learn that they are both assassins hired by competing agencies to kill each other.,55.0,Doug Liman,Mr. & Mrs. Smith,2005,120,USA, 110000000,186336279,478207520,291871241,368207520,1
41981,143.0,"Comedy, Drama, Romance","An uptight, conservative businesswoman accompanies her boyfriend to his eccentric and outgoing family's annual Christmas celebration and finds that she's a fish out of water in their free-spirited way of life.",56.0,Thomas Bezucha,The Family Stone,2005,103,USA, 18000000,60062868,92283851,32220983,74283851,1
42424,128.0,"Comedy, Drama",Follows two young boys dealing with their parents' divorce in Brooklyn in the 1980s.,82.0,Noah Baumbach,The Squid and the Whale,2005,81,USA, 1500000,7372734,11098131,3725397,9598131,1
42456,100.0,Comedy,"Deuce is tricked again into man-whoring by T.J., only in Amsterdam while other man-whores are being murdered in his midst.",23.0,Mike Bigelow,Deuce Bigalow: European Gigolo,2005,83,USA, 22000000,22400154,45109561,22709407,23109561,1
41902,21.0,"Drama, History, Sport","Based on a true story, this film tells the tale of the 1950 U.S. soccer team, who, against all odds, beat England 1 - 0 in the city of Belo Horizonte, Brazil. Although no U.S. team has ever won a World Cup title, this story is about the family traditions and passions which shaped the lives of the players who made up this team of underdogs.",47.0,David Anspaugh,The Game of Their Lives,2005,101,USA, 20000000,375750,388998,13248,-19611002,0
41822,209.0,"Biography, Drama, History","The story of James Braddock, a supposedly washed-up boxer who came back to become a champion and an inspiration in the 1930s.",69.0,Ron Howard,Cinderella Man,2005,144,USA, 88000000,61649911,108539911,46890000,20539911,1
42510,190.0,"Comedy, Drama, Romance","During a hometown memorial for his Kentucky-born father, a young man begins an unexpected romance with a too-good-to-be-true stewardess.",45.0,Cameron Crowe,Elizabethtown,2005,123,USA, 45000000,26850426,52034891,25184465,7034891,1
42551,136.0,"Comedy, Crime","When an affluent couple lose all their money following a series of blunders, they turn to a life of crime to make ends meet.",47.0,Dean Parisot,Fun with Dick and Jane,2005,90,USA, 100000000,110332737,202026112,91693375,102026112,1
41804,173.0,"Animation, Adventure, Comedy","A group of animals who have spent all their life in a New York zoo end up in the jungles of Madagascar, and must adjust to living in the wild.",57.0,"Eric Darnell, Tom McGrath",Madagascar,2005,86,USA, 75000000,193595521,542063846,348468325,467063846,1
42566,52.0,Comedy,"A prequel to the critically acclaimed series featuring Jerri Blank, a forty-six-year-old ex-junkie, ex-con who returns to high school in a bid to start her life over.",57.0,Paul Dinello,Strangers with Candy,2005,97,USA, 3500000,2072645,2254124,181479,-1245876,0
41710,63.0,Comedy,Young employees at Shenaniganz restaurant collectively stave off boredom and adulthood with their antics.,30.0,Rob McKittrick,Waiting...,2005,94,USA, 3000000,16124543,18637690,2513147,15637690,1
41582,52.0,"Drama, Romance","In Havana, Cuba in the late 1950s, a wealthy family, one of whose sons is a prominent night-club owner, is caught in the violent transition from the oppressive regime of Batista to the ...",47.0,Andy Garcia,The Lost City,2005,144,USA, 9600000,2484186,4408011,1923825,-5191989,0
43022,265.0,"Action, Adventure, Sci-Fi",The crew of the ship Serenity try to evade an assassin sent to recapture one of their members who is telepathic.,74.0,Joss Whedon,Serenity,2005,119,USA, 39000000,25514517,38869464,13354947,-130536,0
42836,52.0,"Comedy, Family, Sport",An acclaimed college basketball coach is demoted to a junior varsity team after a public meltdown.,36.0,Steve Carr,Rebound,2005,86,USA, 33100000,16809014,17492014,683000,-15607986,0
43290,45.0,"Drama, Romance",A grief-stricken screenwriter unknowingly enters a three-way relationship with a woman and her film executive husband - to chilling results.,62.0,Craig Lucas,The Dying Gaul,2005,92,USA, 4000000,342747,345041,2294,-3654959,0
43347,8.0,Comedy,"""My Big Fat Independent Movie"" is a spoof along the lines of ""Scary Movie"" and ""Not Another Teen Movie."" It includes parodies of some of the indie film world's most renowned movies such as ...",32.0,Philip Zlotorynski,My Big Fat Independent Movie,2005,80,USA, 3000000,4655,12155249,12150594,9155249,1
43257,139.0,"Drama, Horror, Mystery","Eight unsuspecting high school seniors at a posh boarding school, who delight themselves on playing games of lies, come face-to-face with terror and learn that nobody believes a liar - even when they're telling the truth.",39.0,Jeff Wadlow,Cry Wolf,2005,90,USA, 1000000,10047674,15585495,5537821,14585495,1
39593,85.0,"Drama, Musical, Romance","This is the film version of the Pulitzer and Tony Award winning musical about Bohemians in the East Village of New York City struggling with life, love and AIDS, and the impacts they have on America.",53.0,Chris Columbus,Rent,2005,135,USA, 40000000,29077547,31670620,2593073,-8329380,0
43284,190.0,Horror,Newlyweds are terrorized by demonic forces after moving into a large house that was the site of a grisly mass murder a year before.,33.0,Andrew Douglas,The Amityville Horror,2005,90,USA, 19000000,65233369,107516369,42283000,88516369,1
43366,136.0,"Action, Adventure, Romance","Despite trying to keep his swashbuckling to a minimum, a threat to California's pending statehood causes the adventure-loving Don Alejandro de la Vega (Antonio Banderas) and his wife, Elena (Catherine Zeta-Jones), to take action.",47.0,Martin Campbell,The Legend of Zorro,2005,129,USA, 75000000,46464023,142400065,95936042,67400065,1
40522,8.0,Drama,A painter living in exile returns home where his family endured generations of racial violence. There he begins to fantasize the people around him as a series of portraits in order to bury the pain and find something beautiful to feel.,41.0,Jordan Walker-Pearlman,Constellation,2005,96,USA, 7200000,306533,306533,0,-6893467,0
40587,97.0,"Comedy, Drama, Family",A mischievous dog befriends a lonely young girl in a new town and helps her make new friends.,54.0,Wayne Wang,Because of Winn-Dixie,2005,106,USA, 14000000,32647042,33589427,942385,19589427,1
43376,171.0,"Comedy, Romance","While helping his latest client woo the woman of his dreams, a professional ""date doctor"" finds that his game doesn't quite work on the gossip columnist with whom he's smitten.",58.0,Andy Tennant,Hitch,2005,118,USA, 70000000,179495555,368015934,188520379,298015934,1
43274,98.0,"Comedy, Family, Romance","Family man Phil Weston, a lifelong victim of his father's competitive nature, takes on the coaching duties of a kids' soccer team, and soon finds that he's also taking on his father's dysfunctional way of relating.",45.0,Jesse Dylan,Kicking & Screaming,2005,95,USA, 45000000,52842724,56070433,3227709,11070433,1
40665,117.0,"Comedy, Drama",Justin throws himself and everyone around him into chaos when he attempts to break free from his addiction to his thumb.,69.0,Mike Mills,Thumbsucker,2005,96,USA, 4000000,1328679,1919197,590518,-2080803,0
43421,124.0,"Comedy, Drama, Romance","A career driven professional from Manhattan is wooed by a young painter, who also happens to be the son of her psychoanalyst.",58.0,Ben Younger,Prime,2005,105,USA, 22000000,22827153,67937494,45110341,45937494,1
43176,201.0,"Drama, Horror, Mystery","A mother and daughter, still wounded from a bitter custody dispute, hole up in a run-down apartment building. Adding further drama to their plight, they are targeted by the ghost of former resident.",52.0,Walter Salles,Dark Water,2005,105,USA, 30000000,25473352,68357079,42883727,38357079,1
43307,111.0,"Action, Comedy, Crime","After Cheryl Frasier and Stan Fields are kidnapped, Gracie goes undercover in Las Vegas to find them.",34.0,John Pasquin,Miss Congeniality 2: Armed & Fabulous,2005,115,USA, 45000000,48478006,101393569,52915563,56393569,1
43296,80.0,"Comedy, Drama","Failing to make it on his own, twenty-seven-year-old Jim moves back in with his parents and deals with crippling family obligations.",54.0,Steve Buscemi,Lonesome Jim,2005,91,USA, 500000,154187,182378,28191,-317622,0
43111,69.0,"Comedy, Drama",A 15-year-old girl incites chaos among her friends and a media frenzy when she accuses her drama teacher of sexual harassment.,45.0,Marcos Siega,Pretty Persuasion,2005,104,USA, 2500000,305800,537126,231326,-1962874,0
43082,52.0,"Comedy, Drama","Actress Reese Holden has been offered a small fortune by a book editor if she can secure for publication the love letters that her father, a reclusive novelist, wrote to her mother, who has...",56.0,Adam Rapp,Winter Passing,2005,98,USA, 3500000,107492,113783,6291,-3386217,0
43070,61.0,"Comedy, Family, Romance","A lonely mother begins receiving romantic e-mails from a secret admirer, unaware that this perfect man is really a creation of her daughter who is trying to cheer her up.",27.0,Mark Rosman,The Perfect Man,2005,100,USA, 10000000,16535005,19770475,3235470,9770475,1
43207,149.0,"Action, Adventure, Sci-Fi","Deeply ensconced in a top-secret military program, three pilots struggle to bring an artificial intelligence program under control before it initiates the next world war.",35.0,Rob Cohen,Stealth,2005,121,USA, 135000000,32116746,76932872,44816126,-58067128,0
30610,376.0,"Action, Adventure, Fantasy","Three years into the Clone Wars, the Jedi rescue Palpatine from Count Dooku. As Obi-Wan pursues a new threat, Anakin acts as a double agent between the Jedi Council and Palpatine and is lured into a sinister plan to rule the galaxy.",68.0,George Lucas,Star Wars: Episode III - Revenge of the Sith,2005,140,USA, 113000000,380270577,850035635,469765058,737035635,1
45740,123.0,"Biography, Drama, Sport","Based on the story of Vince Papale, a 30-year-old bartender from South Philadelphia who overcame long odds to play for the NFL's Philadelphia Eagles in 1976.",63.0,Ericson Core,Invincible,2006,105,USA, 40000000,57806952,58480828,673876,18480828,1
48016,255.0,"Action, Adventure, Drama","The story of the battle of Iwo Jima between the United States and Imperial Japan during World War II, as told from the perspective of the Japanese who fought it.",89.0,Clint Eastwood,Letters from Iwo Jima,2006,141,USA, 19000000,13756082,68673228,54917146,49673228,1
45746,103.0,"Drama, Music",The real story of a dance teacher who believed in the talent of a group of problem kids.,55.0,Liz Friedlander,Take the Lead,2006,118,USA, 30000000,34742066,65742992,31000926,35742992,1
45274,10.0,Drama,"Thirteen years after the end of the Vietnam War, a family who was tragically affected by the war are forced to emigrate to America.",70.0,Ham Tran,Journey from the Fall,2006,135,USA, 1300000,641039,655927,14888,-644073,0
45267,28.0,"Drama, Romance","A successful male escort describes in a series of confessions his tangled romantic relationships with his two roommates and an older, enigmatic male client.",56.0,Q. Allan Brocka,Boy Culture,2006,88,USA, 500000,220409,263200,42791,-236800,0
45829,35.0,"Comedy, Drama","In this bittersweet comedy, four adult siblings gather at their dying mother's house in North Carolina for what they expect to be a quick, last goodbye. Instead, they find themselves trapped-- together -- for two weeks.",44.0,Steve Stockman,Two Weeks,2006,102,USA, 2400000,47986,47986,0,-2352014,0
45859,250.0,"Comedy, Drama",A family determined to get their young daughter into the finals of a beauty pageant take a cross-country trip in their VW bus.,80.0,"Jonathan Dayton, Valerie Faris",Little Miss Sunshine,2006,101,USA, 8000000,59891098,100523181,40632083,92523181,1
45919,61.0,"Crime, Drama, Mystery",Five men wake up in a locked-down warehouse with no memory of who they are. They are forced to figure out who is good and who is bad to stay alive.,44.0,Simon Brand,Unknown,2006,85,USA, 3700000,26403,3419456,3393053,-280544,0
45967,67.0,Drama,"As Magdalena's 15th birthday approaches, her simple, blissful life is complicated by the discovery that she's pregnant. Kicked out of her house, she finds a new family with her great-granduncle and gay cousin.",72.0,"Richard Glatzer, Wash Westmoreland",Quincea√±era,2006,90,USA, 400000,1692693,2522787,830094,2122787,1
46019,188.0,"Comedy, Drama, Romance","In a bid to keep their luxurious condo from their significant other, a couple's break-up proceeds to get uglier and nastier by the moment.",45.0,Peyton Reed,The Break-Up,2006,106,USA, 52000000,118703275,204963084,86259809,152963084,1
46024,187.0,"Drama, Mystery, Romance","While in post-war Berlin to cover the Potsdam Conference, an American military journalist is drawn into a murder investigation which involves his former mistress and his driver.",49.0,Steven Soderbergh,The Good German,2006,105,USA, 32000000,1308696,5914908,4606212,-26085092,0
46030,288.0,"Drama, Fantasy, Mystery","Apartment building superintendent Cleveland Heep rescues what he thinks is a young woman from the pool he maintains. When he discovers that she is actually a character from a bedtime story who is trying to make the journey back to her home, he works with his tenants to protect his new friend from the creatures that are determined to keep her in our world.",36.0,M. Night Shyamalan,Lady in the Water,2006,110,USA, 70000000,42285169,72785169,30500000,2785169,1
45817,127.0,"Crime, Drama, Mystery","In the midst of his crumbling relationship, a radio show host begins speaking to his biggest fan, a young boy, via the telephone. But when questions about the boy's identity come up, the host's life is thrown into chaos.",51.0,Patrick Stettner,The Night Listener,2006,91,USA, 4000000,7836393,10639686,2803293,6639686,1
48128,26.0,"Comedy, Drama","An improvisational take on the high school experience, told from the educators' point-of-view.",70.0,Mike Akel,Chalk,2006,85,USA, 10000,302845,302845,0,292845,1
48177,122.0,"Drama, Family, History",A drama that focuses on the period in Mary and Joseph's life where they journeyed to Bethlehem for the birth of Jesus.,52.0,Catherine Hardwicke,The Nativity Story,2006,101,USA, 35000000,37629831,46432264,8802433,11432264,1
45471,135.0,"Comedy, Drama","Young Augusten Burroughs absorbs experiences that could make for a shocking memoir: the son of an alcoholic father and an unstable mother, he's handed off to his mother's therapist, Dr. Finch, and spends his adolescent years as a member of Finch's bizarre extended family.",52.0,Ryan Murphy,Running with Scissors,2006,116,USA, 12000000,7022827,7460797,437970,-4539203,0
45448,14.0,"Crime, Mystery, Thriller","Between 11:50 and 12:00 noon, a crime is commited. In the same ten minute period, we follow the lives of the ten people, all connected to this crime. As we see each person's point of view, ...",57.0,Scott Storm,Ten 'til Noon,2006,83,USA, 750000,6404,6404,0,-743596,0
48153,4.0,Drama,"A retelling of the events leading up to the crucifixion of Jesus Christ, based on the idea that he was a black man whose death was a racially motivated hate crime.",34.0,Jean-Claude La Marre,Color of the Cross,2006,108,USA, 2500000,85802,85802,0,-2414198,0
48343,33.0,Drama,A woman's schizophrenia affects her relationships with her husband and son.,67.0,Joseph Greco,Canvas,2006,101,USA, 1500000,35630,41010,5380,-1458990,0
45436,163.0,"Animation, Adventure, Comedy","Manny, Sid, and Diego discover that the ice age is coming to an end, and join everybody for a journey to higher ground. On the trip, they discover that Manny, in fact, is not the last of the woolly mammoths.",58.0,Carlos Saldanha,Ice Age: The Meltdown,2006,91,USA, 80000000,195330621,667036530,471705909,587036530,1
45432,90.0,"Comedy, Sport",A trio of guys try and make up for missed opportunities in childhood by forming a three-player baseball team to compete against standard children's Little League squads.,25.0,Dennis Dugan,The Benchwarmers,2006,85,USA, 33000000,59843754,64957291,5113537,31957291,1
45430,95.0,"Drama, Family",A young girl from South Los Angeles tries to make it to the National Spelling Bee.,72.0,Doug Atchison,Akeelah and the Bee,2006,112,USA, 8000000,18848430,18948425,99995,10948425,1
45656,163.0,"Action, Crime, Thriller",A Secret Service agent is framed as the mole in an assassination attempt on the President. He must clear his name and foil another assassination attempt while on the run from a Secret Service Protective Intelligence Division agent.,49.0,Clark Johnson,The Sentinel,2006,108,USA, 60000000,36280697,77920346,41639649,17920346,1
45513,23.0,"Crime, Drama, Thriller","During a Midwestern winter, two working-class brothers must cope with their recently incarcerated father.",67.0,Brian Jun,Steel City,2006,95,USA, 350000,10227,10227,0,-339773,0
45249,124.0,"Biography, Drama",Based on the rise and fall of socialite,45.0,George Hickenlooper,Factory Girl,2006,90,USA, 7000000,1675241,3572632,1897391,-3427368,0
48147,87.0,"Drama, Sport","When a plane crash claims the lives of members of the Marshall University football team and some of its fans, the team's new coach and his surviving players try to keep the football program alive.",53.0,McG,We Are Marshall,2006,131,USA, 65000000,43545364,43545364,0,-21454636,0
48675,29.0,"Drama, Fantasy, Sport",A losing coach with an underdog football team faces their giants of fear and failure on and off the field to surprising results.,38.0,Alex Kendrick,Facing the Giants,2006,111,USA, 100000,10178331,10307987,129656,10207987,1
45375,114.0,"Comedy, Drama, Romance","After she quits her lucrative job, Olivia finds herself unsure about her future and her relationships with her successful and wealthy friends.",68.0,Nicole Holofcener,Friends with Money,2006,88,USA, 6500000,13368437,18245244,4876807,11745244,1
45302,131.0,"Comedy, Drama, Romance","Michael'd have a great job, still have his 4 best friends, and be in love with a beautiful girl at 30. He loves Jenna but his life seems predictable until he meets a college girl. It seems that everybody's having relationship problems.",57.0,Tony Goldwyn,The Last Kiss,2006,115,USA, 20000000,11614790,15852401,4237611,-4147599,0
45623,46.0,"Comedy, Romance",Four gay high school friends make a pact to lose their virginity before they go to college.,37.0,Todd Stephens,Another Gay Movie,2006,92,USA, 500000,654132,745327,91195,245327,1
45634,236.0,"Drama, Music, Musical","A trio of black female soul singers cross over to the pop charts in the early 1960s, facing their own personal struggles along the way.",76.0,Bill Condon,Dreamgirls,2006,130,USA, 70000000,103365956,154937680,51571724,84937680,1
45281,102.0,"Horror, Mystery, Thriller","Joanna Mills, a traveling business woman, begins having nightmares of a murder that occurred 15 years ago. Soon she is drawn to an old farmhouse, where the murder took place.",38.0,Asif Kapadia,The Return,2006,85,USA, 15000000,7749851,11994195,4244344,-3005805,0
45575,113.0,"Fantasy, Horror, Mystery","For a group of teens, the answer to the mysterious death of their old friend lies within the world of an online video game based on the true story of an ancient noblewoman known as the Blood Countess.",24.0,William Brent Bell,Stay Alive,2006,85,USA, 7000000,23086480,27105095,4018615,20105095,1
47741,35.0,Comedy,Two plus-sized ladies meet the men of their dreams in the most unexpected of ways.,36.0,Nnegest Likk√©,Phat Girlz,2006,99,USA, 3000000,7061128,7403491,342363,4403491,1
46039,80.0,"Adventure, Comedy, Family","Santa, aka Scott Calvin, is faced with double-duty: how to keep his new family happy, and how to stop Jack Frost from taking over Christmas.",32.0,Michael Lembeck,The Santa Clause 3: The Escape Clause,2006,97,USA, 12000000,84500122,110768122,26268000,98768122,1
46535,99.0,"Crime, Drama, Music","Tyler Gage receives the opportunity of a lifetime after vandalizing a performing arts school, gaining him the chance to earn a scholarship and dance with an up and coming dancer, Nora.",48.0,Anne Fletcher,Step Up,2006,104,USA, 12000000,65328121,114197742,48869621,102197742,1
46555,137.0,"Comedy, Romance","A best man (Wilson) stays on as a houseguest with the newlyweds, much to the couple's annoyance.",46.0,"Anthony Russo, Joe Russo","You, Me and Dupree",2006,110,USA, 54000000,75628110,130431368,54803258,76431368,1
46626,150.0,"Comedy, Music","The new season of ""American Dreamz,"" the wildly popular television singing contest, has captured the country's attention, as the competition looks to be between a young Midwestern gal (Moore) and a showtunes-loving young man from Orange County (Golzari). Recently awakened President Staton (Quaid) even wants in on the craze, as he signs up for the potential explosive season finale.",45.0,Paul Weitz,American Dreamz,2006,107,USA, 17000000,7191830,16458459,9266629,-541541,0
46637,18.0,"Comedy, Drama, Family",A young girl discovers she can communicate with dolphins.,54.0,Michael D. Sellers,Eye of the Dolphin,2006,102,USA, 2500000,72210,72310,100,-2427690,0
46641,15.0,"Action, Adventure, Drama","Quebec Bill Bohomme is a hardy schemer and dreamer, who, desperate to raise money to preserve his endangered herd through the rapidly approaching winter, resorts to whiskey-smuggling, a ...",57.0,Jay Craven,Disappearances,2006,118,USA, 1500000,7506,7506,0,-1492494,0
47211,34.0,"Comedy, Horror, Thriller","After receiving an African fertility mask as a gift Ellen tells her husband William that she's been attacked by masked phantom called 'the Nightmare Man'. As Ellen's paranoia increases, ...",46.0,Rolfe Kanefsky,Nightmare Man,2006,89,USA, 250000,97182,97182,0,-152818,0
46655,150.0,"Comedy, Romance, Sci-Fi","When a regular guy dumps a superhero for her neediness, she uses her powers to make his life a living hell.",50.0,Ivan Reitman,My Super Ex-Girlfriend,2006,96,USA, 30000000,22530295,60984606,38454311,30984606,1
47093,124.0,"Action, Adventure, Fantasy","Four young men who belong to a New England supernatural legacy are forced to battle a fifth power long thought to have died out. Meanwhile, jealousy and suspicion threaten to tear them apart.",19.0,Renny Harlin,The Covenant,2006,97,USA, 20000000,23380495,37597471,14216976,17597471,1
47066,21.0,"Comedy, Drama, Music",A group of guys who sang together in a college a cappella group reunite 15 years later to perform at a friend's wedding and discover how their lives have progressed -- and in some cases regressed -- since their college heyday.,39.0,Bruce Leddy,Shut Up and Sing,2006,96,USA, 1000000,1236953,2811468,1574515,1811468,1
46710,52.0,"Comedy, Crime, Drama","As four friends prepare for life after high school, different challenges bring about turning points in each of their lives. The dramas unfold and resolve at their local rollerskating rink, Cascade.",63.0,Chris Robinson,ATL,2006,105,USA, 20000000,21170563,21170563,0,1170563,1
46713,234.0,"Horror, Thriller",An American official realizes that his young son may literally be the Devil incarnate.,43.0,John Moore,The Omen,2006,110,USA, 25000000,54607383,119498909,64891526,94498909,1
46746,217.0,Drama,An inner-city junior high school teacher with a drug habit forms an unlikely friendship with one of his students after she discovers his secret.,85.0,Ryan Fleck,Half Nelson,2006,106,USA, 700000,2697938,4660481,1962543,3960481,1
47005,6.0,"Comedy, Romance",A lifelong bachelor confronts his intimacy issues when he sublets his apartment to a fetching biologist. His heartsick fish and his wise best buddy are on hand to provide perspective.,38.0,Claudia Myers,Kettle of Fish,2006,97,USA, 2000000,7196,7196,0,-1992804,0
46751,95.0,Drama,Two old pals reunite for a camping trip in Oregon's Cascade Mountains.,84.0,Kelly Reichardt,Old Joy,2006,76,USA, 300000,255923,301047,45124,1047,1
46754,25.0,"Drama, War","The story of an American journalist, a CIA operative, and an Iraqi photographer against the backdrop of the bloody war in Iraq.",45.0,Philip Haas,The Situation,2006,111,USA, 1000000,48896,48896,0,-951104,0
46797,108.0,"Adventure, Drama, Sci-Fi","A NASA astronaut, forced to retire years earlier so he could save his family farm, has never given up his dream of space travel and looks to build his own rocket, despite the government's threats to stop him.",55.0,Michael Polish,The Astronaut Farmer,2006,104,USA, 13000000,11003643,11130889,127246,-1869111,0
46981,6.0,"Comedy, Romance",Todd's life spins out of control when an unexpected friendship with a gay man causes everyone in his life to start believing he's gay. Do they know something he doesn't?,47.0,Stewart Wade,Coffee Date,2006,91,USA, 200000,4412,4412,0,-195588,0
46807,241.0,"Drama, History, Thriller",Two Port Authority police officers become trapped under the rubble of the World Trade Center.,66.0,Oliver Stone,World Trade Center,2006,129,USA, 65000000,70278893,162970240,92691347,97970240,1
46972,26.0,"Action, Sport","A naturally talented basketball player, Noah Cruise is determined to become a doctor using his basketball scholarship to UCLA pre-med, rather than succumb to the lure of former sports agent...",30.0,Preston A. Whitmore II,Crossover,2006,95,USA, 5800000,7009668,7009668,0,1209668,1
46945,71.0,"Crime, Drama, Thriller",A quiet but disturbed young man puts the life of a woman he's obsessed with under a virtual microscope when he installs hidden cameras throughout her house.,65.0,Eric Nicholas,Alone with Her,2006,78,USA, 1000000,10787,1677967,1667180,677967,1
46873,118.0,Comedy,"Three actors learn that their respective performances in the film ""Home for Purim,"" a drama set in the mid-1940s American South, are generating award-season buzz.",68.0,Christopher Guest,For Your Consideration,2006,86,USA, 12000000,5549923,5925637,375714,-6074363,0
46925,287.0,"Action, Adventure, Drama","As the Mayan kingdom faces its decline, a young man is taken on a perilous journey to a world ruled by fear and oppression.",68.0,Mel Gibson,Apocalypto,2006,139,USA, 40000000,50866635,120654337,69787702,80654337,1
47260,9.0,"Drama, Fantasy","A Mexican national, Jesus Feliciano, returning to California from Iraq where he had soldiered in exchange for grant of US citizenship, suffers trauma related to his battle experience and imagines his family life threatened.",57.0,Carl Colpaert,G.I. Jesus,2006,100,USA, 2000000,8593,8593,0,-1991407,0
47701,46.0,Horror,"Both an homage to and a re-imagining of the original 1968 film, this update follows a group of survivors trapped in a farmhouse battling a siege of undead zombies....in 3D!",32.0,Jeff Broadstreet,Night of the Living Dead 3D,2006,80,USA, 750000,271000,1657729,1386729,907729,1
47265,295.0,"Drama, Sport","Thirty years after the ring of the first bell, Rocky Balboa comes out of retirement and dons his gloves for his final fight; against the reigning heavyweight champ Mason 'The Line' Dixon.",63.0,Sylvester Stallone,Rocky Balboa,2006,102,USA, 24000000,70270943,155721132,85450189,131721132,1
46528,108.0,Comedy,"A young guy short on luck enrolls in a class to build confidence to help win over the girl of his dreams, which becomes complicated when it turns out his teacher has the same agenda.",44.0,Todd Phillips,School for Scoundrels,2006,100,USA, 35000000,17807569,24470583,6663014,-10529417,0
47665,77.0,"Adventure, Comedy, Family",A group of unaccompanied minors bond while snowed in at the midwestern Hoover International Airport during the holiday season and ultimately create a makeshift holiday themselves.,43.0,Paul Feig,Unaccompanied Minors,2006,90,USA, 25000000,16655224,21949214,5293990,-3050786,0
46080,23.0,"Comedy, Sport",An unemployed slacker inspires his softball teammates to improve their game so they won't get kicked out of the local league.,40.0,Frank Sebastiano,Beer League,2006,86,USA, 2800000,472185,472185,0,-2327815,0
47569,90.0,Comedy,"Two brothers travel to Germany for Oktoberfest, only to stumble upon a secret, centuries-old competition described as a ""Fight Club"" with beer games.",46.0,Jay Chandrasekhar,Beerfest,2006,110,USA, 17500000,19185184,20387597,1202413,2887597,1
46085,49.0,"Adventure, Comedy, Family","A young man (Lerman) moves from Montana to Florida with his family, where he's compelled to engage in a fight to protect a population of endangered owls.",46.0,Wil Shriner,Hoot,2006,91,USA, 15000000,8117637,8224998,107361,-6775002,0
47464,105.0,"Comedy, Drama, Romance","A comedian who hosts a news satire program decides to run for president, and a computerized voting machine malfunction gets him elected.",39.0,Barry Levinson,Man of the Year,2006,115,USA, 20000000,37327390,41237648,3910258,21237648,1
47330,29.0,"Comedy, Romance","A hastily married couple quickly devolve into a life of affairs, meddling parents, and therapy.",62.0,Robert Cary,Ira & Abby,2006,104,USA, 3500000,221096,563611,342515,-2936389,0
46132,230.0,"Crime, Drama, Mystery","A police detective, a bank robber, and a high-power broker enter high-stakes negotiations after the criminal's brilliant heist spirals into a hostage situation.",76.0,Spike Lee,Inside Man,2006,129,USA, 45000000,88513495,184376254,95862759,139376254,1
46142,151.0,"Horror, Sci-Fi","When their computer hacker friend accidentally channels a mysterious wireless signal, a group of co-eds rally to stop a terrifying evil from taking over the world.",27.0,Jim Sonzero,Pulse,2006,90,USA, 20500000,20264436,29907685,9643249,9407685,1
46143,200.0,"Biography, Drama",A struggling salesman takes custody of his son as he's poised to begin a life-changing professional career.,64.0,Gabriele Muccino,The Pursuit of Happyness,2006,117,USA, 55000000,163566459,307077295,143510836,252077295,1
46149,149.0,"Horror, Mystery, Thriller",A group of young backpackers' vacation turns sour when a bus accident leaves them marooned in a remote Brazilian rural area that holds an ominous secret.,36.0,John Stockwell,Turistas,2006,93,USA, 10000000,7027762,14749758,7721996,4749758,1
46174,46.0,"Comedy, Drama, Romance","While planning her family reunion, a pistol-packing grandma must contend with the other dramas on her plate, including the runaway who has been placed under her care, and her love-troubled nieces.",45.0,Tyler Perry,Madea's Family Reunion,2006,107,USA, 6000000,63318000,63368939,50939,57368939,1
46195,20.0,"Comedy, Drama, Music",A groom (Ed Burns) and his four attendants wrestle with issues related to friendship and maturity a week before the big day.,57.0,Edward Burns,The Groomsmen,2006,98,USA, 3000000,128911,818970,690059,-2181030,0
46276,36.0,"Drama, Romance","A thirty-something southern woman searches for love, despite the burdens she carries with her.",64.0,Joey Lauren Adams,Come Early Morning,2006,97,USA, 6000000,119452,161408,41956,-5838592,0
47304,173.0,"Action, Crime, Thriller",Professional assassin Chev Chelios learns his rival has injected him with a poison that will kill him if his heart rate drops.,57.0,"Mark Neveldine, Brian Taylor",Crank,2006,88,USA, 12000000,27838408,42931041,15092633,30931041,1
46312,165.0,"Comedy, Romance","Two women troubled with guy-problems swap homes in each other's countries, where they each meet a local guy and fall in love.",52.0,Nancy Meyers,The Holiday,2006,136,USA, 85000000,63224849,205135175,141910326,120135175,1
47288,133.0,"Action, Drama, Thriller","At the end of the Civil War, a colonel hunts down a man with whom he has a grudge.",62.0,David Von Ancken,Seraphim Falls,2006,115,USA, 18000000,418296,1220058,801762,-16779942,0
46488,197.0,"Drama, Music","A God-fearing bluesman takes to a wild young woman who, as a victim of childhood sexual abuse, looks everywhere for love, never quite finding it.",52.0,Craig Brewer,Black Snake Moan,2006,116,USA, 15000000,9396870,10903846,1506976,-4096154,0
47267,55.0,"Comedy, Drama, Sci-Fi","A lonely comic book fan, Les Franken, has a reaction to medication and becomes convinced he's a superhero.",57.0,"Hal Haberman, Jeremy Passmore",Special,2006,81,USA, 1000000,7202,14967,7765,-985033,0
46506,142.0,"Comedy, Drama","In what would cause a fantastic media frenzy,",70.0,Lasse Hallstr√∂m,The Hoax,2006,116,USA, 25000000,7164995,11772461,4607466,-13227539,0
46513,36.0,"Comedy, Romance","A slovenly cable repairman becomes a big city Health Inspector, and is tasked with uncovering the source of a food poisoning epidemic.",21.0,Trent Cooper,Larry the Cable Guy: Health Inspector,2006,89,USA, 4000000,15680099,15680099,0,11680099,1
46534,29.0,"Comedy, Drama, Romance","Jake Singer is at loose ends in New York City, and neck deep in psychoanalysis with the outrageous Dr. Morales, when he meets the enigmatic and beautiful widow Allegra Marshall.",54.0,Oren Rudavsky,The Treatment,2006,86,USA, 900000,83354,83354,0,-816646,0
46186,157.0,"Horror, Thriller","During a babysitting gig, a high-school student is harassed by an increasingly threatening prank caller.",27.0,Simon West,When a Stranger Calls,2006,87,USA, 15000000,47860214,66966987,19106773,51966987,1
43595,31.0,"Comedy, Romance","About a man who has trouble with his job, trouble with women, and uses food to deal with it all.",60.0,Jeff Garlin,I Want Someone to Eat Cheese With,2006,80,USA, 1500000,194568,194568,0,-1305432,0
43672,104.0,"Comedy, Drama, Romance",A woman struggles to accept the death of her fianc√© and the secrets he kept from her as she rebuilds her life.,43.0,Susannah Grant,Catch and Release,2006,124,USA, 25000000,15539051,16159325,620274,-8840675,0
44529,82.0,"Crime, Drama, Musical","A musical set in the Prohibition-era American South, where a speakeasy performer and club manager Rooster must contend with gangsters who have their eyes on the club while his piano player ...",55.0,Bryan Barber,Idlewild,2006,121,USA, 15000000,12571185,12643027,71842,-2356973,0
44537,88.0,"Drama, Romance, Sport","Set against the backdrop of boxing at the Naval Academy, centers on a young man from the wrong side of the tracks whose dream of attending Annapolis becomes a reality.",37.0,Justin Lin,Annapolis,2006,108,USA, 26000000,17127992,17496992,369000,-8503008,0
40205,192.0,"Biography, Drama, History",The story of the assassination of U.S. Senator,54.0,Emilio Estevez,Bobby,2006,117,USA, 14000000,11242801,20718608,9475807,6718608,1
44593,283.0,"Action, Adventure, Drama","The life stories of the six men who raised the flag at the Battle of Iwo Jima, a turning point in World War II.",79.0,Clint Eastwood,Flags of Our Fathers,2006,135,USA, 90000000,33602376,65900249,32297873,-24099751,0
43752,127.0,"Adventure, Drama, Family",Brutal cold forces two Antarctic explorers to leave their team of sled dogs behind as they fend for their survival.,64.0,Frank Marshall,Eight Below,2006,120,USA, 40000000,81612565,120455994,38843429,80455994,1
44665,83.0,"Action, Comedy, Drama",A group of diamond thieves on the run kidnap the wife of a recently discharged marine who goes on a chase through the South Carolinian wilderness to retrieve her.,45.0,John Bonito,The Marine,2006,92,USA, 20000000,18844784,22164661,3319877,2164661,1
43746,101.0,"Comedy, Fantasy, Romance","Manhattanite Ashley is known to many as the luckiest woman around. After a chance encounter with a down-and-out young man, however, she realizes that she's swapped her fortune for his.",29.0,Donald Petrie,Just My Luck,2006,103,USA, 28000000,17326650,38159905,20833255,10159905,1
44676,205.0,"Comedy, Drama, Music","A look at what goes on backstage during the last broadcast of America's most celebrated radio show, where singing cowboys Dusty and Lefty, a country music siren, and a host of others hold court.",75.0,Robert Altman,A Prairie Home Companion,2006,105,USA, 10000000,20342852,25986072,5643220,15986072,1
44689,259.0,"Comedy, Drama, Fantasy","An I.R.S. auditor suddenly finds himself the subject of narration only he can hear: narration that begins to affect his entire life, from his work, to his love-interest, to his death.",67.0,Marc Forster,Stranger Than Fiction,2006,113,USA, 30000000,40660952,53653224,12992272,23653224,1
44697,203.0,"Horror, Thriller","Before being sent to serve in Vietnam, two brothers and their girlfriends take one last road trip, but when they get into an accident, a terrifying experience will take them to a secluded house of horrors, with a chainsaw-wielding killer.",30.0,Jonathan Liebesman,The Texas Chainsaw Massacre: The Beginning,2006,91,USA, 16000000,39517763,51764406,12246643,35764406,1
41702,443.0,"Action, Sci-Fi","Superman returns to Earth after spending five years in space examining his homeworld Krypton. But he finds things have changed while he was gone, and he must once again prove himself important to the world.",72.0,Bryan Singer,Superman Returns,2006,154,USA, 270000000,200081192,391081192,191000000,121081192,1
44708,129.0,"Biography, Crime, Drama","While researching his novel ""In Cold Blood"",",68.0,Douglas McGrath,Infamous,2006,110,USA, 13000000,1151330,2613717,1462387,-10386283,0
42100,24.0,"Crime, Drama, Thriller","A former street tough returns to his Philadelphia home after a stint in the military. Back on his home turf, he once again finds himself tangling with the mob boss who was instrumental in his going off to be a soldier.",36.0,Bobby Moresco,10th & Wolf,2006,107,USA, 8000000,54702,143451,88749,-7856549,0
44738,87.0,"Biography, Crime, Drama","Teenagers at a juvenile detention center, under the leadership of their counselor, gain self-esteem by playing football together.",52.0,Phil Joanou,Gridiron Gang,2006,125,USA, 30000000,38432823,41480851,3048028,11480851,1
43651,79.0,"Comedy, Family, Fantasy",A man tries to live a normal life despite the fact that he sometimes turns into a sheepdog.,43.0,Brian Robbins,The Shaggy Dog,2006,98,USA, 50000000,61123569,87134280,26010711,37134280,1
43810,18.0,"Adventure, Drama",An adaptation of James Redfield's novel about the search for a sacred manuscript in the Peruvian rain forest.,23.0,Armand Mastroianni,The Celestine Prophecy,2006,99,USA, 10000000,617236,1127463,510227,-8872537,0
43886,106.0,"Animation, Adventure, Comedy","Boog, a domesticated 900lb. Grizzly bear, finds himself stranded in the woods 3 days before Open Season. Forced to rely on Elliot, a fast-talking mule deer, the two form an unlikely friendship and must quickly rally other forest animals if they are to form a rag-tag army against the hunters.",49.0,"Roger Allers, Jill Culton",Open Season,2006,86,USA, 85000000,85105259,197309027,112203768,112309027,1
40594,265.0,"Animation, Comedy, Family","A hot-shot race-car named Lightning McQueen gets waylaid in Radiator Springs, where he finds the true meaning of friendship and family.",73.0,"John Lasseter, Joe Ranft",Cars,2006,117,USA, 120000000,244082982,461983149,217900167,341983149,1
44212,227.0,"Action, Adventure, Drama","On New Year's Eve, the luxury ocean liner Poseidon capsizes after being swamped by a rogue wave. The survivors are left to fight for their lives as they attempt to escape the sinking ship.",50.0,Wolfgang Petersen,Poseidon,2006,98,USA, 160000000,60674817,181674817,121000000,21674817,1
41755,102.0,"Crime, Drama, Mystery",A black police detective must solve a strange case of a kidnapped boy and deal with a big racial protest.,43.0,Joe Roth,Freedomland,2006,113,USA, 37665000,12512886,14655628,2142742,-23009372,0
41578,193.0,"Drama, History, Thriller",The tumultuous early history of the Central Intelligence Agency is viewed through the prism of one man's life.,61.0,Robert De Niro,The Good Shepherd,2006,167,USA, 90000000,59952835,100266865,40314030,10266865,1
44245,180.0,"Drama, Fantasy, Romance","A lonely doctor, who once occupied an unusual lakeside house, begins exchanging love letters with its former resident, a frustrated architect. They must try to unravel the mystery behind their extraordinary romance before it's too late.",52.0,Alejandro Agresti,The Lake House,2006,99,USA, 40000000,52330111,114830111,62500000,74830111,1
44189,162.0,"Action, Crime, Thriller","A security specialist is forced into robbing the bank that he's protecting, as a bid to pay off his family's ransom.",45.0,Richard Loncraine,Firewall,2006,105,USA, 50000000,48751189,82751189,34000000,32751189,1
44168,357.0,"Crime, Drama, Thriller",An undercover cop and a mole in the police attempt to identify each other while infiltrating an Irish gang in South Boston.,85.0,Martin Scorsese,The Departed,2006,151,USA, 90000000,132384315,291465034,159080719,201465034,1
40963,159.0,"Animation, Adventure, Comedy","A scheming raccoon fools a mismatched family of forest creatures into helping him repay a debt of food, by invading the new suburban sprawl that popped up while they were hibernating...and learns a lesson about family himself.",67.0,"Tim Johnson, Karey Kirkpatrick",Over the Hedge,2006,83,USA, 80000000,155019340,336002996,180983656,256002996,1
43539,176.0,"Comedy, Drama, Fantasy",A workaholic architect finds a universal remote that allows him to fast-forward and rewind to different parts of his life. Complications arise when the remote starts to overrule his choices.,45.0,Frank Coraci,Click,2006,107,USA, 82500000,137355633,237681299,100325666,155181299,1
44121,139.0,"Action, Adventure, Drama","A high school swim champion with a troubled past enrolls in the U.S. Coast Guard's ""A"" School, where legendary rescue swimmer Ben Randall teaches him some hard lessons about loss, love, and self-sacrifice.",53.0,Andrew Davis,The Guardian,2006,139,USA, 70000000,55011732,94973540,39961808,24973540,1
44067,239.0,"Animation, Crime, Drama",An undercover cop in a not-too-distant future becomes involved with a dangerous new drug and begins to lose his own identity as a result.,73.0,Richard Linklater,A Scanner Darkly,2006,100,USA, 8700000,5501616,7659654,2158038,-1040346,0
44331,50.0,"Comedy, Drama, Romance","An offbeat drama focused on a homeless youth, a pop music siren and a member of the paparazzi.",68.0,Tom DiCillo,Delirious,2006,107,USA, 5000000,86460,659589,573129,-4340411,0
44033,254.0,"Drama, Romance","The lives of two lovelorn spouses from separate marriages, a registered sex offender, and a disgraced ex-police officer intersect as they struggle to resist their vulnerabilities and temptations in suburban Massachusetts.",75.0,Todd Field,Little Children,2006,136,USA, 26000000,5463019,14821658,9358639,-11178342,0
43933,176.0,"Action, Adventure, Fantasy","Picking up directly from the previous movie, vampire warrior Selene and the half werewolf Michael hunt for clues to reveal the history of their races and the war between them.",36.0,Len Wiseman,Underworld: Evolution,2006,106,USA, 50000000,62318875,111340801,49021926,61340801,1
44420,175.0,"Comedy, Sport","Number one NASCAR driver Ricky Bobby stays atop the heap thanks to a pact with his best friend and teammate, Cal Naughton, Jr. But when a French Formula One driver, makes his way up the ladder, Ricky Bobby's talent and devotion are put to the test.",66.0,Adam McKay,Talladega Nights: The Ballad of Ricky Bobby,2006,108,USA, 72500000,148213377,162966177,14752800,90466177,1
44163,21.0,"Comedy, Drama","A man stuck in the reveries of his youth tracks down the boyhood friend he once tormented, only to find that simpler times were more complicated than he thought.",47.0,David Munro,Full Grown Men,2006,78,USA, 2000000,13716,13716,0,-1986284,0
44755,65.0,"Comedy, Crime",An FBI agent reprises his disguise as a corpulent old lady and takes a job as a nanny in a crime suspect's house.,34.0,John Whitesell,Big Momma's House 2,2006,99,USA, 40000000,70165972,138259062,68093090,98259062,1
44203,91.0,"Comedy, Romance","Upon learning of a terminal illness, a shy woman decides to sell off all her possessions and live it up at a posh European hotel.",52.0,Wayne Wang,Last Holiday,2006,112,USA, 45000000,38399961,43343247,4943286,-1656753,0
42156,150.0,Comedy,"Cindy finds out the house she lives in is haunted by a little boy and goes on a quest to find out who killed him and why. Also, Alien ""Tr-iPods"" are invading the world and she has to uncover the secret in order to stop them.",40.0,David Zucker,Scary Movie 4,2006,83,USA, 45000000,90710620,178262620,87552000,133262620,1
43215,61.0,"Action, Adventure, Comedy",Former superhero Jack is called back to work to transform an unlikely group of ragtag kids into superheroes at a private academy.,26.0,Peter Hewitt,Zoom,2006,83,USA, 35000000,11989328,12506188,516860,-22493812,0
44930,20.0,"Comedy, Crime, Drama","A rebellious girl hooks up with an escort agency, where her stepfather is a client.",45.0,Nick Guthe,Mini's First Time,2006,91,USA, 6000000,49034,156318,107284,-5843682,0
43233,320.0,"Action, Adventure, Fantasy","Jack Sparrow races to recover the heart of Davy Jones to avoid enslaving his soul to Jones' service, as other friends and foes seek the heart for their own agenda as well.",53.0,Gore Verbinski,Pirates of the Caribbean: Dead Man's Chest,2006,151,USA, 225000000,423315812,1066179725,642863913,841179725,1
45052,219.0,"Biography, Crime, Drama",A detective examines the mysterious death of,62.0,Allen Coulter,Hollywoodland,2006,126,USA, 28000000,14426251,16800438,2374187,-11199562,0
42418,89.0,"Comedy, Drama","A group of New Yorkers caught up in their romantic-sexual milieu converge at an underground salon infamous for its blend of art, music, politics, and carnality.",64.0,John Cameron Mitchell,Shortbus,2006,101,USA, 2000000,1985292,5516192,3530900,3516192,1
43281,117.0,Comedy,"A high school slacker who's rejected by every school he applies to opts to create his own institution of higher learning, the South Harmon Institute of Technology, on a rundown piece of property near his hometown.",47.0,Steve Pink,Accepted,2006,93,USA, 23000000,36323505,38505009,2181504,15505009,1
45095,13.0,Drama,Ethan Jenkins (Michael W. Smith) and Jake Sanders (introducing Jeff Obafemi Carr) are both passionate pastors who worship the same God from the same book--but that's where the similarity ...,52.0,Steve Taylor,The Second Chance,2006,102,USA, 1200000,463542,463542,0,-736458,0
44900,87.0,"Comedy, Romance","A slacker competes with a repeat winner for the ""Employee of the Month"" title at work, in order to gain the affections of a new female employee.",36.0,Greg Coolidge,Employee of the Month,2006,103,USA, 12000000,28444855,38368909,9924054,26368909,1
44867,174.0,Comedy,A calamity at Dante and Randal's shops sends them looking for new horizons - but they ultimately settle at the fast food empire Mooby's.,65.0,Kevin Smith,Clerks II,2006,97,USA, 5000000,24148068,26986174,2838106,21986174,1
43344,187.0,"Animation, Adventure, Comedy","Three teens discover that their neighbor's house is really a living, breathing, scary monster.",68.0,Gil Kenan,Monster House,2006,91,USA, 75000000,73661010,140175006,66513996,65175006,1
44777,103.0,"Biography, Drama, Romance","Turning her back on her wealthy, established family, Diane Arbus falls in love with Lionel Sweeney, an enigmatic mentor who introduces Arbus to the marginalized people who help her become one of the most revered photographers of the twentieth century.",50.0,Steven Shainberg,Fur: An Imaginary Portrait of Diane Arbus,2006,122,USA, 16800000,223202,2305841,2082639,-14494159,0
45169,36.0,Drama,A lyrical telling of the coming of age of a 13-year-old boy who learns to cope with his newfound sexuality and his unrequited love for the cool kid in school.,52.0,Cam Archer,Wild Tigers I Have Known,2006,88,USA, 50000,9946,28190,18244,-21810,0
45151,37.0,"Biography, Drama, History","In Biblical times, a girl disguises her Jewish origins when the Persian king comes looking for a new bride among his subjects.",38.0,Michael O. Sajbel,One Night with the King,2006,123,USA, 20000000,13395961,13728450,332489,-6271550,0
42567,158.0,"Action, Adventure, Crime","A beautiful h√¶mophage infected with a virus that gives her superhuman powers has to protect a boy in a futuristic world, who is thought to be carrying antigens that would destroy all h√¶mophages.",18.0,Kurt Wimmer,Ultraviolet,2006,88,USA, 30000000,18535812,31070211,12534399,1070211,1
45120,66.0,"Comedy, Family, Fantasy",Two teenage girls discover a mermaid in their beach club's swimming pool.,51.0,Elizabeth Allen Rosenbaum,Aquamarine,2006,104,USA, 12000000,18597342,22978953,4381611,10978953,1
44782,240.0,"Comedy, Horror, Thriller","When a group of tourists in a New Orleans haunted swamp tour find themselves stranded in the wilderness, their evening of fun and spooks turns into a horrific nightmare.",57.0,Adam Green,Hatchet,2006,85,USA, 1500000,175281,208550,33269,-1291450,0
45015,141.0,"Comedy, Romance",A thirty-something is still living with his parents until they hire an interventionist to help him graduate out of the house. That's when the fun begins.,47.0,Tom Dey,Failure to Launch,2006,97,USA, 50000000,88715192,128402901,39687709,78402901,1
44813,80.0,Drama,Sherry tries to integrate again into society and become a good mother.,66.0,Laurie Collyer,Sherrybaby,2006,96,USA, 2000000,199176,622806,423630,-1377194,0
45119,105.0,"Animation, Adventure, Comedy","After Lucas Nickle floods an ant colony with his watergun, he's magically shrunken down to insect size and sentenced to hard labor in the ruins.",59.0,John A. Davis,The Ant Bully,2006,88,USA, 50000000,28142535,55181129,27038594,5181129,1
44801,49.0,"Comedy, Drama, Romance",Priscilla Chase is a woman who has never had an orgasm.,48.0,Billy Kent,The Oh in Ohio,2006,88,USA, 5000000,418689,648183,229494,-4351817,0
48021,219.0,"Crime, Drama, Thriller",A New York City nightclub manager tries to save his brother and father from Russian Mafia hitmen.,59.0,James Gray,We Own the Night,2007,117,USA, 21000000,28563179,54926886,26363707,33926886,1
47328,218.0,"Comedy, Drama, Romance",A widower finds out the woman he fell in love with is his brother's girlfriend.,65.0,Peter Hedges,Dan in Real Life,2007,98,USA, 25000000,47642963,68380495,20737532,43380495,1
47284,86.0,"Comedy, Crime, Family","Teen detective Nancy Drew accompanies her father on a business trip to Los Angeles, where she happens upon clues to a murder mystery involving a movie star.",53.0,Andrew Fleming,Nancy Drew,2007,99,USA, 20000000,25612520,30666930,5054410,10666930,1
48125,224.0,"Action, Horror, Sci-Fi","Warring Alien and Predator races descend on a rural Colorado town, where unsuspecting residents must band together for any chance of survival.",29.0,"Colin Strause, Greg Strause",AVPR: Aliens vs Predator - Requiem,2007,94,USA, 40000000,41797066,128883756,87086690,88883756,1
47223,242.0,"Comedy, Romance","For fun-loving party animal Ben Stone, the last thing he ever expected was for his one-night stand to show up on his doorstep eight weeks later to tell him she's pregnant with his child.",85.0,Judd Apatow,Knocked Up,2007,129,USA, 30000000,148768917,219076518,70307601,189076518,1
48115,184.0,"Comedy, Drama","Margot and her son Claude decide to visit her sister Pauline after she announces that she is marrying less-than-impressive Malcolm. In short order, the storm the sisters create leaves behind a mess of thrashed relationships and exposed family secrets.",66.0,Noah Baumbach,Margot at the Wedding,2007,93,USA, 10000000,1959420,2897757,938337,-7102243,0
48073,87.0,"Comedy, Crime",A rag-tag team of Reno cops are called in to save the day after a terrorist attack disrupts a national police convention in Miami Beach during spring break. Based on the Comedy Central series.,47.0,Robert Ben Garant,Reno 911!: Miami,2007,84,USA, 10000000,20342161,22021262,1679101,12021262,1
47329,338.0,"Drama, Sci-Fi, Thriller","Years after a plague kills most of humanity and transforms the rest into monsters, the sole survivor in New York City struggles valiantly to find a cure in this post-apocalyptic action thriller.",65.0,Francis Lawrence,I Am Legend,2007,101,USA, 150000000,256393010,585349010,328956000,435349010,1
47362,174.0,"Comedy, Drama, Romance",The life of a top chef changes when she becomes the guardian of her young niece.,50.0,Scott Hicks,No Reservations,2007,104,USA, 28000000,43107979,92601050,49493071,64601050,1
50437,14.0,"Drama, Romance","Young, beautiful and intelligent, Trevor (screenwriter Brent Gorski) is in a stalemate. Entangled in an unhealthy relationship with Darrell, a self-destructive heroin addict, and trapped in...",36.0,Rosser Goodman,Holding Trevor,2007,88,USA, 55000,16814,16814,0,-38186,0
47699,105.0,"Comedy, Fantasy, Horror","Mistaken for his character Ash from the 'Evil Dead' trilogy,",36.0,Bruce Campbell,My Name Is Bruce,2007,84,USA, 1500000,173066,173066,0,-1326934,0
47700,96.0,"Comedy, Drama, Romance","A college graduate goes to work as a nanny for a rich New York family. Ensconced in their home, she has to juggle their dysfunction, a new romance, and the spoiled brat in her charge.",46.0,"Shari Springer Berman, Robert Pulcini",The Nanny Diaries,2007,106,USA, 20000000,25930652,47738099,21807447,27738099,1
47597,242.0,"Crime, Drama, Mystery",A teen living under house arrest becomes convinced his neighbor is a serial killer.,62.0,D.J. Caruso,Disturbia,2007,105,USA, 20000000,80209692,117760134,37550442,97760134,1
50379,131.0,"Animation, Comedy, Family",Three musical chipmunks are discovered by an aspiring songwriter and wants to become famous by using their amazing singing abilities.,39.0,Tim Hill,Alvin and the Chipmunks,2007,92,USA, 60000000,217326974,361336633,144009659,301336633,1
50408,19.0,"Animation, Family","In this animated adaptation of the Bible story Moses hears the voice of God from a burning bush, which inspires him to confront Egypt's pharaoh and demand freedom for the Israelite slaves. ...",25.0,"Bill Boyce, John Stronach",The Ten Commandments,2007,88,USA, 10000000,952820,1051907,99087,-8948093,0
47742,153.0,Drama,A man who lost his family in the September 11 attack on New York City runs into his old college roommate. Rekindling the friendship is the one thing that appears able to help the man recover from his grief.,61.0,Mike Binder,Reign Over Me,2007,124,USA, 20000000,19661987,22222308,2560321,2222308,1
47770,45.0,"Drama, Thriller",A reclusive telemarketer has only one semblance of a friend: His telecommuter boss. But the telemarketer's social circle seems to improve greatly when a whimsical co-worker enters his life....,40.0,"Adam Green, Joel David Moore",Spiral,2007,90,USA, 600000,3072,3072,0,-596928,0
47575,139.0,"Comedy, Family, Fantasy","Fred Claus, Santa's bitter older brother, is forced to move to the North Pole to help Santa and the elves prepare for Christmas in exchange for cash.",42.0,David Dobkin,Fred Claus,2007,116,USA, 100000000,72006777,97838349,25831572,-2161651,0
50269,35.0,"Comedy, Drama, Romance",A Christmastime drama centered around the Whitfield family's first holiday together in four years.,63.0,Preston A. Whitmore II,This Christmas,2007,117,USA, 13000000,49121934,49778552,656618,36778552,1
47822,115.0,"Comedy, Family, Sport",An NFL quarterback living the bachelor lifestyle discovers that he has an 8-year-old daughter from a previous relationship.,44.0,Andy Fickman,The Game Plan,2007,110,USA, 22000000,90648202,147880543,57232341,125880543,1
47502,105.0,"Adventure, Drama, Family",A boy's life is turned upside down when he learns that he is the last of a group of immortal warriors who have dedicated their lives to fighting the forces of the dark.,38.0,David L. Cunningham,The Seeker: The Dark Is Rising,2007,99,USA, 45000000,8794452,31400740,22606288,-13599260,0
47964,249.0,"Crime, Thriller","Danny Ocean rounds up the boys for a third heist, after casino owner Willy Bank double-crosses one of the original eleven, Reuben Tishkoff.",62.0,Steven Soderbergh,Ocean's Thirteen,2007,122,USA, 85000000,117154724,311312624,194157900,226312624,1
47697,27.0,Comedy,"A dark comedy which chronicles the final day in the life of self-proclaimed artist and genius, K. Roth Binew. Binew is a dreamer who elevates his drab and somewhat pitiful existence into a ...",37.0,Sol Tryon,The Living Wake,2007,91,USA, 500000,12232,12232,0,-487768,0
47997,47.0,"Comedy, Drama, Fantasy","A guy's life is turned around by an email, which includes the names of everyone he's had sex with and ever will have sex with. His situation gets worse when he encounters a femme fatale (Ryder) who targets men guilty of sex crime.",24.0,Daniel Waters,Sex and Death 101,2007,117,USA, 5000000,23624,1229330,1205706,-3770670,0
47466,59.0,"Comedy, Crime, Drama","A professor of chemistry wins the Nobel Prize. His wife joins him to Stockholm but his PhD. working son gets kidnapped. The kidnapper demands $2,000,000 = prize sum.",28.0,Randall Miller,Nobel Son,2007,110,USA, 4000000,540382,550782,10400,-3449218,0
52964,298.0,"Horror, Mystery, Thriller","After moving into a suburban home, a couple becomes increasingly disturbed by a nightly demonic presence.",68.0,Oren Peli,Paranormal Activity,2007,86,USA, 15000,107918810,193355800,85436990,193340800,1
45197,134.0,"Comedy, Drama, Romance",A young widow discovers that her late husband has left her 10 messages intended to help ease her pain and start a new life.,39.0,Richard LaGravenese,P.S. I Love You,2007,126,USA, 30000000,53695808,156835339,103139531,126835339,1
48264,94.0,"Drama, Family","Upon hearing his wife was killed in the Iraq war, a father takes his two daughters on a road trip.",65.0,Jim Strouse,Grace Is Gone,2007,85,USA, 2000000,50899,1066141,1015242,-933859,0
48140,174.0,"Comedy, Music, Romance","A washed up singer is given a couple days to compose a chart-topping hit for an aspiring teen sensation. Though he's never written a decent lyric in his life, he sparks with an offbeat younger woman with a flair for words.",59.0,Marc Lawrence,Music and Lyrics,2007,96,USA, 40000000,50572589,145896422,95323833,105896422,1
49321,33.0,Comedy,"Bruce Lee's shocking death left legions of stunned fans and a legacy of 12 minutes from his unfinished Game Of Death. Undeterred, studio executives launched a search for his replacement chronicled here through the eyes of five aspiring thespians who find out what the real game is.",46.0,Justin Lin,Finishing the Game: The Search for a New Bruce Lee,2007,84,USA, 500000,52868,53570,702,-446430,0
49293,168.0,"Comedy, Music",Singer Dewey Cox overcomes adversity to become a musical legend.,63.0,Jake Kasdan,Walk Hard: The Dewey Cox Story,2007,96,USA, 35000000,18317151,20575243,2258092,-14424757,0
49290,30.0,"Comedy, Family, Fantasy",A young girl turns to a department store Santa in the hopes that he will help find a new husband for her divorced mother.,32.0,Lance Rivera,The Perfect Holiday,2007,96,USA, 20000000,5812781,5812781,0,-14187219,0
48646,61.0,"Comedy, Family, Music","During their first year of high school, four best girlfriends face off against the domineering student body President, who wants to split them up into different social cliques.",21.0,Sean McNamara,Bratz,2007,110,USA, 20000000,10010209,26013153,16002944,6013153,1
48647,174.0,"Action, Crime, Thriller","Nick Hume is a mild-mannered executive with a perfect life, until one gruesome night he witnesses something that changes him forever. Transformed by grief, Hume eventually comes to the disturbing conclusion that no length is too great when protecting his family.",36.0,James Wan,Death Sentence,2007,105,USA, 20000000,9534258,16974459,7440201,-3025541,0
48658,161.0,"Crime, Horror, Thriller",A businesswoman is pursued by a psychopath after being locked in a parking garage on Christmas Eve.,37.0,Franck Khalfoun,P2,2007,98,USA, 8000000,3995018,7766240,3771222,-233760,0
48660,134.0,"Drama, Thriller","When a terrorist bombing in North Africa kills 19 incl. an American, an Egyptian chemical engineer flying from South Africa to his wife in USA, is arrested upon arriving USA. He disappears. His wife asks senator for help.",55.0,Gavin Hood,Rendition,2007,122,USA, 27500000,9736045,27038732,17302687,-461268,0
39491,200.0,"Crime, Drama, Thriller","When two brothers organize the robbery of their parent's jewelry store the job goes horribly wrong, triggering a series of events that sends them, their father and one brother's wife hurtling towards a shattering climax.",84.0,Sidney Lumet,Before the Devil Knows You're Dead,2007,117,USA, 18000000,7084227,25038417,17954190,7038417,1
49261,282.0,"Adventure, Comedy, Drama","A year after their father's funeral, three brothers travel across India by train in an attempt to bond with each other.",67.0,Wes Anderson,The Darjeeling Limited,2007,91,USA, 16000000,11902715,35078918,23176203,19078918,1
48814,18.0,Drama,"In seeking her own redemption from the man of whom she is most afraid, ten-year-old Cadi Forbes discovers a secret sin haunting her community of Welsh immigrants in 1850s Appalachia.",37.0,Michael Landon Jr.,The Last Sin Eater,2007,117,USA, 2200000,388390,388390,0,-1811610,0
48831,20.0,Drama,A pool shark takes the ultimate gamble when she kidnaps her own son and flees her ex-husband.,55.0,Chris Eigeman,Turn the River,2007,92,USA, 500000,5149,5149,0,-494851,0
38931,40.0,"Crime, Drama","Brooklyn, 1985. With the mob world as a backdrop, three life-long friends struggle with questions of love, loss and loyalty.",53.0,Michael Corrente,Brooklyn Rules,2007,99,USA, 8000000,458232,458232,0,-7541768,0
48865,34.0,"Comedy, Romance, Sport",Jerry Ferro's 40th birthday has brought his life into sharp relief and it's not a pretty picture. A once-promising amateur boxer -- who quit so he wouldn't risk his perfect record of ...,57.0,Charles Herman-Wurmfeld,The Hammer,2007,88,USA, 850000,443591,443591,0,-406409,0
48898,76.0,"Drama, Fantasy, Mystery",A woman's survivor's guilt from a Columbine-like event twenty years ago causes her present-day idyllic life to fall apart.,38.0,Vadim Perelman,The Life Before Her Eyes,2007,90,USA, 13000000,303439,7248490,6945051,-5751510,0
48905,71.0,"Comedy, Drama, Romance",A modern retelling of Snow White set against students in their freshman year of college in the greek system.,45.0,Joe Nussbaum,Sydney White,2007,108,USA, 16500000,11892415,13620075,1727660,-2879925,0
49143,265.0,Comedy,Two co-dependent high school seniors are forced to deal with separation anxiety after their plan to stage a booze-soaked party goes awry.,76.0,Greg Mottola,Superbad,2007,113,USA, 20000000,121463226,169871719,48408493,149871719,1
49131,70.0,"Crime, Drama, History","1950. Rural Alabama. Cotton harvest. It's a make-or-break weekend for the Honeydripper Lounge and its owner, piano player Tyrone ""Pine Top"" Purvis. Deep in debt to the liquor man, the ...",68.0,John Sayles,Honeydripper,2007,124,USA, 5000000,267880,544925,277045,-4455075,0
49051,201.0,"Comedy, Drama",Two terminally ill men escape from a cancer ward and head off on a road trip with a wish list of to-dos before they die.,42.0,Rob Reiner,The Bucket List,2007,97,USA, 45000000,93466502,175372502,81906000,130372502,1
35546,133.0,"Crime, Drama, Mystery",A wealthy young man undergoing heart transplant surgery discovers that the surgical team intend to murder him.,33.0,Joby Harold,Awake,2007,84,USA, 8600000,14377198,32685679,18308481,24085679,1
48595,162.0,"Horror, Thriller",A group of National Guard trainees find themselves battling against a vicious group of mutants on their last day of training in the desert.,32.0,Martin Weisz,The Hills Have Eyes II,2007,89,USA, 15000000,20804166,37466538,16662372,22466538,1
48587,113.0,"Adventure, Comedy",A spoof on previous years' epic movies (,17.0,"Jason Friedberg, Aaron Seltzer",Epic Movie,2007,86,USA, 20000000,39739367,86865564,47126197,66865564,1
48563,126.0,"Comedy, Crime, Romance","While drying out on the West Coast, an alcoholic hitman befriends a tart-tongued woman who might just come in handy when it's time for him to return to Buffalo and settle some old scores.",64.0,John Dahl,You Kill Me,2007,93,USA, 4000000,2429367,3748295,1318928,-251705,0
50014,42.0,"Comedy, Drama","The big screen adaptation of Perry's stage play about the trials of marriage, and what happens to one family when a sexy young temptress arrives on the scene.",54.0,Tyler Perry,Why Did I Get Married?,2007,113,USA, 15000000,55204525,55862886,658361,40862886,1
48172,173.0,"Comedy, Romance","Two straight, single Brooklyn firefighters pretend to be a gay couple in order to receive domestic partner benefits.",37.0,Dennis Dugan,I Now Pronounce You Chuck & Larry,2007,115,USA, 85000000,120059556,186054170,65994614,101054170,1
49933,145.0,"Crime, Drama, Mystery","A young woman who was missing reappears, but she claims to be someone else entirely.",16.0,Chris Sivertson,I Know Who Killed Me,2007,105,USA, 12000000,7498716,9669758,2171042,-2330242,0
48211,9.0,"Drama, Thriller","They are married men that pass H.I.V. to their male or female partners. Many of the men hide behind the vow of marriage, but still desire men. The women know, but have grown accustomed to the extravagant lifestyle.",30.0,Bill Duke,Cover,2007,98,USA, 3600000,79436,79436,0,-3520564,0
49863,234.0,"Crime, Drama, Mystery","Injuries sustained by two Army rangers behind enemy lines in Afghanistan set off a sequence of events involving a congressman, a journalist and a professor.",47.0,Robert Redford,Lions for Lambs,2007,92,USA, 35000000,15002854,63215872,48213018,28215872,1
48229,34.0,Drama,"The military draft is back, three best friends are drafted and given 30 days to report for duty. In that time, they're forced to confront everything they believe about courage, duty, love, friendship and honor.",41.0,Bryan Gunnar Cole,Day Zero,2007,92,USA, 2000000,16659,16659,0,-1983341,0
49777,357.0,"Horror, Sci-Fi","A freak storm unleashes a species of bloodthirsty creatures on a small town, where a small band of citizens hole up in a supermarket and fight for their lives.",58.0,Frank Darabont,The Mist,2007,126,USA, 18000000,25594957,57293715,31698758,39293715,1
48294,30.0,"Crime, Drama, Thriller","When the thugs who killed his father come looking for him, a young Latino man and his mother flee from their home.",40.0,Franc. Reyes,Illegal Tender,2007,108,USA, 8000000,3106835,3106835,0,-4893165,0
48298,83.0,"Drama, Music, Romance","When his brother is murdered, a street dancer moves to Georgia to work his way thru college. He joins a fraternity's step dancing team for a competition. Will he also get an education and the girl?",44.0,Sylvain White,Stomp the Yard,2007,109,USA, 13000000,61356221,75511123,14154902,62511123,1
48136,241.0,"Adventure, Biography, Drama","After graduating from Emory University, top student and athlete Christopher McCandless abandons his possessions, gives his entire $24,000 savings account to charity and hitchhikes to Alaska to live in the wilderness. Along the way, Christopher encounters a series of characters that shape his life.",73.0,Sean Penn,Into the Wild,2007,148,USA, 15000000,18354356,56255142,37900786,41255142,1
48317,31.0,"Drama, Romance",A mechanic falls in love with his attorney.,49.0,Tyler Perry,Daddy's Little Girls,2007,100,USA, 10000000,31366978,31609243,242265,21609243,1
48363,32.0,Action,A gorgeous young automobile fanatic--and front to the hottest unsigned band on the West coast--finds herself caught up in illegal drag-racing competitions organized by exotic car fanatics.,24.0,Andy Cheng,Redline,2007,95,USA, 26000000,6881022,8267379,1386357,-17732621,0
48365,143.0,"Horror, Sci-Fi, Thriller","A horror film told in three parts, from three perspectives, in which a mysterious transmission that turns people into killers invades every cell phone, radio, and television.",63.0,"David Bruckner, Dan Bush",The Signal,2007,103,USA, 50000,251150,1040386,789236,990386,1
48403,28.0,Drama,College student Charlie Banks has to face old problems when the bully he had an unpleasant encounter with back in high school shows up on his campus.,50.0,Fred Durst,The Education of Charlie Banks,2007,100,USA, 5000000,15078,15078,0,-4984922,0
48424,54.0,Comedy,"A pair of well-meaning, but socially inept brothers try to find their perfect mates in order to provide their dying father with a grandchild.",32.0,Bob Odenkirk,The Brothers Solomon,2007,93,USA, 10000000,900926,1035056,134130,-8964944,0
48438,25.0,"Comedy, Sport",When a rap mogul from Atlanta tries to join a conservative country club in the Carolinas he runs into fierce opposition from the board President- but it's nothing that he and his entourage can't handle.,18.0,Don Michael Paul,Who's Your Caddy?,2007,93,USA, 7000000,5713425,5713425,0,-1286575,0
49522,26.0,"Action, Adventure, Comedy","Two former thieves reunite to rob the biggest thief they know -- Moctesuma Valdez, a TV infomercial guru who's made millions selling worthless health products to poor Latino immigrants. When none of their affiliates want to go undercover as day laborers to pull off the heist, the two men turn to the real thing for help.",61.0,Joe Menendez,Ladr√≥n que roba a ladr√≥n,2007,98,USA, 1200000,4011254,6875089,2863835,5675089,1
48469,14.0,"Comedy, Romance","It's a case of mistaken ethnicity, where two non-Italians pretend to be Italian to win each others hearts in Boston's North End.",26.0,Jason Todd Ipson,Everybody Wants to Be Italian,2007,105,USA, 3000000,351416,532726,181310,-2467274,0
49499,230.0,Drama,A college professor travels to New York City to attend a conference and finds a young couple living in his apartment.,79.0,Tom McCarthy,The Visitor,2007,104,USA, 4000000,9427089,18078175,8651086,14078175,1
49427,283.0,"Fantasy, Horror, Sci-Fi",A group of young film students run into real-life zombies while filming a horror movie of their own.,66.0,George A. Romero,Diary of the Dead,2007,95,USA, 2000000,958961,5540941,4581980,3540941,1
48486,50.0,"Comedy, Sport","A comedy that spoofs inspirational sports movies, this movie tells the story of an out-of-luck coach, Lambeau Fields, who takes a rag-tag bunch of college misfits and drives them towards the football championships. In the process, this life-long loser discovers that he is a winner after all by redeeming himself, saving his relationship with his family and friends, and finding that there is indeed...",25.0,Tom Brady,The Comebacks,2007,84,USA, 20000000,13349927,13539154,189227,-6460846,0
48498,84.0,"Comedy, Drama","A troubled young woman is sent to live with her grandmother for the summer, while hiding a secret that could potentially tear her family apart.",25.0,Garry Marshall,Georgia Rule,2007,113,USA, 20000000,19103072,24991167,5888095,4991167,1
48359,218.0,"Crime, Drama, Thriller",A well-respected businessman is sometimes controlled by his murder and mayhem-loving alter ego.,45.0,Bruce A. Evans,Mr. Brooks,2007,120,USA, 20000000,28549298,48121900,19572602,28121900,1
43128,294.0,"Action, Crime, Drama",A small-time rancher agrees to hold a captured outlaw who's awaiting a train to go to court in Yuma. A battle of wills ensues as the outlaw tries to psych out the rancher.,76.0,James Mangold,3:10 to Yuma,2007,122,USA, 55000000,53606916,70016220,16409304,15016220,1
42711,348.0,Horror,"After being committed for 17 years, Michael Myers, now a grown man and still very dangerous, escapes from the mental institution and immediately returns to Haddonfield to find his baby sister, Laurie.",47.0,Rob Zombie,Halloween,2007,109,USA, 15000000,58272029,80253908,21981879,65253908,1
43715,174.0,"Animation, Adventure, Comedy","Lewis is a brilliant inventor who meets mysterious stranger named Wilbur Robinson, whisking Lewis away in a time machine and together they team up to track down Bowler Hat Guy in a showdown that ends with an unexpected twist of fate.",61.0,Stephen J. Anderson,Meet the Robinsons,2007,95,USA, 150000000,97822171,169333034,71510863,19333034,1
46529,305.0,"Animation, Adventure, Comedy","After Homer accidentally pollutes the town's water supply, Springfield is encased in a gigantic dome by the EPA and the family are declared fugitives.",80.0,David Silverman,The Simpsons Movie,2007,87,USA, 75000000,183135014,527071022,343936008,452071022,1
45923,306.0,"Fantasy, Horror, Mystery","A man who specialises in debunking paranormal occurrences checks into the fabled room 1408 in the Dolphin Hotel. Soon after settling in, he confronts genuine terror.",64.0,Mikael H√•fstr√∂m,1408,2007,104,USA, 25000000,71985628,132033383,60047755,107033383,1
46633,189.0,"Action, Adventure, Mystery",Benjamin Gates must follow a clue left in John Wilkes Booth's diary to prove his ancestor's innocence in the assassination of Abraham Lincoln.,48.0,Jon Turteltaub,National Treasure: Book of Secrets,2007,124,USA, 130000000,219964115,457364600,237400485,327364600,1
46649,311.0,"Crime, Drama, Mystery","A law firm brings in its ""fixer"" to remedy the situation after a lawyer has a breakdown while representing a chemical company that he knows is guilty in a multibillion-dollar class action suit.",82.0,Tony Gilroy,Michael Clayton,2007,119,USA, 25000000,49033882,92991835,43957953,67991835,1
45864,324.0,"Action, Adventure, Fantasy","Captain Barbossa, Will Turner and Elizabeth Swann must sail off the edge of the map, navigate treachery and betrayal, find Jack Sparrow, and make their final alliances for one last decisive battle.",50.0,Gore Verbinski,Pirates of the Caribbean: At World's End,2007,169,USA, 300000000,309420425,960996492,651576067,660996492,1
46653,215.0,Action,"A man named Mr. Smith delivers a woman's baby during a shootout, and is then called upon to protect the newborn from the army of gunmen.",49.0,Michael Davis,Shoot 'Em Up,2007,86,USA, 39000000,12807139,26012272,13205133,-12987728,0
43806,185.0,"Drama, Family, Fantasy",A preteen's life turns upside down when he befriends the new girl in school and they imagine a whole new fantasy world to escape reality.,74.0,Gabor Csupo,Bridge to Terabithia,2007,96,USA, 17000000,82272442,137587063,55314621,120587063,1
46726,383.0,"Comedy, Drama","Faced with an unplanned pregnancy, an offbeat young woman makes an unusual decision regarding her unborn child.",81.0,Jason Reitman,Juno,2007,96,USA, 7500000,143495265,231411584,87916319,223911584,1
46801,422.0,Drama,"A story of family, religion, hatred, oil and madness, focusing on a turn-of-the-century prospector in the early days of the business.",93.0,Paul Thomas Anderson,There Will Be Blood,2007,158,USA, 25000000,40222514,76181545,35959031,51181545,1
44466,107.0,"Drama, Sport","Up-and-coming sports reporter rescues a homeless man (""Champ"") only to discover that he is, in fact, a boxing legend believed to have passed away. What begins as an opportunity to resurrect Champ's story and escape the shadow of his father's success becomes a personal journey as the ambitious reporter reexamines his own life and his relationship with his family.",55.0,Rod Lurie,Resurrecting the Champ,2007,112,USA, 13000000,3172573,3243611,71038,-9756389,0
45731,150.0,"Comedy, Sport","In 2002, two rival Olympic ice skaters were stripped of their gold medals and permanently banned from men's single competition. Presently, however, they've found a loophole that will allow them to qualify as a pairs team.",64.0,"Josh Gordon, Will Speck",Blades of Glory,2007,93,USA, 61000000,118594548,145708642,27114094,84708642,1
45687,189.0,"Horror, Thriller","A former Christian missionary, who specializes in debunking religious phenomena, investigates a small town which seems to be suffering from the 10 biblical plagues.",36.0,Stephen Hopkins,The Reaping,2007,99,USA, 40000000,25126214,62771059,37644845,22771059,1
45664,403.0,"Crime, Drama, Mystery","In the late 1960s/early 1970s, a San Francisco cartoonist becomes an amateur detective obsessed with tracking down the Zodiac Killer, an unidentified individual who terrorizes Northern California with a killing spree.",78.0,David Fincher,Zodiac,2007,157,USA, 65000000,33080084,84785914,51705830,19785914,1
44198,172.0,"Comedy, Romance",A newly wed man who believes he's just gotten hitched to the perfect woman encounters another lady on his honeymoon.,46.0,"Bobby Farrelly, Peter Farrelly",The Heartbreak Kid,2007,116,USA, 60000000,36787257,127766650,90979393,67766650,1
46496,53.0,"Comedy, Family","Seeking to offer his son the satisfying summer camp experience that eluded him as a child, the operator of a neighborhood daycare center opens his own camp, only to face financial hardship and stiff competition from a rival camp.",13.0,Fred Savage,Daddy Day Camp,2007,89,USA, 6000000,13235267,18197398,4962131,12197398,1
46492,52.0,"Action, Comedy, Crime","An amnesiac wakes up in a hotel room next to a dead FBI agent and $250,000. Is the sexy lady in the lobby his wife? Is he a spy or a cleaner?",33.0,Les Mayfield,Code Name: The Cleaner,2007,84,USA, 20000000,8135024,10337477,2202453,-9662523,0
46466,228.0,"Animation, Comedy, Family","A young maiden in a land called Andalasia, who is prepared to be wed, is sent away to New York City by an evil queen, where she falls in love with a lawyer.",75.0,Kevin Lima,Enchanted,2007,107,USA, 85000000,127807262,340487652,212680390,255487652,1
44441,38.0,"Drama, Music","A drama set in the American South, where a precocious, troubled girl finds a safe haven in the music and movement of",31.0,Deborah Kampmeier,Hounddog,2007,102,USA, 3750000,131961,131961,0,-3618039,0
46161,81.0,"Animation, Action, Adventure","An action epic that explores the origins of Master Shake, Frylock, and Meatwad, better known as the Aqua Teen Hunger Force, who somehow become pitted in a battle over an immortal piece of exercise equipment.",54.0,"Matt Maiellaro, Dave Willis",Aqua Teen Hunger Force Colon Movie Film for Theaters,2007,86,USA, 750000,5520368,5520368,0,4770368,1
46178,173.0,"Horror, Mystery, Thriller","A young widower returns to his hometown to search for answers to his wife's murder, which may be linked to the ghost of a murdered ventriloquist.",34.0,James Wan,Dead Silence,2007,89,USA, 20000000,16809076,22217407,5408331,2217407,1
44344,413.0,"Action, Sci-Fi","A strange black entity from another world bonds with Peter Parker and causes inner turmoil as he contends with new villains, temptations, and revenge.",59.0,Sam Raimi,Spider-Man 3,2007,139,USA, 258000000,336530303,890871626,554341323,632871626,1
51091,14.0,Drama,"August Evening follows an aging undocumented farm worker named Jaime and his young, widowed daughter-in-law, Lupe, as their lives are thrown into upheaval. Lupe is more of a daughter to ...",68.0,Chris Eska,August Evening,2007,128,USA, 35000,74759,74759,0,39759,1
44342,227.0,"Animation, Adventure, Comedy","When his new father-in-law, King Harold falls ill, Shrek is looked at as the heir to the land of Far, Far Away. Not one to give up his beloved swamp, Shrek recruits his friends Donkey and Puss in Boots to install the rebellious Artie as the new king. Princess Fiona, however, rallies a band of royal girlfriends to fend off a coup d'etat by the jilted Prince Charming.",58.0,"Chris Miller, Raman Hui",Shrek the Third,2007,93,USA, 160000000,322719944,804438141,481718197,644438141,1
44821,158.0,"Animation, Comedy, Family","A behind-the-scenes look at the annual Penguin World Surfing Championship, and its newest participant, up-and-comer Cody Maverick.",64.0,"Ash Brannon, Chris Buck",Surf's Up,2007,85,USA, 100000000,58867694,149044471,90176777,49044471,1
46196,183.0,"Crime, Thriller",A serial killer pins his crimes on two college students who gave him a ride.,28.0,Dave Meyers,The Hitcher,2007,84,USA, 10000000,16472961,25399945,8926984,15399945,1
44340,188.0,"Comedy, Family, Fantasy",God contacts Congressman Evan Baxter and tells him to build an ark in preparation for a great flood.,37.0,Tom Shadyac,Evan Almighty,2007,96,USA, 175000000,100462298,173418781,72956483,-1581219,0
47198,27.0,"Drama, Horror, Thriller","A Seattle history professor, drawn back to his estranged family on the Oregon coast to execute his late mother's estate, is reaquainted with his best friend from childhood, with whom he has...",41.0,Dan Gildark,Cthulhu,2007,100,USA, 750000,15213,15213,0,-734787,0
46043,227.0,"Horror, Thriller","A married couple becomes stranded at an isolated motel and finds hidden video cameras in their room. They soon realize that unless they escape, they'll be the next victims of a snuff film.",54.0,Nimr√≥d Antal,Vacancy,2007,85,USA, 19000000,19363565,35300645,15937080,16300645,1
46286,165.0,"Crime, Drama, Horror","A journalist goes undercover to ferret out businessman Harrison Hill as her childhood friend's killer. Posing as one of his temps, she enters into a game of online cat-and-mouse.",31.0,James Foley,Perfect Stranger,2007,109,USA, 60795000,23984949,73090611,49105662,12295611,1
44660,80.0,"Comedy, Drama, Romance",A sleazy writer has a chance to redeem himself when he goes to stay with his grandmother and befriends the neighbors.,47.0,Jonathan Kasdan,In the Land of Women,2007,97,USA, 10000000,11052958,17562071,6509113,7562071,1
46023,262.0,"Crime, Drama, Mystery","Two Boston area detectives investigate a little girl's kidnapping, which ultimately turns into a crisis both professionally and personally.",72.0,Ben Affleck,Gone Baby Gone,2007,114,USA, 19000000,20292962,34612443,14319481,15612443,1
44670,84.0,"Comedy, Romance, Sport","Taken aback by his mother's wedding announcement, a young man returns home in an effort to stop her from marrying his old high school gym teacher, a man who made middle school hell for generations of students.",41.0,Craig Gillespie,Mr. Woodcock,2007,87,USA, 22000000,25799486,33621851,7822365,11621851,1
44573,392.0,"Action, Adventure, Sci-Fi","An ancient struggle between two Cybertronian races, the heroic Autobots and the evil Decepticons, comes to Earth, with a clue to the ultimate power held by a teenager.",61.0,Michael Bay,Transformers,2007,144,USA, 150000000,319246193,709709780,390463587,559709780,1
49025,201.0,"Action, Drama, Thriller","A marksman living in exile is coaxed back into action after learning of a plot to kill the President. Ultimately double-crossed and framed for the attempt, he goes on the run to find the real killer and the reason he was set up.",53.0,Antoine Fuqua,Shooter,2007,124,USA, 61000000,47003582,95696996,48693414,34696996,1
44451,111.0,"Comedy, Drama, Family","A science-fiction writer, recently widowed, considers whether to adopt a hyper-imaginative 6-year-old abandoned and socially rejected boy who says he's really from Mars.",48.0,Menno Meyjes,Martian Child,2007,106,USA, 27000000,7500310,9411042,1910732,-17588958,0
44848,124.0,"Comedy, Drama, Romance",A rich kid becomes the self-appointed psychiatrist to the student body of his new high school.,54.0,Jon Poll,Charlie Bartlett,2007,97,USA, 12000000,3951699,5254986,1303287,-6745014,0
47143,125.0,"Comedy, Romance","A mild-mannered guy, who is married to a monstrous woman, meets the woman of his dreams, and schemes to find a way to be with her.",27.0,Brian Robbins,Norbit,2007,102,USA, 60000000,95673607,159313561,63639954,99313561,1
47135,183.0,"Action, Crime, Drama","Struggling to recover emotionally from a brutal assault that killed her fianc√© and left her in a coma, a radio personality begins a quest for vengeance against the perpetrators that leaves a bloody trail across New York City.",56.0,Neil Jordan,The Brave One,2007,122,USA, 70000000,36793804,69787394,32993590,-212606,0
45030,228.0,"Crime, Drama, Thriller","Chris is a once promising high school athlete whose life is turned upside down following a tragic accident. As he tries to maintain a normal life, he takes a job as a janitor at a bank, where he ultimately finds himself caught up in a planned heist.",73.0,Scott Frank,The Lookout,2007,99,USA, 16000000,4600585,5371181,770596,-10628819,0
50729,86.0,"Comedy, Romance","Broke and alone on New Year's Eve, Wilson just wants to spend the rest of a very bad year in bed. But, when his best friend convinces him to post a personal ad, he meets a woman bent on finding the right guy to be with at midnight.",64.0,Alex Holdridge,In Search of a Midnight Kiss,2007,90,USA, 25000,172605,1294176,1121571,1269176,1
45053,50.0,Comedy,An improvisational comedy using a handful of actors playing characters competing in an actual poker tournament.,57.0,Zak Penn,The Grand,2007,104,USA, 5400000,115879,115879,0,-5284121,0
45018,107.0,"Biography, Drama, Romance","A drama based on the true story of Melvin B. Tolson, a professor at Wiley College Texas. In 1935, he inspired students to form the school's first debate team, which went on to challenge Harvard in the national championship.",65.0,Denzel Washington,The Great Debaters,2007,126,USA, 15000000,30236407,30271556,35149,15271556,1
45006,149.0,"Drama, Music",An orphaned musical prodigy uses his gift to try to find his birth parents.,38.0,Kirsten Sheridan,August Rush,2007,114,USA, 30000000,31664162,66122026,34457864,36122026,1
43202,332.0,"Animation, Adventure, Comedy",A rat who can cook makes an unusual alliance with a young kitchen worker at a famous restaurant.,96.0,"Brad Bird, Jan Pinkava",Ratatouille,2007,111,USA, 150000000,206445654,623722818,417277164,473722818,1
47146,87.0,"Comedy, Drama","Looking for answers to life's big questions, a stuttering boy joins his high school debate team.",73.0,Jeffrey Blitz,Rocket Science,2007,101,USA, 6000000,714943,763578,48635,-5236422,0
44947,186.0,"Horror, Mystery, Thriller","An ominous darkness invades a seemingly serene sunflower farm in North Dakota, and the Solomon family is torn apart by suspicion, mayhem and murder.",34.0,"Danny Pang, Oxide Chun Pang",The Messengers,2007,90,USA, 16000000,35374833,55060212,19685379,39060212,1
44934,31.0,"Comedy, Crime, Drama",A man who is being driven crazy by the noise in New York City decides to take vigilante action against it.,55.0,Henry Bean,Noise,2007,92,USA,2000,16513,16934,421,14934,1
47145,144.0,"Drama, Fantasy, Mystery","A depressed woman learns that her husband was killed in a car accident the previous day, then awakens the next morning to find him alive and well at home; then awakens the day after that to find that he's dead.",29.0,Mennan Yapo,Premonition,2007,96,USA, 20000000,47852604,84297309,36444705,64297309,1
45520,14.0,"Comedy, Romance","When Tom comes home on Valentine's Day to a ""Dear John"" Letter from his girlfriend, he spends the rest of the night talking to his four best friends about woman, sex & love until five women show up and the battle of the sexes begins.",14.0,Mars Callahan,What Love Is,2007,93,USA, 8500000,18901,18901,0,-8481099,0
43456,91.0,"Comedy, Drama",An unstable dad who after getting out of a mental institution tries to convince his daughter that there's Spanish gold buried somewhere under suburbia.,63.0,Mike Cahill,King of California,2007,93,USA, 10000000,268461,1045786,777325,-8954214,0
45546,63.0,"Biography, Drama, Sport",A teenager faces an uphill battle when she fights to give women the opportunity to play competitive soccer.,52.0,Davis Guggenheim,Gracie,2007,95,USA, 9000000,2956339,3826568,870229,-5173432,0
45356,192.0,"Action, Sci-Fi, Thriller",A Las Vegas magician who can see into the future is pursued by FBI agents seeking to use his abilities to prevent a nuclear terrorist attack.,42.0,Lee Tamahori,Next,2007,96,USA, 70000000,18211013,77421190,59210177,7421190,1
46971,17.0,Comedy,Three quirky families seeking to buy their next home collide when trying to purchase the same property. The bidding war tests the limits of their marriages and the resolve of their agents.,58.0,"Armen Kaprelian, Kent Llewellyn",Closing Escrow,2007,93,USA, 600000,8719,8719,0,-591281,0
46984,175.0,"Comedy, Drama, Romance","Jenna is a pregnant, unhappily married waitress in the deep south. She meets a newcomer to her town and falls into an unlikely relationship as a last attempt at happiness.",75.0,Adrienne Shelly,Waitress,2007,108,USA, 1500000,19074800,22179430,3104630,20679430,1
47166,528.0,"Crime, Drama, Thriller",Violence and mayhem ensue after a hunter stumbles upon a drug deal gone wrong and more than two million dollars in cash near the Rio Grande.,91.0,"Ethan Coen, Joel Coen",No Country for Old Men,2007,122,USA, 25000000,74283625,171627166,97343541,146627166,1
51424,75.0,"Drama, Horror, Thriller","A girl with PTSD attempts to refresh her life at a new school, but soon finds it impossible when she's afflicted by not only bullying and bad memories, but also the supernatural.",28.0,Mickey Liddell,The Haunting of Molly Hartley,2008,82,USA, 5000000,13559812,15418749,1858937,10418749,1
51372,16.0,Comedy,A teenager with an early onset of male-pattern baldness befriends his high school's janitor.,10.0,T. Sean Shannon,Harold,2008,90,USA, 3500000,13229,13229,0,-3486771,0
51946,45.0,Drama,"A trucker, leading a life free of depth and on the way to nowhere, is forced to make a decision about her aggressive loner 11-year-old son whom she openly deserted ten years previously.",61.0,James Mottern,Trucker,2008,90,USA, 2000000,52429,52429,0,-1947571,0
49633,147.0,"Comedy, Romance","A successful, single businesswoman who dreams of having a baby discovers she is infertile and hires a working class woman to be her unlikely surrogate.",55.0,Michael McCullers,Baby Mama,2008,99,USA, 30000000,60494212,64163648,3669436,34163648,1
51435,77.0,"Comedy, Romance",Tank faces the ultimate test of friendship when his best friend hires him to take his ex-girlfriend out on a lousy date in order to make her realize how great her former boyfriend is.,34.0,Howard Deutch,My Best Friend's Girl,2008,101,USA, 20000000,19219250,41622502,22403252,21622502,1
49048,272.0,"Biography, Crime, Drama",Grief-stricken mother Christine Collins (Angelina Jolie) takes on the L.A.P.D. to her own detriment when it tries to pass off an obvious impostor as her missing child.,63.0,Clint Eastwood,Changeling,2008,141,USA, 55000000,35739802,113020256,77280454,58020256,1
51384,85.0,"Biography, Drama, Music",Chronicles the rise of Chess Records and its recording artists.,65.0,Darnell Martin,Cadillac Records,2008,109,USA, 12000000,8195551,8883019,687468,-3116981,0
51880,201.0,"Horror, Thriller","A television reporter and her cameraman are trapped inside a building quarantined by the CDC, after the outbreak of a mysterious virus which turns humans into bloodthirsty killers.",53.0,John Erick Dowdle,Quarantine,2008,89,USA, 12000000,31691811,41319906,9628095,29319906,1
51118,139.0,"Action, Drama, Sport",A frustrated and conflicted teenager arrives at a new high school to discover an underground fight club and meet a classmate who begins to coerce him into fighting.,39.0,Jeff Wadlow,Never Back Down,2008,110,USA, 20000000,24850922,41627431,16776509,21627431,1
49548,200.0,"Comedy, Drama","In order to raise the tuition to send her young son to private school, a mom starts an unusual business -- a biohazard removal/crime scene clean-up service -- with her unreliable sister.",61.0,Christine Jeffs,Sunshine Cleaning,2008,91,USA, 8000000,12062558,16580250,4517692,8580250,1
49175,228.0,"Action, Adventure, Crime","Rookie cop Denny Colt returns from the beyond as The Spirit, a hero whose mission is to fight against the bad forces in Central City.",30.0,Frank Miller,The Spirit,2008,103,USA, 60000000,19806188,39040174,19233986,-20959826,0
51125,98.0,"Drama, Music, Romance",Romantic sparks occur between two dance students from different backgrounds at the Maryland School of the Arts.,50.0,Jon M. Chu,Step Up 2: The Streets,2008,98,USA, 17500000,58017783,150988382,92970599,133488382,1
51276,192.0,"Crime, Mystery, Thriller",Two veteran New York City detectives work on a case of serial executions of criminals who escaped justice.,36.0,Jon Avnet,Righteous Kill,2008,101,USA, 60000000,40081410,79498846,39417436,19498846,1
49279,164.0,"Comedy, Sport","Jackie Moon, the owner-coach-player of the American Basketball Association's Flint Michigan Tropics, rallies his teammates to make their NBA dreams come true.",47.0,Kent Alterman,Semi-Pro,2008,91,USA, 55000000,33479698,43884230,10404532,-11115770,0
51765,112.0,Comedy,A spoof of,9.0,"Jason Friedberg, Aaron Seltzer",Meet the Spartans,2008,86,USA, 30000000,38233676,84646831,46413155,54646831,1
51268,126.0,"Action, Drama, History","Jewish brothers in Nazi-occupied Eastern Europe escape into the Belarussian forests, where they join Russian resistance fighters, and endeavor to build a village, in order to protect themselves and about one thousand Jewish non-combatants.",58.0,Edward Zwick,Defiance,2008,137,USA, 32000000,28644813,51155219,22510406,19155219,1
49269,191.0,Comedy,Two aimless middle-aged losers still living at home are forced against their will to become roommates when their parents marry.,51.0,Adam McKay,Step Brothers,2008,98,USA, 65000000,100468793,128107642,27638849,63107642,1
49255,48.0,Horror,"In rural Alabama, two couples find themselves in a fight for survival. Running from a maniac (The Tin Man) bent on killing them, they flee deep into the woods and seek refuge in a house. ...",24.0,Robby Henson,House,2008,88,USA, 2500000,575048,1141018,565970,-1358982,0
51258,148.0,"Comedy, Romance","A man and a woman are compelled, for legal reasons, to live life as a couple for a limited period of time. At stake is a large amount of money.",36.0,Tom Vaughan,What Happens in Vegas,2008,99,USA, 35000000,80277646,219375562,139097916,184375562,1
49533,12.0,"Drama, Sport",The true story about a father struggling to make amends with his twin sons as they pursue their dreams of professional baseball.,52.0,"Logan Miller, Noah Miller",Touching Home,2008,108,USA, 2000000,116353,116353,0,-1883647,0
49329,185.0,"Action, Adventure, Comedy","The Brothers Bloom are the best con men in the world, swindling millionaires with complex scenarios of lust and intrigue. Now they've decided to take on one last job - showing a beautiful and eccentric heiress the time of her life with a romantic adventure that takes them around the world.",55.0,Rian Johnson,The Brothers Bloom,2008,114,USA, 20000000,3531756,5530764,1999008,-14469236,0
51843,14.0,"Drama, Romance, War",The devastating legacy of a liaison between a concentration camp inmate and a Nazi doctor reflects on the lives of her sons.,39.0,Boaz Yakin,Death in Love,2008,97,USA, 3000000,23412,23412,0,-2976588,0
49342,41.0,Comedy,A wild weekend is in store for three high school seniors who visit a local college campus as prospective freshmen.,15.0,Deb Hagan,College,2008,94,USA, 7000000,4694636,6265483,1570847,-734517,0
51612,467.0,"Horror, Sci-Fi, Thriller",A group of friends venture deep into the streets of New York on a rescue mission during a rampaging monster attack.,64.0,Matt Reeves,Cloverfield,2008,85,USA, 25000000,80048433,170764026,90715593,145764026,1
51173,131.0,"Comedy, Drama","In a remarkable turn-of-events, the result of the presidential election comes down to one man's vote.",47.0,Joshua Michael Stern,Swing Vote,2008,120,USA, 21000000,16289867,17635397,1345530,-3364603,0
51140,158.0,"Comedy, Drama",A sex-addicted con-man pays for his mother's hospital bills by playing on the sympathies of those who rescue him from choking to death.,47.0,Clark Gregg,Choke,2008,92,USA, 3000000,2926565,3982459,1055894,982459,1
49210,16.0,Comedy,"An odd couple take to the open road. Having followed his girlfriend out to California's Wine Country for the summer, Yale law student Sherman finds himself dumped, and cut off from his ...",43.0,Craig M. Saavedra,Sherman's Way,2008,97,USA, 250000,13282,13282,0,-236718,0
49450,131.0,"Comedy, Romance","After Playboy bunny Shelley is kicked out of the playboy mansion, she finds a job as the house mother for a sorority full of socially awkward girls.",55.0,Fred Wolf,The House Bunny,2008,97,USA, 25000000,48237389,70431655,22194266,45431655,1
51228,126.0,"Comedy, Music","In the 1980s, a drummer is abandoned by his band just before they become rock superstars. Twenty years later, the drummer sees his second chance at stardom arise when he is asked to perform with his teenage nephew's high school rock band.",53.0,Peter Cattaneo,The Rocker,2008,102,USA, 15000000,6409528,8767338,2357810,-6232662,0
50630,158.0,"Crime, Drama","A mom looks for another source of income, when her husband leaves with the money meant for the new mobile home. A nearby Indian territory stretches across the border to Canada with a drivable frozen river between. Smugling?",82.0,Courtney Hunt,Frozen River,2008,97,USA, 1000000,2511476,5414283,2902807,4414283,1
51060,36.0,Drama,Family life gets in the way of a con man's search for the perfect scam.,48.0,Robert Celestino,Yonkers Joe,2008,101,USA, 5000000,8286,8286,0,-4991714,0
49733,195.0,"Crime, Mystery, Thriller","FBI agent Jennifer Marsh is tasked with hunting down a seemingly untraceable serial killer who posts live videos of his victims on the Internet. As time runs out, the cat and mouse chase becomes more personal.",32.0,Gregory Hoblit,Untraceable,2008,101,USA, 35000000,28687835,52659594,23971759,17659594,1
50401,58.0,"Drama, Romance",A road trip through Louisiana transforms three strangers who were originally brought together by their respective feelings of loneliness.,62.0,Udayan Prasad,The Yellow Handkerchief,2008,102,USA, 15500000,318623,318623,0,-15181377,0
52373,50.0,"Drama, Fantasy, Romance","In an attempt to save his marriage, a firefighter uses a 40-day experiment known as ""The Love Dare.""",28.0,Alex Kendrick,Fireproof,2008,122,USA, 500000,33456317,33473297,16980,32973297,1
50724,178.0,"Comedy, Romance","After serving as a bridesmaid 27 times, a young woman wrestles with the idea of standing by her sister's side as her sibling marries the man she's secretly in love with.",47.0,Anne Fletcher,27 Dresses,2008,111,USA, 30000000,76808654,160259319,83450665,130259319,1
53039,218.0,"Animation, Action, Adventure","After the Republic's victory on Christophsis, Anakin and his new apprentice Ahsoka Tano must rescue the kidnapped son of Jabba the Hutt. Political intrigue complicates their mission.",35.0,Dave Filoni,Star Wars: The Clone Wars,2008,98,USA, 8500000,35161554,68282844,33121290,59782844,1
50430,204.0,Comedy,An Israeli Special Forces Soldier fakes his death so he can re-emerge in New York City as a hair stylist.,54.0,Dennis Dugan,You Don't Mess with the Zohan,2008,113,USA, 90000000,100018837,199936011,99917174,109936011,1
50720,139.0,"Action, Crime, Drama","When straight arrow FBI agent Roy Clayton heads up the investigation into a dangerous international conspiracy, all clues seem to lead back to former U.S. Special Operations officer, Samir Horn.",60.0,Jeffrey Nachmanoff,Traitor,2008,114,USA, 22000000,23530831,27664723,4133892,5664723,1
52450,49.0,"Drama, Romance",Twenty-four hours in the tentative relationship of two young San Franciscans also dealing with the conundrum of being a minority in a rapidly gentrifying city.,63.0,Barry Jenkins,Medicine for Melancholy,2008,88,USA, 13000,111551,111551,0,98551,1
52494,103.0,"Comedy, Romance",A high school senior drives cross-country with his best friends to hook up with a babe he met online.,49.0,Sean Anders,Sex Drive,2008,109,USA, 19000000,8402485,18755936,10353451,-244064,0
50433,44.0,"Comedy, Music","In his quest to become the world's greatest air-drummer, a small-town dreamer must overcome obstacles and ridicule to save the day.",39.0,Ari Gold,Adventures of Power,2008,89,USA, 2500000,17419,17419,0,-2482581,0
50434,147.0,"Comedy, Family, Fantasy",A hotel handyman's life changes when the lavish bedtime stories he tells his niece and nephew start to magically come true.,33.0,Adam Shankman,Bedtime Stories,2008,99,USA, 80000000,110101975,212874864,102772889,132874864,1
50446,69.0,Drama,The Taylor family is devastated by an accident that takes place on the day their matriarch is due to graduate from college -- decades after leaving to raise her children.,34.0,Dennis Lee,Fireflies in the Garden,2008,120,USA, 8000000,70600,6692182,6621582,-1307818,0
50458,130.0,"Comedy, Drama, Family","As seniors in high school, Troy and Gabriella struggle with the idea of being separated from one another as college approaches. Along with the rest of the Wildcats, they stage a spring musical to address their experiences, hopes and fears about their future.",57.0,Kenny Ortega,High School Musical 3: Senior Year,2008,112,USA, 11000000,90559416,252909177,162349761,241909177,1
50781,209.0,"Comedy, Drama, Fantasy","Bertram Pincus is a man whose people skills leave much to be desired. When Pincus dies unexpectedly, but is miraculously revived after seven minutes, he wakes up to discover that he now has the annoying ability to see ghosts.",72.0,David Koepp,Ghost Town,2008,102,USA, 20000000,13367624,27074492,13706868,7074492,1
50648,168.0,"Comedy, Drama, Music","High school student Nick O'Leary, member of the Queercore band The Jerk Offs, meets college-bound Norah Silverberg when she asks him to be her boyfriend for five minutes.",64.0,Peter Sollett,Nick and Norah's Infinite Playlist,2008,90,USA, 10000000,31487293,33506644,2019351,23506644,1
50482,78.0,"Crime, Horror, Thriller",A group of medical students devise a deadly game: to see which one of them can commit the perfect murder.,55.0,Marc Sch√∂lermann,Pathology,2008,95,USA, 8000000,109846,3234706,3124860,-4765294,0
50494,58.0,"Crime, Drama, Thriller","A woman leaves an abusive relationship to begin a new life in a new city, where she forms an unlikely and ironic relationship with a suicidal hitman (unbeknownst to her). Enter a worn, ...",55.0,Michael Keaton,The Merry Gentleman,2008,110,USA, 5000000,347977,347977,0,-4652023,0
50522,122.0,"Adventure, Family, Fantasy","For generations, the people of the City of Ember have flourished in an amazing world of glittering lights. But Ember's once powerful generator is failing ... and the great lamps that illuminate the city are starting to flicker.",58.0,Gil Kenan,City of Ember,2008,90,USA, 55000000,7873007,17929684,10056677,-37070316,0
50561,66.0,"Drama, Thriller",A reclusive man sets out for justice and redemption when three troublesome teens kill his dog for no good reason.,61.0,"Trygve Allister Diesen, Lucky McKee",Red,2008,93,USA, 2500000,4643,10731,6088,-2489269,0
52687,67.0,Drama,"A drama set in the Mississippi delta, where one man's suicide affects three people's lives.",84.0,Lance Hammer,Ballast,2008,96,USA, 700000,77556,81864,4308,-618136,0
52672,190.0,Drama,"Over the summer, a series of unfortunate happening triggers a financial crisis for a young woman and she soon finds her life falling apart.",80.0,Kelly Reichardt,Wendy and Lucy,2008,80,USA, 200000,865695,1192995,327300,992995,1
50646,56.0,"Comedy, Drama, War",Three different soldiers - a woman and two men - return from the war and facing the peaceful life's problems of each other.,53.0,Neil Burger,The Lucky Ones,2008,115,USA, 15000000,266967,287567,20600,-14712433,0
52647,26.0,"Drama, Romance",A holiday fable that tells the story of an elderly man discovering love for the first time.,57.0,Nicholas Fackler,"Lovely, Still",2008,92,USA, 5000000,127564,236600,109036,-4763400,0
52617,15.0,Drama,"After a stint in prison, Sonny returns to his home in East Texas, determined to repair his relationship with his son. Standing in his way is his brother, who has turned the home into a crumbling meth lab.",44.0,David Pomes,Cook County,2008,93,USA, 700000,17977,17977,0,-682023,0
50577,137.0,"Drama, Romance","Cultural critic David Kepesh finds his life, which he indicates is a state of ""emancipated manhood"", thrown into tragic disarray by Consuela Castillo, a well-mannered student who awakens a sense of sexual possessiveness in her teacher.",66.0,Isabel Coixet,Elegy,2008,112,USA, 13000000,3581642,14894347,11312705,1894347,1
50609,24.0,Comedy,A wave twisting tale of a soul searching surfer experiencing an existential crisis.,16.0,S.R. Bindler,"Surfer, Dude",2008,85,USA, 6000000,52132,52132,0,-5947868,0
50467,139.0,"Horror, Musical, Sci-Fi","A worldwide epidemic encourages a biotech company to launch an organ-financing program similar in nature to a standard car loan. The repossession clause is a killer, however.",32.0,Darren Lynn Bousman,Repo! The Genetic Opera,2008,98,USA, 8500000,146750,188126,41376,-8311874,0
50878,231.0,"Comedy, Drama, Romance",A New York City writer on sex and love is finally getting married to her Mr. Big. But her three best girlfriends must console her after one of them inadvertently leads Mr. Big to jilt her.,53.0,Michael Patrick King,Sex and the City,2008,145,USA, 65000000,152647258,415253641,262606383,350253641,1
50371,95.0,"Comedy, Crime, Thriller",Three female employees of the Federal Reserve plot to steal money that is about to be destroyed.,41.0,Callie Khouri,Mad Money,2008,104,USA, 22000000,20668843,26412163,5743320,4412163,1
49774,76.0,"Action, Comedy, Thriller","A corporation hires a professional assassin to pose as its trade show representative who must organize the wedding of a Middle Eastern pop star, which will allow him the opportunity to kill a Middle Eastern politician.",37.0,Joshua Seftel,"War, Inc.",2008,107,USA, 10000000,580862,1296184,715322,-8703816,0
53363,110.0,Comedy,"Over the course of one evening, an unsuspecting group of twenty-somethings find themselves bombarded by a series of natural disasters and catastrophic events.",15.0,"Jason Friedberg, Aaron Seltzer",Disaster Movie,2008,87,USA, 20000000,14190901,34816824,20625923,14816824,1
49821,397.0,"Drama, Thriller, War","During the Iraq War, a Sergeant recently assigned to an army bomb squad is put at odds with his squad mates due to his maverick way of handling his work.",95.0,Kathryn Bigelow,The Hurt Locker,2008,131,USA, 15000000,17017811,49230772,32212961,34230772,1
51056,72.0,"Comedy, Drama, Romance",Four college freshmen and best friends find that it may take more than a shared pair of jeans to help them stay in touch as their lives go in different directions.,63.0,Sanaa Hamri,The Sisterhood of the Traveling Pants 2,2008,119,USA, 27000000,44089964,44352417,262453,17352417,1
49975,109.0,"Comedy, Horror",A grave robber reflects on his life of crime.,62.0,Glenn McQuaid,I Sell the Dead,2008,85,USA, 750000,8050,8050,0,-741950,0
52008,45.0,"Biography, Comedy, Drama","The true story of Jasmine Plummer who, at the age of eleven, became the first female to play in Pop Warner football tournament in its 56-year history.",52.0,Fred Durst,The Longshots,2008,94,USA, 23000000,11537046,11767866,230820,-11232134,0
50991,330.0,"Biography, Drama",The story of,84.0,Gus Van Sant,Milk,2008,128,USA, 20000000,31841299,54586584,22745285,34586584,1
53108,46.0,"Comedy, Fantasy",An anti-American filmmaker who's out to abolish the July Fourth holiday is visited by three ghosts who try to change his perception of the country.,20.0,David Zucker,An American Carol,2008,83,USA, 20000000,7013191,7013191,0,-12986809,0
52064,19.0,"Drama, Romance","A drama of four interconnecting stories revolving around love, drugs and poverty in Philadelphia.",54.0,Mark Webber,Explicit Ills,2008,87,USA, 1500000,28564,28564,0,-1471436,0
50062,228.0,"Action, Comedy, Crime",A process server and his marijuana dealer wind up on the run from hitmen and a corrupt police officer after he witnesses his dealer's boss murder a competitor while trying to serve papers on him.,64.0,David Gordon Green,Pineapple Express,2008,111,USA, 27000000,87341380,101624843,14283463,74624843,1
50065,264.0,"Animation, Adventure, Family","In the distant future, a small waste-collecting robot inadvertently embarks on a space journey that will ultimately decide the fate of mankind.",95.0,Andrew Stanton,WALL¬∑E,2008,98,USA, 180000000,223808164,521311860,297503696,341311860,1
52102,352.0,"Drama, Fantasy, Romance","Bella Swan moves to Forks and encounters Edward Cullen, a gorgeous boy with a secret.",56.0,Catherine Hardwicke,Twilight,2008,122,USA, 37000000,193962473,393853583,199891110,356853583,1
52130,14.0,Drama,"FIX takes you from Beverly Hills to Watts, and places in between, in one day, as documentary filmmakers Bella and Milo race to get Milo's brother Leo from jail to rehab before 8pm, or Leo ...",31.0,Tao Ruspoli,Fix,2008,93,USA, 500000,9890,9890,0,-490110,0
50079,108.0,"Comedy, Drama","The story of the early days of California wine making featuring the now infamous, blind Paris wine tasting of 1976 that has come to be known as ""Judgment of Paris"".",56.0,Randall Miller,Bottle Shock,2008,110,USA, 5000000,4078607,4628553,549946,-371447,0
50985,163.0,"Drama, Sport","A fateful event leads to a job in the film business for top mixed-martial arts instructor Mike Terry. Though he refuses to participate in prize bouts, circumstances conspire to force him to consider entering such a competition.",69.0,David Mamet,Redbelt,2008,99,USA, 7000000,2345941,2674090,328149,-4325910,0
52157,124.0,"Comedy, Music","In this irreverent comedy, a failed actor-turned-worse-high-school-drama-teacher rallies his Tucson, AZ students as he conceives and stages politically incorrect musical sequel to Shakespeare's Hamlet.",54.0,Andrew Fleming,Hamlet 2,2008,92,USA, 9000000,4886216,4925288,39072,-4074712,0
50102,300.0,"Drama, Mystery",A Catholic school principal questions a priest's ambiguous relationship with a troubled young student.,68.0,John Patrick Shanley,Doubt,2008,104,USA, 20000000,33446470,51018161,17571691,31018161,1
50347,157.0,"Crime, Drama, Thriller","Based on a true story, a troubled and racist African-American L.A.P.D. Officer will stop at nothing to force out a friendly interracial couple who just moved in next door to him.",47.0,Neil LaBute,Lakeview Terrace,2008,110,USA, 20000000,39263506,44655002,5391496,24655002,1
50939,245.0,"Comedy, Romance","Lifelong platonic friends Zack and Miri look to solve their respective cash-flow problems by making an adult film together. As the cameras roll, however, the duo begin to sense that they may have more feelings for each other than they previously thought.",56.0,Kevin Smith,Zack and Miri Make a Porno,2008,101,USA, 24000000,31457946,42106992,10649046,18106992,1
50889,36.0,"Comedy, Crime","The story centers on a small-town Sheriff who witnesses what he believes is a kidnapping, and rushes to rescue a woman. The kidnappers turn out to be F.B.I. Agents assigned to protect her ...",17.0,Charles Robert Carner,Witless Protection,2008,97,USA, 7500000,4161625,4161625,0,-3338375,0
49688,19.0,"Crime, Drama","A desperate young man, on the run from a dangerous drug dealer, returns to his mother, years after a family tragedy drove them far apart, to hide. However, his old and new life are about to collide.",29.0,"Hunter Hill, Perry Moore",Lake City,2008,93,USA, 4000000,12767,12767,0,-3987233,0
49021,182.0,"Comedy, Drama, Family","A family learns important life lessons from their adorable, but naughty and neurotic dog.",53.0,David Frankel,Marley & Me,2008,115,USA, 60000000,143153751,255743093,112589342,195743093,1
42680,195.0,"Action, Adventure, Family","On a quest to find out what happened to his missing brother, a scientist, his nephew and their mountain guide discover a fantastic and dangerous lost world in the center of the earth.",57.0,Eric Brevig,Journey to the Center of the Earth,2008,93,USA, 60000000,101704370,241995151,140290781,181995151,1
48256,13.0,"Adventure, Comedy, Drama","The story of three people who strive to realize their dreams. Brothers Carter and Ellis set out on a road trip to their childhood home in a desperate search for their estranged father, who may hold the key to their future.",42.0,Aaron Woodley,Tennessee,2008,99,USA, 4000000,16100,16100,0,-3983900,0
47703,145.0,"Drama, War","A veteran soldier returns from his completed tour of duty in Iraq, only to find his life turned upside down when he is arbitrarily ordered to return to field duty by the Army.",61.0,Kimberly Peirce,Stop-Loss,2008,112,USA, 25000000,10915744,11207130,291386,-13792870,0
47197,151.0,"Crime, Drama, History","""21"" is the fact-based story about six MIT students who were trained to become experts in card counting and subsequently took Vegas casinos for millions in winnings.",48.0,Robert Luketic,21,2008,123,USA, 35000000,81159365,157927340,76767975,122927340,1
44997,121.0,"Action, Comedy","Orphaned high school student Rick Riker is bitten by a radioactive dragonfly, develops super powers (except for the ability to fly), and becomes a hero.",33.0,Craig Mazin,Superhero Movie,2008,75,USA, 35000000,25881068,71239186,45358118,36239186,1
44905,270.0,"Action, Adventure, Comedy","Maxwell Smart, a highly intellectual but bumbling spy working for the CONTROL agency, is tasked with preventing a terrorist attack from rival spy agency KAOS.",54.0,Peter Segal,Get Smart,2008,110,USA, 80000000,130319208,230685453,100366245,150685453,1
44754,382.0,"Drama, Fantasy, Romance","Tells the story of Benjamin Button, a man who starts aging backwards with bizarre consequences.",70.0,David Fincher,The Curious Case of Benjamin Button,2008,166,USA, 150000000,127509326,333932083,206422757,183932083,1
42465,467.0,"Action, Adventure","In 1957, archaeologist and adventurer Dr. Henry ""Indiana"" Jones, Jr. is called back into action and becomes entangled in a Soviet plot to uncover the secret behind mysterious artifacts known as the Crystal Skulls.",65.0,Steven Spielberg,Indiana Jones and the Kingdom of the Crystal Skull,2008,122,USA, 185000000,317101119,786636033,469534914,601636033,1
47311,164.0,"Animation, Adventure, Comedy","The Madagascar animals fly back to New York City, but crash-land on an African nature reserve, where they meet others of their own kind, and Alex especially discovers his royal heritage as prince of a lion pride.",61.0,"Eric Darnell, Tom McGrath",Madagascar: Escape 2 Africa,2008,89,USA, 150000000,180010950,603900354,423889404,453900354,1
47892,74.0,"Comedy, Romance","Dr. RJ Stevens is a talk show host who visits his family in the deep south. While there he reunites with his brother Otis, his sister Betty, his cousin/rival Clyde and his childhood love interest Lucinda Allen.",46.0,Malcolm D. Lee,"Welcome Home, Roscoe Jenkins",2008,114,USA, 35000000,42436517,43650785,1214268,8650785,1
48431,100.0,"Comedy, Fantasy, Romance",A ghost tries to sabotage her former boyfriend's current relationship with a psychic.,30.0,Jeff Lowell,Over Her Dead Body,2008,95,USA, 10000000,7563670,21458111,13894441,11458111,1
48593,246.0,"Comedy, Drama, Romance","Devastated Peter takes a Hawaiian vacation in order to deal with the recent break-up with his TV star girlfriend, Sarah. Little does he know, Sarah's traveling to the same resort as her ex - and she's bringing along her new boyfriend.",67.0,Nicholas Stoller,Forgetting Sarah Marshall,2008,111,USA, 30000000,63172463,105173115,42000652,75173115,1
44731,196.0,"Action, Crime, Drama","An undercover cop, disillusioned by the death of his wife, is implicated in the murder of an officer and must struggle to clear himself.",55.0,David Ayer,Street Kings,2008,109,USA, 20000000,26418667,65572887,39154220,45572887,1
48217,126.0,"Adventure, Comedy, Family","A crew of miniature aliens operate a spaceship that has a human form. While trying to save their planet, the aliens encounter a new problem, as their ship becomes smitten with an Earth woman.",43.0,Brian Robbins,Meet Dave,2008,90,USA, 60000000,11803254,50650079,38846825,-9349921,0
44473,193.0,"Action, Adventure, Drama","Upon moving into the run-down Spiderwick Estate with their mother, twin brothers Jared and Simon Grace, along with their sister Mallory, find themselves pulled into an alternate world full of faeries and other creatures.",62.0,Mark Waters,The Spiderwick Chronicles,2008,96,USA, 90000000,71195053,162839667,91644614,72839667,1
44468,100.0,Drama,"In 1964, a teenage girl in search of the truth about her mother runs away to a small town in South Carolina and finds a family of independent women who can connect her to her past.",57.0,Gina Prince-Bythewood,The Secret Life of Bees,2008,114,USA, 11000000,37770162,39947322,2177160,28947322,1
42241,158.0,"Comedy, Drama, Romance",A family unit begins to bow under the pressure of a failing marriage.,64.0,Derick Martini,Lymelife,2008,95,USA, 1500000,421307,526245,104938,-973755,0
44293,33.0,"Drama, Thriller","An unhappy wife orders a guy she meets over the Internet to kill her, but the two of them fall in love.",19.0,Johan Renck,Downloading Nancy,2008,102,USA, 3000000,22282,22282,0,-2977718,0
44249,142.0,"Adventure, Family, Fantasy",A young girl inhabits an isolated island with her scientist father and communicates with a reclusive author of the novel she's reading.,55.0,"Jennifer Flackett, Mark Levin",Nim's Island,2008,96,USA, 37000000,48006762,100076342,52069580,63076342,1
47383,157.0,"Adventure, Comedy","After being mistaken for terrorists and thrown into Guant√°namo Bay, stoners Harold and Kumar escape and return to the U.S., where they proceed to flee across the country with federal agents in hot pursuit.",57.0,"Jon Hurwitz, Hayden Schlossberg",Harold & Kumar Escape from Guantanamo Bay,2008,104,USA, 12000000,38108728,43494280,5385552,31494280,1
47431,129.0,"Horror, Mystery, Thriller","A newly married couple discovers disturbing, ghostly images in photographs they develop after a tragic accident. Fearing the manifestations may be connected, they investigate and learn that some mysteries are better left unsolved.",37.0,Masayuki Ochiai,Shutter,2008,85,USA, 8000000,25928550,47879410,21950860,39879410,1
47435,305.0,"Horror, Mystery, Thriller",A young couple staying in an isolated vacation home are terrorized by three unknown assailants.,47.0,Bryan Bertino,The Strangers,2008,86,USA, 9000000,52597610,82391145,29793535,73391145,1
48263,25.0,"Drama, Thriller",The owner of a 1930s nightclub loses control of his life amid love triangles and too much debt.,38.0,Rachel Samuels,Dark Streets,2008,83,USA, 8000000,16815,16815,0,-7983185,0
47434,78.0,"Animation, Adventure, Comedy",Three chimps are sent into space to explore the possibility of alien life when an unmanned space shuttle crash lands on an uncharted planet.,36.0,Kirk DeMicco,Space Chimps,2008,81,USA, 37000000,30105968,64884277,34778309,27884277,1
42128,44.0,"Animation, Adventure, Comedy","Delgo, an adventurous but naive teenager, must rally his group of friends to protect their world from conflict between the Lockni and Nohrin people.",27.0,"Marc F. Adler, Jason Maurer",Delgo,2008,94,USA, 40000000,694782,694782,0,-39305218,0
47704,57.0,"Adventure, Comedy","With the ratings dropping for a wilderness-themed television show, two animal fans go to the Andes Mountains in search of Bigfoot.",12.0,Fred Wolf,Strange Wilderness,2008,87,USA, 20000000,6575282,6964734,389452,-13035266,0
42619,526.0,"Action, Adventure, Sci-Fi","After being held captive in an Afghan cave, billionaire engineer Tony Stark creates a unique weaponized suit of armor to fight evil.",79.0,Jon Favreau,Iron Man,2008,126,USA, 140000000,318604126,585366247,266762121,445366247,1
47098,36.0,"Animation, Adventure, Comedy","Three lazy misfits - very timid Elliot (Larry the Cucumber), lazy Sedgewick (Mr. Lunt) and no self-confident George (Pa Grape) - dream of the day of putting on a show about pirates. With ...",49.0,Mike Nawrocki,The Pirates Who Don't Do Anything: A VeggieTales Movie,2008,85,USA, 15000000,12981269,13155091,173822,-1844909,0
46861,38.0,Drama,"August centers on two brothers fighting to keep their start-up company afloat on Wall Street during August 2001, a month before the 9/11 terrorist attacks.",39.0,Austin Chick,August,2008,88,USA, 3400000,12636,12636,0,-3387364,0
43213,249.0,"Comedy, Drama","A theatre director struggles with his work, and the women in his life, as he creates a life-size replica of New York City inside a warehouse as part of his new play.",67.0,Charlie Kaufman,"Synecdoche, New York",2008,124,USA, 20000000,3083538,4580758,1497220,-15419242,0
43778,232.0,"Animation, Adventure, Comedy",The canine star of a fictional sci-fi/action show that believes his powers are real embarks on a cross country trek to save his co-star from a threat he believes is just as real.,67.0,"Byron Howard, Chris Williams",Bolt,2008,96,USA, 150000000,114053579,309979994,195926415,159979994,1
48946,141.0,"Comedy, Drama",Three kids hire a low-budget bodyguard to protect them from the playground bully.,41.0,Steven Brill,Drillbit Taylor,2008,110,USA, 40000000,32862104,49690625,16828521,9690625,1
45948,194.0,"Animation, Adventure, Comedy",Horton the Elephant struggles to protect a microscopic community from his neighbors who refuse to believe it exists.,71.0,"Jimmy Hayward, Steve Martino",Horton Hears a Who!,2008,86,USA, 85000000,154529439,297138014,142608575,212138014,1
45828,313.0,"Action, Fantasy",Hancock is a superhero whose ill-considered behavior regularly causes damage in the millions. He changes when the person he saves helps him improve his public image.,49.0,Peter Berg,Hancock,2008,92,USA, 150000000,227946274,624386771,396440497,474386771,1
48876,209.0,Drama,A man with a fateful secret embarks on an extraordinary journey of redemption by forever changing the lives of seven strangers.,36.0,Gabriele Muccino,Seven Pounds,2008,123,USA, 55000000,69951824,168168201,98216377,113168201,1
46927,28.0,Comedy,"While Danny's father and mother independently search for love, Danny is on his own desperate quest to find a prom date. Danny's search becomes progressively more pathetic once he and his family learn that Bart, the school's biggest dweeb, not only secured a date for the prom, but got a hotel room as well.",57.0,Brian Hecker,Bart Got a Room,2008,80,USA, 2000000,53760,53760,0,-1946240,0
48596,388.0,"Action, Adventure, Sci-Fi","Bruce Banner, a scientist on the run from the U.S. Government, must find a cure for the monster he turns into, whenever he loses his temper.",61.0,Louis Leterrier,The Incredible Hulk,2008,112,USA, 150000000,134806913,263427551,128620638,113427551,1
48753,136.0,"Comedy, Drama, Romance","Eleven love stories set in one of the most loved and hated cities of the world, New York City.",49.0,"Fatih Akin, Yvan Attal","New York, I Love You",2008,103,USA, 14700000,1588015,14603177,13015162,-96823,0
45771,26.0,Drama,"As an ex-gambler teaches a hot-shot college kid some things about playing cards, he finds himself pulled into the world series of poker, where his prot√©g√© is his toughest competition.",35.0,Gil Cates Jr.,Deal,2008,85,USA, 5000000,61626,78731,17105,-4921269,0
48251,178.0,"Action, Adventure, Comedy",A new clue to the whereabouts of a lost treasure rekindles a married couple's sense of adventure -- and their estranged romance.,29.0,Andy Tennant,Fool's Gold,2008,112,USA, 70000000,70231041,111231041,41000000,41231041,1
48605,99.0,"Crime, Drama, Mystery","An accountant is introduced to a mysterious sex club known as The List by his lawyer friend. But in this new world, he soon becomes the prime suspect in a woman's disappearance and a multi-million dollar heist.",31.0,Marcel Langenegger,Deception,2008,107,USA, 25000000,4598506,17741298,13142792,-7258702,0
48610,191.0,"Action, Crime, Drama",Two friends hired to police a small town that is suffering under the rule of a rancher find their job complicated by the arrival of a young widow.,64.0,Ed Harris,Appaloosa,2008,115,USA, 20000000,20211394,27665851,7454457,7665851,1
45570,274.0,"Animation, Action, Adventure","The Dragon Warrior has to clash against the savage Tai Lung as China's fate hangs in the balance. However, the Dragon Warrior mantle is supposedly mistaken to be bestowed upon an obese panda who is a novice in martial arts.",73.0,"Mark Osborne, John Stevenson",Kung Fu Panda,2008,92,USA, 130000000,215434591,631746197,416311606,501746197,1
45170,121.0,"Comedy, Drama","A wealthy New Yorker wrestles with the decision to leave her cheating husband, as she and her friends discover that women really can have it all.",27.0,Diane English,The Women,2008,114,USA, 16000000,26902075,50007546,23105471,34007546,1
48678,191.0,"Horror, Mystery","A photographer's obsessive pursuit of dark subject matter leads him into the path of a serial killer who stalks late night commuters, ultimately butchering them in the most gruesome ways imaginable.",58.0,Ry√ªhei Kitamura,The Midnight Meat Train,2008,98,USA, 15000000,83361,3533227,3449866,-11466773,0
45616,227.0,"Action, Crime, Drama",The attempted assassination of the American President is told and re-told from several different perspectives.,40.0,Pete Travis,Vantage Point,2008,90,USA, 40000000,72266306,151161491,78895185,111161491,1
48635,74.0,Comedy,Two assistant managers of a corporate grocery store vie for a coveted promotion.,51.0,Steve Conrad,The Promotion,2008,86,USA, 8000000,408709,457690,48981,-7542310,0
44015,194.0,"Comedy, Drama, Romance","While his trailer trash parents teeter on the edge of divorce, Nick Twisp sets his sights on dream girl Sheeni Saunders, hoping that she'll be the one to take away his virginity.",63.0,Miguel Arteta,Youth in Revolt,2009,90,USA, 18000000,15281286,19651093,4369807,1651093,1
52139,172.0,Drama,"A drama set in the days leading up to the 2008 Presidential election, and centered on a high-end Manhattan call girl meeting the challenges of her boyfriend, her clients, and her work.",66.0,Steven Soderbergh,The Girlfriend Experience,2009,77,USA, 1700000,695840,1007962,312122,-692038,0
52357,208.0,"Biography, Comedy, Drama",A man working at his parents' motel in the Catskills inadvertently sets in motion the generation-defining concert in the summer of 1969.,55.0,Ang Lee,Taking Woodstock,2009,120,USA, 30000000,7460204,9975737,2515533,-20024263,0
52082,47.0,"Action, Comedy, Crime","Two inept criminals are mistakenly delivered a package of cocaine and think they've hit the jackpot, triggering a series of events that changes ten people's lives forever.",46.0,Benny Boom,Next Day Air,2009,84,USA, 3000000,10027047,10172519,145472,7172519,1
52246,135.0,"Comedy, Drama, Family","As Hannah Montana's popularity begins to take over her life, Miley Stewart, on the urging from her father takes a trip to her hometown of Crowley Corners, Tennessee to get some perspective on what matters in life the most.",47.0,Peter Chelsom,Hannah Montana: The Movie,2009,102,USA, 30000000,79576189,155545279,75969090,125545279,1
44218,474.0,"Action, Drama, Mystery","In 1985 where former superheroes exist, the murder of a colleague sends active vigilante Rorschach into his own sprawling investigation, uncovering something that could completely change the course of history as we know it.",56.0,Zack Snyder,Watchmen,2009,162,USA, 130000000,107509799,185258983,77749184,55258983,1
52255,169.0,"Action, Comedy, Crime","When a shopping mall is taken over by a gang of organized crooks, it's up to a mild-mannered security guard to save the day.",39.0,Steve Carr,Paul Blart: Mall Cop,2009,91,USA, 26000000,146336178,183293131,36956953,157293131,1
52308,19.0,Comedy,"Julian Marsh is an out of work ladies' man who lands a job directing a bizarre adaptation of Hamlet. After casting his best friend and his ex-girlfriend in the show, Julian finds himself in...",45.0,Jordan Galland,Rosencrantz and Guildenstern Are Undead,2009,89,USA, 600000,71007,71007,0,-528993,0
52300,156.0,"Action, Crime, Thriller",Chelios faces a Chinese mobster who has stolen his nearly indestructible heart and replaced it with a battery-powered ticker which requires regular jolts of electricity to keep working.,41.0,"Mark Neveldine, Brian Taylor",Crank: High Voltage,2009,96,USA, 20000000,13684249,34561792,20877543,14561792,1
52066,285.0,"Crime, Drama",Terence McDonagh is a drug- and gambling-addled detective in post-Katrina New Orleans investigating the killing of five Senegalese immigrants.,69.0,Werner Herzog,The Bad Lieutenant: Port of Call - New Orleans,2009,122,USA, 25000000,1702112,10601596,8899484,-14398404,0
52346,422.0,"Horror, Thriller","A loan officer who evicts an old woman from her home finds herself the recipient of a supernatural curse. Desperate, she turns to a seer to try and save her soul, while evil forces work to push her to a breaking point.",83.0,Sam Raimi,Drag Me to Hell,2009,99,USA, 30000000,42100625,90842646,48742021,60842646,1
52327,17.0,"Comedy, Romance","A young ladies' man teaches his dating tricks to his lonely, widowed grandfather, and plays his best mind games to meet the woman of his dreams.",35.0,Marc Fienberg,Play the Game,2009,105,USA, 1100000,659483,659483,0,-440517,0
51789,170.0,"Action, Adventure, Family",A Las Vegas cabbie enlists the help of a UFO expert to protect two siblings with paranormal powers from the clutches of an organization that wants to use the kids for their nefarious plans.,52.0,Andy Fickman,Race to Witch Mountain,2009,98,USA, 65000000,67172594,106387141,39214547,41387141,1
51887,87.0,"Comedy, Sport",The two most popular guys in high school decide to ditch football camp for cheerleader camp. For the girls and for the glory.,31.0,Will Gluck,Fired Up!,2009,90,USA, 20000000,17231291,18599102,1367811,-1400898,0
51111,349.0,"Comedy, Drama, Romance","An offbeat romantic comedy about a woman who doesn't believe true love exists, and the young man who falls for her.",76.0,Marc Webb,(500) Days of Summer,2009,95,USA, 7500000,32391374,60722734,28331360,53222734,1
46041,217.0,"Drama, Fantasy, Romance","A Chicago librarian has a gene that causes him to involuntarily time travel, creating complications in his marriage.",47.0,Robert Schwentke,The Time Traveler's Wife,2009,107,USA, 39000000,63414846,101344412,37929566,62344412,1
45924,164.0,"Action, Adventure, Fantasy","Teenager Darren Shan meets a mysterious man at a freak show who turns out to be a vampire. After a series of events, Darren must leave his normal life and go on the road with the Cirque du Freak and become a vampire.",43.0,Paul Weitz,Cirque du Freak: The Vampire's Assistant,2009,109,USA, 40000000,13869515,39232113,25362598,-767887,0
51183,8.0,"Drama, Romance","2002: Jake Mitchell is the defending World West Coast Swing Champion. He's got everything going for him: looks, personality, and style. He's at the top of his game when he and his partner ...",43.0,Robert Iscove,Love N' Dancing,2009,91,USA, 10000000,47812,73848,26036,-9926152,0
51261,185.0,"Action, Sci-Fi, Thriller","In a future mind-controlling game, death row convicts are forced to battle in a 'Doom'-type environment. Convict Kable, controlled by Simon, a skilled teenage gamer, must survive thirty sessions in order to be set free.",27.0,"Mark Neveldine, Brian Taylor",Gamer,2009,95,USA, 50000000,20534907,40828540,20293633,-9171460,0
51274,33.0,"Drama, Sport","In the early 70s, Cathy Rush becomes the head basketball coach at a tiny, all-girls Catholic college. Though her team has no gym and no uniforms -- and the school itself is in danger of being sold -- Coach Rush looks to steer her girls to their first national championship.",49.0,Tim Chambers,The Mighty Macs,2009,99,USA, 7000000,1891936,1891936,0,-5108064,0
51375,230.0,"Comedy, Drama, Romance",A pushy boss forces her young assistant to marry her in order to keep her visa status in the U.S. and avoid deportation to Canada.,48.0,Anne Fletcher,The Proposal,2009,108,USA, 40000000,163958031,317375031,153417000,277375031,1
45376,143.0,"Animation, Action, Adventure",A specially trained squad of guinea pigs is dispatched to stop a diabolical billionaire from taking over the world.,41.0,Hoyt Yeatman,G-Force,2009,88,USA, 150000000,119436770,292817841,173381071,142817841,1
51429,171.0,Comedy,"After being banished from their tribe, two hunter-gatherers encounter Biblical characters and eventually wind up in the city of Sodom.",34.0,Harold Ramis,Year One,2009,97,USA, 60000000,43337279,62357900,19020621,2357900,1
51470,421.0,"Animation, Adventure, Comedy","Seventy-eight year old Carl Fredricksen travels to Paradise Falls in his home equipped with balloons, inadvertently taking a young stowaway.",88.0,"Pete Docter, Bob Peterson",Up,2009,96,USA, 175000000,293004164,735099082,442094918,560099082,1
51550,374.0,"Action, Adventure, Sci-Fi","Sam Witwicky leaves the Autobots behind for a normal life. But when his mind is filled with cryptic symbols, the Decepticons target him and he is dragged back into the Transformers' war.",35.0,Michael Bay,Transformers: Revenge of the Fallen,2009,150,USA, 200000000,402111870,836303693,434191823,636303693,1
51569,314.0,"Biography, Drama, History","Nelson Mandela (Morgan Freeman), in his first term as President of South African, initiates a unique venture to unite the Apartheid-torn land: enlist the national rugby team on a mission to win the 1995 Rugby World Cup.",74.0,Clint Eastwood,Invictus,2009,134,USA, 60000000,37491364,122426792,84935428,62426792,1
51575,196.0,"Comedy, Fantasy, Romance","A comedy set in a world where no one has ever lied, until a writer seizes the opportunity for personal gain.",58.0,"Ricky Gervais, Matthew Robinson",The Invention of Lying,2009,100,USA, 18500000,18451251,32406507,13955256,13906507,1
51668,251.0,"Animation, Drama, Family","An animated retelling of Charles Dickens' classic novel about a Victorian-era miser taken on a journey of self-redemption, courtesy of several mysterious Christmas apparitions.",55.0,Robert Zemeckis,A Christmas Carol,2009,96,USA, 200000000,137855863,325286646,187430783,125286646,1
51826,147.0,"Drama, Family",Anna Fitzgerald looks to earn medical emancipation from her parents who until now have relied on their youngest child to help their leukemia-stricken daughter Kate remain alive.,51.0,Nick Cassavetes,My Sister's Keeper,2009,109,USA, 30000000,49200230,95714875,46514645,65714875,1
51834,167.0,Comedy,"A comedy centered around four couples who settle into a tropical-island resort for a vacation. While one of the couples is there to work on the marriage, the others fail to realize that participation in the resort's therapy sessions is not optional.",23.0,Peter Billingsley,Couples Retreat,2009,113,USA, 70000000,109204945,171844840,62639895,101844840,1
51845,189.0,"Animation, Adventure, Comedy","When Sid's attempt to adopt three dinosaur eggs gets him abducted by their real mother to an underground lost world, his friends attempt to rescue him.",50.0,"Carlos Saldanha, Mike Thurmeier",Ice Age: Dawn of the Dinosaurs,2009,94,USA, 90000000,196573705,886686817,690113112,796686817,1
52033,81.0,Comedy,Used-car liquidator Don Ready is hired by a flailing auto dealership to turn their Fourth of July sale into a majorly profitable event.,39.0,Neal Brennan,"The Goods: Live Hard, Sell Hard",2009,89,USA, 10000000,15122676,15300714,178038,5300714,1
52383,256.0,"Biography, Comedy, Crime","The U.S. government decides to go after an agro-business giant with a price-fixing accusation, based on the evidence submitted by their star witness, vice president-turned-informant Mark Whitacre.",66.0,Steven Soderbergh,The Informant!,2009,108,USA, 22000000,33316821,41771168,8454347,19771168,1
53507,62.0,"Drama, Romance","A drama that is centered around a troubled teenage girl, and a family that is trying to get over the loss of their son.",45.0,Shana Feste,The Greatest,2009,99,USA, 6000000,114766,833492,718726,-5166508,0
52474,262.0,"Biography, Drama, Romance",Julia Child's story of her start in the cooking profession is intertwined with blogger Julie Powell's 2002 challenge to cook all the recipes in Child's first book.,66.0,Nora Ephron,Julie & Julia,2009,118,USA, 40000000,94125426,129540499,35415073,89540499,1
53228,236.0,"Comedy, Drama","When seasoned comedian George Simmons learns of his terminal, inoperable health condition, his desire to form a genuine friendship causes him to take a relatively green performer under his wing as his opening act.",60.0,Judd Apatow,Funny People,2009,146,USA, 75000000,51855045,71585235,19730190,-3414765,0
53315,164.0,"Crime, Drama, Thriller",Three unconnected Brooklyn cops wind up at the same deadly location after enduring vastly different career paths.,43.0,Antoine Fuqua,Brooklyn's Finest,2009,132,USA, 17000000,27163593,45719985,18556392,28719985,1
53438,42.0,"Comedy, Drama","In Manhattan, a mother of two preparing for her daughter's sixth birthday party has no idea of the challenges she's about to face in order to pull off the event.",34.0,Katherine Dieckmann,Motherhood,2009,90,USA, 5000000,93388,726936,633548,-4273064,0
53502,191.0,"Comedy, Crime, Romance","Joel, the owner of an extract plant, tries to contend with myriad personal and professional problems, such as his potentially unfaithful wife and employees who want to take advantage of him.",61.0,Mike Judge,Extract,2009,92,USA, 8000000,10823158,10848783,25625,2848783,1
53596,106.0,"Animation, Comedy, Family","The world famous singing pre-teen chipmunk trio return to contend with the pressures of school, celebrity, and a rival female music group known as The Chipettes.",41.0,Betty Thomas,Alvin and the Chipmunks: The Squeakquel,2009,88,USA, 75000000,219614612,443140005,223525393,368140005,1
53612,172.0,"Horror, Mystery","A group of sorority sisters try to cover up the death of their house-sister after a prank gone wrong, only to be stalked by a serial killer.",24.0,Stewart Hendler,Sorority Row,2009,101,USA, 12500000,11965282,27206120,15240838,14706120,1
55385,34.0,"Comedy, Drama","When Madea catches sixteen-year-old Jennifer and her two younger brothers looting her home, she decides to take matters into her own hands.",55.0,Tyler Perry,I Can Do Bad All by Myself,2009,113,USA, 13000000,51733921,51733921,0,38733921,1
53853,22.0,Romance,A young New York couple intricately strategize their own break up.,56.0,Daryl Wein,Breaking Upwards,2009,88,USA, 15000,77389,77389,0,62389,1
53855,22.0,"Comedy, Romance","Calm and quiet Daniel starts on Wall Street. His womanizing colleague, Tommy, encourages him to meet women. He unknowingly meets Tommy's girlfriend, Beth, and ends up in her 5 women book club. Will he find the woman?",47.0,Julio DePietro,The Good Guy,2009,90,USA, 10000000,100688,100688,0,-9899312,0
53864,61.0,"Comedy, Drama","Unable to cope with a recent personal tragedy, LA's top celebrity shrink turns into a pothead with no concern for his appearance and a creeping sense of his inability to help his patients.",40.0,Jonas Pate,Shrink,2009,104,USA, 5100000,189621,303431,113810,-4796569,0
53892,61.0,"Comedy, Crime, Drama","Chronicles Jack Harris, one of the pioneers of internet commerce, as he wrestles with his morals, and struggles not to drown in a sea of con men, mobsters, drug addicts, and porn stars.",60.0,George Gallo,Middle Men,2009,105,USA, 20000000,754301,754301,0,-19245699,0
53224,35.0,Drama,"A single-parent ex-con in a tough, minority neighborhood finds his personal values challenged when he discovers his son is gay.",47.0,Peter Bratt,La Mission,2009,117,USA, 3000000,1062941,1062941,0,-1937059,0
54017,277.0,"Drama, Music, Romance",A faded country music musician is forced to reassess his dysfunctional life during a doomed romance that also inspires him.,83.0,Scott Cooper,Crazy Heart,2009,112,USA, 7000000,39464306,47405566,7941260,40405566,1
54099,21.0,Drama,"After a childhood friend's death, Jake Taylor, an all-star athlete must change his life - and sacrifice his dreams to save the lives of others.",19.0,Brian Baugh,To Save a Life,2009,120,USA, 500000,3777210,3824868,47658,3324868,1
54945,36.0,"Drama, Musical","After connecting with the shy Madeline, a jazz trumpeter embarks on a quest for a more gregarious paramour, but through a series of twists and turns punctuated by an original score, the two lovers seem destined to be together.",83.0,Damien Chazelle,Guy and Madeline on a Park Bench,2009,82,USA, 60000,35556,35556,0,-24444,0
54172,39.0,"Comedy, Drama",An ex-gambler is lured back into the game by a veteran insurance-fraud investigator.,32.0,Hue Rhodes,Saint John of Las Vegas,2009,85,USA, 3800000,102645,111731,9086,-3688269,0
54288,144.0,Drama,"A seemingly perfect family moves into a suburban neighborhood, but when it comes to the truth as to why they're living there, they don't exactly come clean with their neighbors.",55.0,Derrick Borte,The Joneses,2009,96,USA, 10000000,1475746,7034834,5559088,-2965166,0
54409,59.0,Drama,"On a summer break from college, a young epileptic woman struggles to balance her feelings for her fledgling boyfriend while her friend Al crashes with her for the season.",69.0,Bradley Rust Gray,The Exploding Girl,2009,79,USA, 40000,25572,25572,0,-14428,0
54414,116.0,"Comedy, Drama, Romance",A car magnate watches his personal and professional life hit the skids because of his business and romantic indiscretions.,69.0,"Brian Koppelman, David Levien",Solitary Man,2009,90,USA, 15000000,4360548,5245746,885198,-9754254,0
54490,86.0,"Action, Crime, Thriller","The MacManus brothers are living a quiet life in Ireland with their father, but when they learn that their beloved priest has been killed by mob forces, they go back to Boston to bring justice to those responsible and avenge the priest.",24.0,Troy Duffy,The Boondock Saints II: All Saints Day,2009,118,USA, 8000000,10273188,10629321,356133,2629321,1
54694,25.0,Drama,"An ex-Navy man carrying out the last wish of a dying shipmate renews contact with old friends to break the code of silence around a mysterious, long-buried crime.",59.0,Bette Gordon,Handsome Harry,2009,94,USA, 1000000,13500,13500,0,-986500,0
54681,300.0,"Drama, Romance","An English professor, one year after the sudden death of his boyfriend, is unable to cope with his typical days in 1960s Los Angeles.",77.0,Tom Ford,A Single Man,2009,99,USA, 7000000,9176000,24964890,15788890,17964890,1
54655,136.0,"Comedy, Drama, Romance","In New York City, an estranged couple who witness a murder are relocated to small town Wyoming as part of the Witness Protection Program.",27.0,Marc Lawrence,Did You Hear About the Morgans?,2009,103,USA, 58000000,29580087,85280250,55700163,27280250,1
53958,297.0,"Adventure, Drama, Fantasy","Edward leaves Bella after an attack that nearly claimed her life, and, in her depression, she falls into yet another difficult relationship - this time with her close friend, Jacob Black.",44.0,Chris Weitz,The Twilight Saga: New Moon,2009,130,USA, 50000000,297816253,711020081,413203828,661020081,1
52413,314.0,"Comedy, Horror",A newly possessed high school cheerleader turns into a succubus who specializes in killing her male classmates. Can her best friend put an end to the horror?,47.0,Karyn Kusama,Jennifer's Body,2009,102,USA, 16000000,16204793,31556061,15351268,15556061,1
53197,107.0,"Drama, Romance, Thriller","A successful asset manager, who has just received a huge promotion, is blissfully happy in his career and in his marriage. But when a temp worker starts stalking him, all the things he's worked so hard for are placed in jeopardy.",25.0,Steve Shill,Obsessed,2009,108,USA, 20000000,68261644,73830340,5568696,53830340,1
53190,224.0,"Action, Crime, Drama",A frustrated man decides to take justice into his own hands after a plea bargain sets one of his family's killers free.,34.0,F. Gary Gray,Law Abiding Citizen,2009,109,USA, 50000000,73357727,126690726,53332999,76690726,1
52524,27.0,"Crime, Drama, Mystery",A detective deals with the loss of his own son while trying to uncover the identity of a boy whose mummified remains are found in a box buried for fifty years.,34.0,Anders Anderson,Stolen Lives,2009,91,USA, 2000000,7943,7943,0,-1992057,0
52533,182.0,"Drama, Horror, Mystery",A young woman fights the spirit that is slowly taking possession of her.,30.0,David S. Goyer,The Unborn,2009,88,USA, 16000000,42670410,76514050,33843640,60514050,1
52548,96.0,"Comedy, Romance","Ryden Malby graduates from college and is forced to move back into her childhood home with her eccentric family, while she attempts to find a job, the right guy, and just a hint of where her life is headed.",35.0,Vicky Jenson,Post Grad,2009,88,USA, 15000000,6380019,6414729,34710,-8585271,0
52557,175.0,"Comedy, Romance",An uptight television producer takes control of a morning show segment on modern relationships hosted by a misogynistic man.,28.0,Robert Luketic,The Ugly Truth,2009,96,USA, 38000000,88915214,321682600,232767386,283682600,1
52569,23.0,"Drama, Romance","'Peter and Vandy' is a love story told out of order. Set in Manhattan, the story shifts back and forth in time, juxtaposing Peter and Vandy's romantic beginnings with the twisted, ...",44.0,Jay DiPietro,Peter and Vandy,2009,95,USA, 500000,11495,11495,0,-488505,0
52577,226.0,"Horror, Thriller","After a young man's premonition of a deadly race-car crash helps saves the lives of his peers, Death sets out to collect those who evaded their end.",30.0,David R. Ellis,The Final Destination,2009,82,USA, 40000000,66477700,186167139,119689439,146167139,1
46283,151.0,"Action, Adventure, Comedy","On his latest expedition, Dr. Rick Marshall is sucked into a space-time vortex alongside his research assistant and a redneck survivalist. In this alternate universe, the trio make friends with a primate named Chaka, their only ally in a world full of dinosaurs and other fantastic creatures.",32.0,Brad Silberling,Land of the Lost,2009,102,USA, 100000000,49438370,68777554,19339184,-31222446,0
52650,76.0,"Comedy, Crime, Drama","An Ivy League professor is lured back to his Oklahoma hometown, where his twin brother, a small-time pot grower, has concocted a scheme to take down a local drug lord.",58.0,Tim Blake Nelson,Leaves of Grass,2009,105,USA, 9000000,70066,1034214,964148,-7965786,0
52652,20.0,"Drama, Romance","Tanner Hall is a vivid peek into the private world of an all-girls boarding school. In a cozy, but run-down New England, the knot of adolescent complexity is unraveled through the coming-of-age stories of four teenage girls.",40.0,"Francesca Gregorini, Tatiana von F√ºrstenberg",Tanner Hall,2009,96,USA, 3000000,5073,5073,0,-2994927,0
52659,75.0,"Comedy, Romance","Eugene believes in no sex before marriage. So DID his girlfriend, Cindi. His BFF loves sex. At Senior Prom, just before sex with Cindi, he falls into a coma. Waking up 4 years later, his Cindi is Miss March in Playboy. Can he get her back?",7.0,"Zach Cregger, Trevor Moore",Miss March,2009,90,USA, 6000000,4543320,4591629,48309,-1408371,0
52690,84.0,"Action, Comedy, Music","Street dancer Thomas Uncles is from the wrong side of the tracks, but his bond with the beautiful Megan White might help the duo realize their dreams as they enter in the mother of all dance battles.",40.0,Damien Dante Wayans,Dance Flick,2009,83,USA, 25000000,25662155,31439140,5776985,6439140,1
53192,194.0,"Comedy, Crime, Drama","Bi-polar mall security guard Ronnie Barnhardt is called into action to stop a flasher from turning shopper's paradise into his personal peep show. But when Barnhardt can't bring the culprit to justice, a surly police detective is recruited to close the case.",54.0,Jody Hill,Observe and Report,2009,86,USA, 18000000,24007324,26973554,2966230,8973554,1
52692,225.0,"Comedy, Romance","Friendless Peter Klaven goes on a series of man-dates to find a Best Man for his wedding. But, when his insta-bond with his new B.F.F. puts a strain on his relationship with his fianc√©e, can the trio learn to live happily ever after?",70.0,John Hamburg,"I Love You, Man",2009,105,USA, 40000000,71440011,91636986,20196975,51636986,1
52760,117.0,"Action, Crime, Thriller","Detective Danny Fisher discovers his girlfriend has been kidnapped by an ex-con tied to Fisher's past, and he'll have to successfully complete 12 challenges in order to secure her safe release.",38.0,Renny Harlin,12 Rounds,2009,108,USA, 22000000,12234694,17280326,5045632,-4719674,0
52775,104.0,"Adventure, Comedy, Sci-Fi",A teenager attends a fantasy writers' convention where he discovers his idea has been stolen by an established novelist.,28.0,Jared Hess,Gentlemen Broncos,2009,89,USA, 10000000,113682,118492,4810,-9881508,0
52852,193.0,"Drama, Sport","In Bodeen, Texas, an indie-rock loving misfit finds a way of dealing with her small-town misery after she discovers a roller derby league in nearby Austin.",68.0,Drew Barrymore,Whip It,2009,111,USA, 15000000,13043363,16633035,3589672,1633035,1
52861,252.0,Horror,"In 1983, financially struggling college student Samantha Hughes takes a strange babysitting job that coincides with a full lunar eclipse. She slowly realizes her clients harbor a terrifying secret, putting her life in mortal danger.",73.0,Ti West,The House of the Devil,2009,95,USA, 900000,101215,101215,0,-798785,0
52890,146.0,"Comedy, Drama","The Rizzos, a family who doesn't share their habits, aspirations, and careers with one another, find their delicate web of lies disturbed by the arrival of a young ex-con (Strait) brought ...",66.0,Raymond De Felitta,City Island,2009,104,USA, 6000000,6671036,7875862,1204826,1875862,1
52963,206.0,"Horror, Mystery, Thriller","Tom returns to his hometown on the tenth anniversary of the Valentine's night massacre that claimed the lives of 22 people. Instead of a homecoming, Tom finds himself suspected of committing the murders, and it seems like his old flame is the only one that believes he's innocent.",51.0,Patrick Lussier,My Bloody Valentine,2009,101,USA, 15000000,51545952,100734718,49188766,85734718,1
53019,26.0,"Comedy, Romance",A romantic comedy that explores the adult film industry through the eyes of an idealistic 25 year-old award winning film school grad.,30.0,Julie Davis,Finding Bliss,2009,96,USA, 1500000,6783,6783,0,-1493217,0
42175,291.0,"Drama, Fantasy, Mystery","A small wooden box arrives on the doorstep of a married couple, who know that opening it will grant them a million dollars and kill someone they don't know.",47.0,Richard Kelly,The Box,2009,115,USA, 30000000,15051977,33334176,18282199,3334176,1
53102,226.0,"Action, Adventure, Sci-Fi",A frustrated writer struggles to keep his family alive when a series of global catastrophes threatens to annihilate mankind.,49.0,Roland Emmerich,2012,2009,158,USA, 200000000,166112167,788550900,622438733,588550900,1
53103,176.0,"Action, Comedy","Black Dynamite is the greatest African-American action star of the 1970s. When his only brother is killed by The Man, it's up to him to find justice.",65.0,Scott Sanders,Black Dynamite,2009,84,USA, 2900000,242578,296557,53979,-2603443,0
40988,332.0,"Animation, Drama, Fantasy","An adventurous 11-year-old girl finds another world that is a strangely idealized version of her frustrating home, but it has sinister secrets.",80.0,Henry Selick,Coraline,2009,100,USA, 60000000,75286229,124596398,49310169,64596398,1
53131,409.0,"Comedy, Drama, Romance","Ryan Bingham enjoys living out of a suitcase for his job, travelling around the country firing people, but finds that lifestyle threatened by the presence of a potential love interest, and a new hire.",83.0,Jason Reitman,Up in the Air,2009,109,USA, 25000000,83823381,166842739,83019358,141842739,1
52713,476.0,"Adventure, Comedy, Horror","A shy student trying to reach his family in Ohio, a gun-toting tough guy trying to find the last Twinkie, and a pair of sisters trying to get to an amusement park join forces to travel across a zombie-filled America.",73.0,Ruben Fleischer,Zombieland,2009,88,USA, 23600000,75590286,102392080,26801794,78792080,1
51026,131.0,"Comedy, Drama, Musical",An updated version of the musical,39.0,Kevin Tancharoen,Fame,2009,107,USA, 18000000,22455510,77211836,54756326,59211836,1
54621,239.0,Horror,"Laurie Strode struggles to come to terms with her brother Michael's deadly return to Haddonfield, Illinois; meanwhile, Michael prepares for another reunion with his sister.",35.0,Rob Zombie,Halloween II,2009,105,USA, 15000000,33392973,39421467,6028494,24421467,1
49337,190.0,"Animation, Adventure, Comedy","A local scientist is often regarded as a failure until he invents a machine that can make food fall from the sky. But little does he know, that things are about to take a turn for the worst.",66.0,"Phil Lord, Christopher Miller",Cloudy with a Chance of Meatballs,2009,90,USA, 100000000,124870275,243006126,118135851,143006126,1
49267,140.0,"Drama, Mystery, Thriller","After a car accident, a young woman caught between life and death meets a funeral director who claims to have the gift of transitioning the dead into the afterlife.",36.0,Agnieszka Wojtowicz-Vosloo,After.Life,2009,104,USA, 4500000,108595,2005519,1896924,-2494481,0
49324,14.0,Comedy,"The employees of a low-end electronics store find creative ways to stave off boredom and their impending adulthood, but when one of them gets married they all must face the realities of growing up.",24.0,Jameel Khan,The Strip,2009,91,USA, 1200000,5107,5107,0,-1194893,0
50607,124.0,"Comedy, Family",Two friends and business partners find their lives turned upside down when strange circumstances lead them to be the temporary guardians of seven year-old twins.,19.0,Walt Becker,Old Dogs,2009,88,USA, 35000000,49492060,96753696,47261636,61753696,1
50605,78.0,"Comedy, Drama, Family","A new kid in town assembles a fledgling rock band -- together, they achieve their dreams and compete against the best in the biggest event of the year, a battle of the bands.",66.0,Todd Graff,Bandslam,2009,111,USA, 20000000,5210988,12225023,7014035,-7774977,0
50581,193.0,"Comedy, Drama, Fantasy",Mike O'Donnell is ungrateful for how his life turned out. He gets a chance to rewrite his life when he tried to save a janitor near a bridge and jumped after him into a time vortex.,48.0,Burr Steers,17 Again,2009,102,USA, 20000000,64167069,136267476,72100407,116267476,1
50547,103.0,"Action, Adventure, Drama",Two pairs of lovers on a Hawaiian vacation discover that psychopaths are stalking and murdering tourists on the islands.,63.0,David Twohy,A Perfect Getaway,2009,98,USA, 14000000,15515460,22869853,7354393,8869853,1
49923,54.0,"Drama, Romance",Twenty-eight-year-old Kansas University doctoral student Omar Razaghi (Omar Metwally) wins a grant to write a biography of Latin American writer Jules Gund. Omar must get through to three ...,52.0,James Ivory,The City of Your Final Destination,2009,117,USA, 8300000,493296,1356253,862957,-6943747,0
49339,155.0,"Horror, Thriller","Desperate to repay his debt to his ex-wife, an ex-con plots a heist at his new employer's country home, unaware that a second criminal has also targeted the property, and rigged it with a series of deadly traps.",29.0,Marcus Dunstan,The Collector,2009,90,USA, 6000000,7712114,9444018,1731904,3444018,1
50426,55.0,"Fantasy, Horror, Thriller","Nine friends take a holiday at a Victorian home on a private island and uncover a game that when played brings out the worst in each of them. Jealously, greed, hatred, lust, all of the things they keep buried deep inside themselves rise to the surface and come to a boil.",31.0,Gabriel Bologna,The Black Waters of Echo's Pond,2009,89,USA, 5000000,224409,224409,0,-4775591,0
47693,125.0,"Adventure, Comedy, Drama",Star Wars fanatics take a cross-country trip to,45.0,Kyle Newman,Fanboys,2009,90,USA, 3900000,688529,960828,272299,-2939172,0
48538,41.0,"Drama, Romance",A car accident and shifting affections test the bond between a married couple.,43.0,Bill Duke,Not Easily Broken,2009,99,USA, 5000000,10572742,10726909,154167,5726909,1
48476,217.0,"Drama, Romance, War",An American soldier struggles with an ethical dilemma when he becomes involved with a widow of a fallen officer.,77.0,Oren Moverman,The Messenger,2009,113,USA, 6500000,1109660,1521261,411601,-4978739,0
50210,329.0,Drama,"In New York City's Harlem circa 1987, an overweight, abused, illiterate teen who is pregnant with her second child is invited to enroll in an alternative school in hopes that her life can head in a new direction.",79.0,Lee Daniels,Precious,2009,110,USA, 10000000,47566524,63647833,16081309,53647833,1
49940,366.0,Drama,"In a dangerous post-apocalyptic world, an ailing father defends his son as they slowly travel to the sea.",64.0,John Hillcoat,The Road,2009,111,USA, 25000000,8117000,27635305,19518305,2635305,1
49958,159.0,"Comedy, Romance",Two best friends become rivals when they schedule their respective weddings on the same day.,24.0,Gary Winick,Bride Wars,2009,89,USA, 30000000,58715510,115154152,56438642,85154152,1
49888,227.0,"Animation, Action, Comedy",A woman transformed into a giant after she is struck by a meteorite on her wedding day becomes part of a team of monsters sent in by the U.S. government to defeat an alien mastermind trying to take over Earth.,56.0,"Rob Letterman, Conrad Vernon",Monsters vs. Aliens,2009,94,USA, 175000000,198351526,381509870,183158344,206509870,1
48171,34.0,"Comedy, Romance","A florist, who abides by a strict five-date-limit with any man, finds herself wanting more with the new restaurateur in town.",17.0,Nia Vardalos,I Hate Valentine's Day,2009,98,USA, 3000000,11004,3510643,3499639,510643,1
49742,127.0,"Comedy, Romance","Convinced that a CCN cameraman is her true love, an eccentric crossword puzzler trails him as he travels all over the country, hoping to convince him that they belong together.",17.0,Phil Traill,All About Steve,2009,99,USA, 15000000,33862903,40105542,6242639,25105542,1
49264,128.0,"Action, Adventure, Comedy",Insp. Jacques Clouseau teams up with a squad of International detectives who are just as bumbling as he is. Their mission: Stop a globe-trotting thief who specializes in stealing historical artifacts.,36.0,Harald Zwart,The Pink Panther 2,2009,92,USA, 70000000,35922978,75946615,40023637,5946615,1
48130,331.0,"Horror, Mystery, Thriller","A group of young adults discover a boarded up Camp Crystal Lake, where they soon encounter Jason Voorhees and his deadly intentions.",34.0,Marcus Nispel,Friday the 13th,2009,97,USA, 19000000,65002019,91379051,26377032,72379051,1
48072,727.0,"Action, Adventure, Fantasy",A paraplegic Marine dispatched to the moon Pandora on a unique mission becomes torn between following his orders and protecting the world he feels is his home.,83.0,James Cameron,Avatar,2009,162,USA, 237000000,760507625,2789968301,2029460676,2552968301,1
48348,161.0,"Adventure, Drama",A widower who realized his only connection to his family was through his wife sets off on an impromptu road trip to reunite with each of his grown children.,47.0,Kirk Jones,Everybody's Fine,2009,99,USA, 21000000,9208876,16443609,7234733,-4556391,0
48351,235.0,"Animation, Adventure, Comedy","A waitress, desperate to fulfill her dreams as a restaurant owner, is set on a journey to turn a frog prince back into a human being, but she has to face the same problem after she kisses him.",73.0,"Ron Clements, John Musker",The Princess and the Frog,2009,97,USA, 105000000,104400899,267045765,162644866,162045765,1
49712,271.0,"Biography, Drama, Sport","The story of Michael Oher, a homeless and traumatized boy who became an All-American football player and first-round NFL draft pick with the help of a caring woman and her family.",53.0,John Lee Hancock,The Blind Side,2009,129,USA, 29000000,255959475,309208309,53248834,280208309,1
50139,111.0,"Crime, Drama",Crossing Over is about illegal aliens of many nationalities in the Los Angeles area and the authorities and individuals dealing with them.,38.0,Wayne Kramer,Crossing Over,2009,113,USA, 19000000,455654,3529869,3074215,-15470131,0
50069,113.0,"Action, Crime, Thriller","A newbie guard for an armored truck company is coerced by his veteran coworkers to steal a truck containing $42 million. But a wrinkle in their supposedly foolproof plan divides the group, leading to a potentially deadly resolution.",50.0,Nimr√≥d Antal,Armored,2009,88,USA, 20000000,15988876,22942221,6953345,2942221,1
48194,216.0,"Action, Drama, Thriller",A young man comforts his older brother's wife and children after he goes missing in Afghanistan.,58.0,Jim Sheridan,Brothers,2009,105,USA, 26000000,28544157,43318349,14774192,17318349,1
50710,268.0,"Action, Crime, Sci-Fi","Set in a futuristic world where humans live in isolation and interact through surrogate robots, a cop is forced to leave his home for the first time in years in order to investigate the murders of others' surrogates.",45.0,Jonathan Mostow,Surrogates,2009,89,USA, 80000000,38577772,122444772,83867000,42444772,1
49010,148.0,"Comedy, Fantasy, Romance","While attending his brother's wedding, a serial womanizer is haunted by the ghosts of his past girlfriends.",34.0,Mark Waters,Ghosts of Girlfriends Past,2009,100,USA, 37500000,55250026,102223269,46973243,64723269,1
46924,271.0,"Animation, Action, Adventure",A rag doll that awakens in a postapocalyptic future holds the key to humanity's salvation.,60.0,Shane Acker,9,2009,79,USA, 30000000,31749894,48428063,16678169,18428063,1
48878,123.0,"Crime, Thriller","Michael Harding (Penn Badgely) returns home from military school to find his mother Susan (Sela Ward) happily in love and living with her new boyfriend David (Dylan Walsh). As the two men get to know each other, he becomes more and more suspicious of the man who is always there with a helpful hand.",33.0,Nelson McCormick,The Stepfather,2009,101,USA, 20000000,29062561,31198531,2135970,11198531,1
46941,132.0,"Biography, Crime, Drama","The life and death story of Notorious B.I.G. (a.k.a. Christopher Wallace), who came straight out of Brooklyn to take the world of rap music by storm.",60.0,George Tillman Jr.,Notorious,2009,122,USA, 20000000,36843682,44371751,7528069,24371751,1
48762,152.0,"Comedy, Drama","Friends, family, and lovers struggle to find love, forgiveness, and meaning in an almost war-torn world riddled with comedy and pathos.",69.0,Todd Solondz,Life During Wartime,2009,98,USA, 4500000,281447,791946,510499,-3708054,0
50938,21.0,"Comedy, Drama","Movie centers on the adult son of a baseball legend who, together with his girlfriend, embarks on a road trip with his estranged father.",47.0,Michael Meredith,The Open Road,2009,90,USA, 10000000,19716,19716,0,-9980284,0
54760,168.0,"Comedy, Romance",A romantic comedy centered on a guy and a gal who try to keep their love alive as they shuttle back and forth between New York and San Francisco to see one another.,51.0,Nanette Burstein,Going the Distance,2010,102,USA, 32000000,17804299,42052757,24248458,10052757,1
48372,373.0,"Drama, Fantasy, Horror","Upon his return to his ancestral homeland, an American man is bitten, and subsequently cursed by, a werewolf.",43.0,Joe Johnston,The Wolfman,2010,103,USA, 150000000,61979680,139789765,77810085,-10210235,0
53140,140.0,"Drama, Music, Romance",A tight-knit group of New York City street dancers find themselves pitted against the world's best hip hop dancers in a high-stakes showdown.,45.0,Jon M. Chu,Step Up 3D,2010,107,USA, 30000000,42400223,159291809,116891586,129291809,1
53182,26.0,"Drama, Thriller",A couple goes to dangerous lengths to find a lung donor for their daughter.,39.0,Baltasar Korm√°kur,Inhale,2010,83,USA, 10000000,4115,55089,50974,-9944911,0
54381,46.0,"Comedy, Drama, Romance","When an awkward teen meets his favorite porn star, whose career peaked in the '80s, an unexpected friendship follows as the young man gets a glimpse inside Monica Velour's current life as a single mom struggling to make ends meet.",51.0,Keith Bearden,Meet Monica Velour,2010,96,USA, 5000000,33042,33042,0,-4966958,0
58361,120.0,Comedy,"A spoof of vampire-themed movies. Teenager, Becca finds herself torn between 2 boys. As she and her friends wrestle with a number of different dramas, everything comes to a head at their prom.",18.0,"Jason Friedberg, Aaron Seltzer",Vampires Suck,2010,82,USA, 20000000,36661504,80547866,43886362,60547866,1
54796,285.0,"Action, Adventure, Crime","As a string of mysterious killings grips Seattle, Bella, whose high school graduation is fast approaching, is forced to choose between her love for vampire Edward and her friendship with werewolf Jacob.",58.0,David Slade,The Twilight Saga: Eclipse,2010,124,USA, 68000000,300531751,698491347,397959596,630491347,1
56245,13.0,Drama,Two men embark on a music-steeped journey through the American South.,44.0,Mario Van Peebles,Redemption Road,2010,95,USA, 2300000,29384,29384,0,-2270616,0
48904,182.0,"Comedy, Romance","An average Joe meets the perfect woman, but his lack of confidence and the influence of his friends and family begin to pick away at the relationship.",46.0,Jim Field Smith,She's Out of My League,2010,104,USA, 20000000,32010860,49779728,17768868,29779728,1
56184,221.0,"Drama, Horror, Sci-Fi","In a world of vampires, an expert vampire hunter and his young prot√©g√© travel toward sanctuary.",66.0,Jim Mickle,Stake Land,2010,98,USA, 650000,33245,405380,372135,-244620,0
53314,20.0,Drama,"A drama based on a true story, in which a black Vietnam-era veteran is allegedly murdered by a local white businessman, who is later exonerated. The plot focuses on the role of a local high school teacher, and the civil unrest that followed the acquittal.",49.0,Jeb Stuart,Blood Done Sign My Name,2010,128,USA, 10000000,109383,109383,0,-9890617,0
58718,44.0,Comedy,"Four guys, one camera, and their experience chronicling the exhilarating and terrifying rite of passage: losing your virginity. As these guys help their buddy get laid, they'll have to ...",40.0,"Huck Botko, Andrew Gurland",The Virginity Hit,2010,86,USA, 2000000,636706,636706,0,-1363294,0
56159,20.0,"Drama, Family","A young boy fighting cancer writes letters to God, touching lives in his neighborhood and community and inspiring hope among everyone he comes in contact. An unsuspecting substitute postman...",31.0,"David Nixon, Patrick Doughtie",Letters to God,2010,110,USA, 3000000,2848578,3269546,420968,269546,1
56068,143.0,"Horror, Mystery, Thriller","The population of Detroit has almost completely disappeared, but a few remain. As daylight disappears they realize that the Dark is coming for them.",50.0,Brad Anderson,Vanishing on 7th Street,2010,92,USA, 10000000,22729,1068682,1045953,-8931318,0
53347,321.0,"Drama, Fantasy, Romance","A drama centered on three people - a blue-collar American, a French journalist and a London school boy - who are touched by death in different ways.",56.0,Clint Eastwood,Hereafter,2010,129,USA, 50000000,32746941,105197635,72450694,55197635,1
53349,147.0,"Comedy, Romance","A woman conceives twins through artificial insemination, only to meet the man of her dreams on the very same day.",34.0,Alan Poul,The Back-up Plan,2010,104,USA, 35000000,37490007,77477008,39987001,42477008,1
56248,144.0,"Action, Comedy, Romance","Former special operative MacGruber is called back into action to take down his arch-enemy, Dieter Von Cunth, who's in possession of a nuclear warhead and bent on destroying Washington, D.C.",43.0,Jorma Taccone,MacGruber,2010,90,USA, 10000000,8525600,9322895,797295,-677105,0
49659,159.0,"Horror, Mystery, Thriller",A serial killer returns to his hometown to stalk seven children who share the same birthday as the date he was allegedly put to rest.,25.0,Wes Craven,My Soul to Take,2010,107,USA, 25000000,14744435,20976402,6231967,-4023598,0
49714,134.0,"Comedy, Drama","In New York City, a husband and wife butt heads with the granddaughters of the elderly woman who lives in the apartment the couple owns.",78.0,Nicole Holofcener,Please Give,2010,87,USA, 3000000,4033574,4313085,279511,1313085,1
53030,149.0,"Comedy, Romance","Beth is a young, ambitious New Yorker who is completely unlucky in love. However, on a whirlwind trip to Rome, she impulsively steals some coins from a reputed fountain of love, and is then aggressively pursued by a band of suitors.",25.0,Mark Steven Johnson,When in Rome,2010,91,USA, 55000000,32680633,43042835,10362202,-11957165,0
49889,224.0,"Animation, Adventure, Comedy",Rumpelstiltskin tricks a mid-life crisis burdened Shrek into allowing himself to be erased from existence and cast in a dark alternate timeline where Rumpel rules supreme.,58.0,Mike Mitchell,Shrek Forever After,2010,93,USA, 165000000,238736787,752600867,513864080,587600867,1
54672,274.0,"Horror, Mystery, Thriller",A group of people are trapped in an elevator and the Devil is mysteriously amongst them.,44.0,John Erick Dowdle,Devil,2010,80,USA, 10000000,33601190,62695489,29094299,52695489,1
54534,68.0,"Comedy, Romance","The weeks leading up to a young couple's wedding are comic and stressful, especially as their respective fathers try to lay their long standing feud to rest.",38.0,Rick Famuyiwa,Our Family Wedding,2010,103,USA, 14000000,20255281,21409028,1153747,7409028,1
49887,304.0,"Animation, Action, Adventure","A hapless young Viking who aspires to hunt dragons becomes the unlikely friend of a young dragon himself, and learns there may be more to the creatures than he assumed.",74.0,"Dean DeBlois, Chris Sanders",How to Train Your Dragon,2010,98,USA, 165000000,217581231,494878759,277297528,329878759,1
49880,161.0,"Adventure, Comedy, Drama","Sophie dreams of becoming a writer and travels to Verona, Italy where she meets the ""Secretaries of Juliet"".",50.0,Gary Winick,Letters to Juliet,2010,105,USA, 30000000,53032453,79181750,26149297,49181750,1
54499,46.0,"Comedy, Drama, Romance",A comedy about a New York City couple (Schreiber and Hunt) in romantic and family crises.,48.0,Richard Levine,Every Day,2010,93,USA, 3000000,46029,46029,0,-2953971,0
49840,183.0,"Comedy, Drama, Romance","Seven years after the fact, a man comes to the realization that he was the sperm donor for his best friend's boy.",52.0,"Josh Gordon, Will Speck",The Switch,2010,101,USA, 19000000,27779426,49843011,22063585,30843011,1
48942,88.0,"Comedy, Drama, Romance",Two eighth-graders start to have feelings for each other despite being total opposites.,45.0,Rob Reiner,Flipped,2010,90,USA, 14000000,1755212,4225921,2470709,-9774079,0
48945,190.0,"Comedy, Romance",Intertwining couples and singles in Los Angeles break-up and make-up based on the pressures and expectations of Valentine's Day.,34.0,Garry Marshall,Valentine's Day,2010,125,USA, 52000000,110485654,216485654,106000000,164485654,1
52860,220.0,Drama,"The story centers on a year in the life of three men trying to survive a round of corporate downsizing at a major company - and how that affects them, their families, and their communities.",69.0,John Wells,The Company Men,2010,104,USA, 15000000,4441272,4882577,441305,-10117423,0
54745,119.0,Comedy,A funeral ceremony turns into a debacle of exposed family secrets and misplaced bodies.,51.0,Neil LaBute,Death at a Funeral,2010,92,USA, 21000000,42739347,49050886,6311539,28050886,1
54449,24.0,"Comedy, Drama, Romance","A Hollywood-set romantic tale of a guy who is content to live his life without a job yet with the love of his life, a young actress.",26.0,James Keach,Waiting for Forever,2010,95,USA, 5000000,25517,25517,0,-4974483,0
54753,22.0,Drama,A U.S. soldier returning home from war struggles to reconcile his experiences abroad with the life and family he left in Texas.,47.0,Ryan Piers Williams,The Dry Land,2010,92,USA, 1000000,11777,11777,0,-988223,0
52940,379.0,"Crime, Drama, Horror","The spectre of a disfigured man haunts the children of the parents who murdered him, stalking and killing them in their dreams.",35.0,Samuel Bayer,A Nightmare on Elm Street,2010,95,USA, 35000000,63075011,115664037,52589026,80664037,1
54415,122.0,"Drama, Music, Romance","A rebellious girl is sent to a Southern beach town for the summer to stay with her father. Through their mutual love of music, the estranged duo learn to reconnect.",33.0,Julie Anne Robinson,The Last Song,2010,107,USA, 20000000,62950384,89041656,26091272,69041656,1
49722,216.0,"Drama, Romance","A married woman realizes how unhappy her marriage really is, and that her life needs to go in a different direction. After a painful divorce, she takes off on a round-the-world journey to ""find herself"".",50.0,Ryan Murphy,Eat Pray Love,2010,133,USA, 60000000,80574010,204594016,124020006,144594016,1
54733,185.0,"Adventure, Comedy, Family","Travel writer Lemuel Gulliver takes an assignment in Bermuda, but ends up on the island of Lilliput, where he towers over its tiny citizens.",33.0,Rob Letterman,Gulliver's Travels,2010,85,USA, 112000000,42779261,237382724,194603463,125382724,1
55749,370.0,"Action, Adventure, Sci-Fi",A group of elite warriors parachute into an unfamiliar jungle and are hunted by members of a merciless alien race.,51.0,Nimr√≥d Antal,Predators,2010,107,USA, 40000000,52000688,127233108,75232420,87233108,1
55851,197.0,"Action, Crime, Drama",An ex-con gets on a series of apparently unrelated killings. He gets tracked by a veteran cop with secrets of his own and an egocentric hit man.,44.0,George Tillman Jr.,Faster,2010,98,USA, 24000000,23240020,35626958,12386938,11626958,1
54928,223.0,"Comedy, Drama, Romance","John and Molly, a divorced middle aged man and a single mother meet at a friends party and start up a small relationship, all John has to do now is meet Molly's son... Cyrus",74.0,"Jay Duplass, Mark Duplass",Cyrus,2010,91,USA, 7000000,7468936,9923855,2454919,2923855,1
54150,90.0,"Comedy, Drama, Fantasy","Shakespeare's epic play is translated from page to screen, with the gender of the main character, Prospero, changed from male to female.",43.0,Julie Taymor,The Tempest,2010,110,USA, 20000000,277943,346594,68651,-19653406,0
55390,274.0,"Action, Comedy, Crime","Two mismatched New York City detectives seize an opportunity to step up like the city's top cops, whom they idolize, only things don't quite go as planned.",64.0,Adam McKay,The Other Guys,2010,107,USA, 100000000,119219978,170432927,51212949,70432927,1
53818,128.0,Drama,A drama centered on the efforts of John and Aileen Crowley to find a researcher who might have a cure for their two children's rare genetic disorder.,45.0,Tom Vaughan,Extraordinary Measures,2010,106,USA, 31000000,12068313,15134293,3065980,-15865707,0
53821,182.0,"Biography, Crime, Drama","A working mother puts herself through law school in an effort to represent her brother, who has been wrongfully convicted of murder and has exhausted his chances to appeal his conviction through public defenders.",61.0,Tony Goldwyn,Conviction,2010,107,USA, 12500000,6783129,9710055,2926926,-2789945,0
54141,101.0,"Action, Comedy, Family","Former C.I.A. spy Bob Ho takes on his toughest assignment to date: looking after his girlfriend's three kids, who haven't exactly warmed to their mom's beau.",27.0,Brian Levant,The Spy Next Door,2010,94,USA, 28000000,24307086,66166000,41858914,38166000,1
53829,327.0,"Action, Comedy, Crime","When his peaceful life is threatened by a high-tech assassin, former black-ops Agent Frank Moses (Bruce Willis) reassembles his old team in a last ditch effort to survive and uncover his assailants.",60.0,Robert Schwentke,RED,2010,111,USA, 58000000,90380162,199006387,108626225,141006387,1
49307,323.0,"Comedy, Drama, Romance",Two children conceived by artificial insemination bring their biological father into their non-traditional family life.,86.0,Lisa Cholodenko,The Kids Are All Right,2010,106,USA, 4000000,20811365,34758951,13947586,30758951,1
53769,230.0,"Horror, Thriller","A writer who is brutalized during her cabin retreat seeks revenge on her attackers, who left her for dead.",27.0,Steven R. Monroe,I Spit on Your Grave,2010,108,USA, 2000000,93051,572809,479758,-1427191,0
53856,55.0,Comedy,"A high school valedictorian who gets baked with the local stoner finds himself the subject of a drug test. The situation causes him to concoct an ambitious plan to get his entire graduating class to face the same fate, and fail.",31.0,John Stalberg Jr.,High School,2010,99,USA, 10000000,139034,221590,82556,-9778410,0
55382,205.0,"Action, Comedy, Crime","Jimmy's rare baseball card is robbed. Since it's his only hope to pay for his daughter's upcoming wedding, he recruits his cop partner Paul to track down the robber, a memorabilia-obsessed gangster.",31.0,Kevin Smith,Cop Out,2010,107,USA, 30000000,44875481,55583804,10708323,25583804,1
48651,161.0,"Comedy, Drama, Romance",A clinically depressed teenager gets a new start after he checks himself into an adult psychiatric ward.,63.0,"Anna Boden, Ryan Fleck",It's Kind of a Funny Story,2010,101,USA, 8000000,6363628,6491240,127612,-1508760,0
54997,156.0,"Comedy, Drama, Romance","After being cut from the U.S.A. softball team and feeling a bit past her prime, Lisa finds herself evaluating her life and in the middle of a love triangle, as a corporate guy in crisis competes with her current, baseball-playing beau.",46.0,James L. Brooks,How Do You Know,2010,121,USA, 120000000,30212620,48668907,18456287,-71331093,0
55289,178.0,Comedy,"After their high school basketball coach passes away, five good friends and former teammates reunite for a Fourth of July holiday weekend.",30.0,Dennis Dugan,Grown Ups,2010,102,USA, 80000000,162001186,271430189,109429003,191430189,1
54114,138.0,"Action, Comedy, Horror","Marybeth escapes the clutches of the bayou-butcher Victor Crowley and returns to the swamp with an army of hunters and gunmen, determined to end Crowley's reign of horror once and for all.",49.0,Adam Green,Hatchet II,2010,85,USA, 800000,52604,156190,103586,-643810,0
53998,220.0,"Comedy, Drama, Romance","While wrestling with the pressures of life, love, and work in Manhattan, Carrie, Miranda, and Charlotte join Samantha for a trip to Abu Dhabi (United Arab Emirates), where Samantha's ex is filming a new movie.",27.0,Michael Patrick King,Sex and the City 2,2010,146,USA, 100000000,95347692,288347692,193000000,188347692,1
49284,388.0,"Crime, Drama, Thriller","As he plans his next job, a longtime thief tries to balance his feelings for a bank manager connected to one of his earlier heists, as well as the F.B.I. Agent looking to bring him and his crew down.",74.0,Ben Affleck,The Town,2010,125,USA, 37000000,92186262,154026136,61839874,117026136,1
54205,257.0,"Comedy, Crime, Romance","In New York City, a case of mistaken identity turns a bored married couple's attempt at a glamorous and romantic evening into something more thrilling and dangerous.",56.0,Shawn Levy,Date Night,2010,88,USA, 55000000,98711404,152263880,53552476,97263880,1
55446,37.0,"Comedy, Drama, Romance","Four couples find themselves struggling to save their marriages once again on their annual marriage retreat, while each of them battle through financial, physical, mental, and emotional issues.",43.0,Tyler Perry,Why Did I Get Married Too?,2010,121,USA, 20000000,60095852,60673972,578120,40673972,1
55456,98.0,"Comedy, Family","A suburban family moves to a new neighborhood with their large, yet lovable Great Dane, who has a tendency to wreak havoc in his own oblivious way.",30.0,Tom Dey,Marmaduke,2010,87,USA, 50000000,33644788,83761844,50117056,33761844,1
55740,130.0,"Drama, Thriller",A convicted arsonist looks to manipulate a parole officer into a plan to secure his parole by placing his beautiful wife in the lawman's path.,58.0,John Curran,Stone,2010,105,USA, 22000000,1810078,9479718,7669640,-12520282,0
55671,9.0,Comedy,An American couple and a foreign couple test the limits of friendship and love when they switch partners and get married for green cards.,28.0,David Burton Morris,Immigration Tango,2010,92,USA, 1100000,24554,24554,0,-1075446,0
53451,65.0,"Comedy, Crime, Drama","Released from prison for a crime he didn't commit, an ex-con targets the same bank he was sent away for robbing.",49.0,Malcolm Venville,Henry's Crime,2010,108,USA, 12000000,102541,204940,102399,-11795060,0
55655,89.0,"Comedy, Romance","When a young woman realizes her brother is about to marry the girl who bullied her in high school, she sets out to expose the fianc√©e's true colors.",28.0,Andy Fickman,You Again,2010,105,USA, 20000000,25702053,32005248,6303195,12005248,1
53506,215.0,"Comedy, Music",A record company intern is hired to accompany out-of-control British rock star Aldous Snow to a concert at L.A.'s Greek Theater.,65.0,Nicholas Stoller,Get Him to the Greek,2010,109,USA, 40000000,60974475,91261479,30287004,51261479,1
54270,577.0,"Biography, Drama",As Harvard student,95.0,David Fincher,The Social Network,2010,120,USA, 40000000,96962694,224920315,127957621,184920315,1
53538,483.0,"Action, Adventure, Sci-Fi","With the world now aware of his identity as Iron Man, Tony Stark must contend with both his declining health and a vengeful mad man with ties to his father's legacy.",57.0,Jon Favreau,Iron Man 2,2010,124,USA, 200000000,312433331,623933331,311500000,423933331,1
55568,73.0,Drama,"Each of the women portray one of the characters represented in the collection of twenty poems, revealing different issues that impact women in general and women of color in particular.",50.0,Tyler Perry,For Colored Girls,2010,133,USA, 21000000,37729698,37747016,17318,16747016,1
55558,37.0,"Comedy, Drama, Romance",Seven close friends reunite for the wedding of two of their friends. Problems arise because the bride and the maid of honor have had a long rivalry over the groom.,43.0,Galt Niederhoffer,The Romantics,2010,95,USA, 4500000,106524,123820,17296,-4376180,0
55555,148.0,"Drama, Romance","A romantic drama centered on two new lovers: Tyler, whose parents have split in the wake of his brother's suicide, and Ally, who lives each day to the fullest since witnessing her mother's murder.",40.0,Allen Coulter,Remember Me,2010,113,USA, 16000000,19068240,56032889,36964649,40032889,1
54234,269.0,"Comedy, Drama, Romance",A clean-cut high school student relies on the school's rumor mill to advance her social and financial standing.,72.0,Will Gluck,Easy A,2010,92,USA, 8000000,58401464,74952305,16550841,66952305,1
53597,311.0,"Adventure, Comedy",High-strung father-to-be Peter Highman is forced to hitch a ride with aspiring actor Ethan Tremblay on a road trip in order to make it to his child's birth on time.,51.0,Todd Phillips,Due Date,2010,95,USA, 65000000,100539043,211780824,111241781,146780824,1
53599,267.0,"Comedy, Sci-Fi","A malfunctioning time machine at a ski resort takes a man back to 1986 with his two friends and nephew, where they must relive a fateful night and not change anything to make sure the nephew is born.",63.0,Steve Pink,Hot Tub Time Machine,2010,101,USA, 36000000,50287556,64616723,14329167,28616723,1
55554,515.0,"Drama, Western",A stubborn teenager enlists the help of a tough U.S. Marshal to track down her father's murderer.,80.0,"Ethan Coen, Joel Coen",True Grit,2010,110,USA, 38000000,171243005,252276927,81033922,214276927,1
54914,111.0,"Comedy, Crime, Thriller",An on-the-run convict looking for temporary cover finds it at the house of a very colorful character.,48.0,Nick Tomnay,The Perfect Host,2010,93,USA, 500000,48764,453708,404944,-46292,0
55547,137.0,"Comedy, Crime, Drama",A young boy has lost his mother and is losing touch with his father and the world around him. Then he meets Hesher who manages to make his life even more chaotic.,45.0,Spencer Susser,Hesher,2010,106,USA, 7000000,382946,449702,66756,-6550298,0
55516,372.0,"Drama, Mystery",An unflinching Ozark Mountain girl hacks through dangerous social terrain as she hunts down her drug-dealing father while trying to keep her family intact.,90.0,Debra Granik,Winter's Bone,2010,100,USA, 2000000,6531503,13796834,7265331,11796834,1
55484,59.0,"Drama, Fantasy, Romance",An angel under the thumb of a ruthless gangster is saved by a trumpet player down on his luck.,22.0,Mitch Glazer,Passion Play,2010,94,USA, 8000000,3669,25603,21934,-7974397,0
40953,27.0,"Drama, Mystery, Thriller","Marcus is a popular massage therapist who struggles with parasomnia, a severe sleepwalking disorder that causes him to do things in his sleep that he cannot remember the next day. When he ...",33.0,Allen Wolf,In My Sleep,2010,104,USA, 1000000,30158,30158,0,-969842,0
50993,138.0,"Action, Comedy, Crime","The adventures of supernatural private investigator, Dylan Dog, who seeks out the monsters of the Louisiana bayou in his signature red shirt, black jacket, and blue jeans.",31.0,Kevin Munroe,Dylan Dog: Dead of Night,2010,107,USA, 20000000,1186538,4634062,3447524,-15365938,0
51839,17.0,Drama,A young man named Victor realizes the shortcomings of the Utopian ideals on the hippie commune where he was raised. Victor's mother is funding the commune where the guru Insley hypnotizes ...,24.0,Adam Sherman,Happiness Runs,2010,88,USA, 1200000,7199,7199,0,-1192801,0
50480,407.0,"Biography, Drama, Sport","Based on the story of Micky Ward, a fledgling boxer who tries to escape the shadow of his more famous but troubled older boxing brother and get his own shot at greatness.",79.0,David O. Russell,The Fighter,2010,116,USA, 25000000,93617009,129190869,35573860,104190869,1
51338,163.0,"Action, Comedy, Romance","A bounty hunter learns that his next target is his ex-wife, a reporter working on a murder cover-up. Soon after their reunion, the always-at-odds duo find themselves on a run-for-their-lives adventure.",22.0,Andy Tennant,The Bounty Hunter,2010,110,USA, 40000000,67061228,136333522,69272294,96333522,1
51334,227.0,"Action, Adventure, Fantasy","When a group of strangers at a dusty roadside diner come under attack by demonic forces, their only chance for survival lies with an archangel named Michael, who informs a pregnant waitress that her unborn child is humanity's last hope.",32.0,Scott Stewart,Legion,2010,100,USA, 26000000,40168080,67918658,27750578,41918658,1
51318,333.0,"Action, Adventure, Drama","A post-apocalyptic tale, in which a lone man fights his way across America in order to protect a sacred book that holds the secrets to saving humankind.",53.0,"Albert Hughes, Allen Hughes",The Book of Eli,2010,118,USA, 80000000,94835059,157107755,62272696,77107755,1
52127,142.0,"Action, Comedy, Romance","A vacationing woman meets her ideal man, leading to a swift marriage. Back at home, however, their idyllic life is upset when they discover their neighbors could be assassins who have been contracted to kill the couple..",21.0,Robert Luketic,Killers,2010,100,USA, 75000000,47059963,98159963,51100000,23159963,1
56955,15.0,"Comedy, Drama","On the verge of getting married, Sam Nussbaum insists he escort his younger brother, Tom, on a wild goose chase of a journey to find Tom's fifth grade girlfriend.",56.0,Drake Doremus,Douchebag,2010,81,USA, 500000,20615,20615,0,-479385,0
50735,163.0,"Drama, Romance, War",A romantic drama about a soldier who falls for a conservative college student while he's home on leave.,43.0,Lasse Hallstr√∂m,Dear John,2010,108,USA, 25000000,80014842,114977104,34962262,89977104,1
52140,476.0,"Action, Adventure, Sci-Fi",The son of a virtual world designer goes looking for his father and ends up inside the digital world that his father designed. He meets his father's corrupted creation and a unique ally who was born inside the digital world.,49.0,Joseph Kosinski,Tron,2010,125,USA, 170000000,172062763,400062763,228000000,230062763,1
43793,337.0,"Animation, Adventure, Comedy","The magically long-haired Rapunzel has spent her entire life in a tower, but now that a runaway thief has stumbled upon her, she is about to discover the world for the first time, and who she really is.",71.0,"Nathan Greno, Byron Howard",Tangled,2010,100,USA, 260000000,200821936,591794936,390973000,331794936,1
56900,169.0,"Comedy, Drama, Romance",A young man is rocked by two announcements from his elderly father: that he has terminal cancer and that he has a young male lover.,81.0,Mike Mills,Beginners,2010,105,USA, 3200000,5790894,14311701,8520807,11111701,1
52194,65.0,"Comedy, Drama","It's 1987 and Danielle, the high school 'Dirty Girl', is running away. With her is chubby, gay Clarke, a bag of flour called Joan and a Walkman full of glorious '80s tunes.",37.0,Abe Sylvia,Dirty Girl,2010,90,USA, 4000000,55125,143485,88360,-3856515,0
50346,685.0,"Drama, Thriller","A committed dancer struggles to maintain her sanity after winning the lead role in a production of Tchaikovsky's ""Swan Lake"".",79.0,Darren Aronofsky,Black Swan,2010,108,USA, 13000000,106954678,329398046,222443368,316398046,1
57293,114.0,"Comedy, Drama, Romance",About a recent college grad who returns home while she tries to figure out what to do with her life.,72.0,Lena Dunham,Tiny Furniture,2010,98,USA, 65000,391674,416498,24824,351498,1
52295,395.0,"Drama, Romance","The relationship of a contemporary married couple, charting their evolution over a span of years by cross-cutting between time periods.",81.0,Derek Cianfrance,Blue Valentine,2010,112,USA, 1000000,9706328,12903649,3197321,11903649,1
56964,215.0,Horror,"After experiencing what they think are a series of ""break-ins"", a family sets up security cameras around their home, only to realize that the events unfolding before them are more sinister than they seem.",53.0,Tod Williams,Paranormal Activity 2,2010,91,USA, 3000000,84752907,177512032,92759125,174512032,1
46978,311.0,"Action, Fantasy",A young fugitive Prince and Princess must stop a villain who unknowingly threatens to destroy the world with a special dagger that enables the magic sand inside to reverse time.,50.0,Mike Newell,Prince of Persia: The Sands of Time,2010,116,USA, 200000000,90759676,336365676,245606000,136365676,1
57044,24.0,Drama,"Everything can change in an instant, and take a lifetime to unravel. Every day, we have the opportunity to rebuild relationships by extending and receiving God's grace. Offer The Grace Card, and never underestimate the power of God's love.",43.0,David G. Evans,The Grace Card,2010,101,USA, 200000,2430735,2430735,0,2230735,1
50473,237.0,"Action, Adventure, Family",Master sorcerer Balthazar Blake must find and train Merlin's descendant to defeat dark sorceress Morgana la F√©e.,46.0,Jon Turteltaub,The Sorcerer's Apprentice,2010,109,USA, 150000000,63150991,215283742,152132751,65283742,1
45012,189.0,Comedy,"When he finds out that his work superiors host a dinner celebrating the idiocy of their guests, a rising executive questions it when he's invited, just as he befriends a man who would be the perfect guest.",56.0,Jay Roach,Dinner for Schmucks,2010,114,USA, 69000000,73026337,86855739,13829402,17855739,1
51546,144.0,"Comedy, Drama, Romance",Two single adults become caregivers to an orphaned girl when their mutual best friends die in an accident.,39.0,Greg Berlanti,Life as We Know It,2010,114,USA, 38000000,53374681,105648706,52274025,67648706,1
57196,33.0,"Drama, War",A fictional account of events during the Philippine-American War.,63.0,John Sayles,Amigo,2010,124,USA, 1500000,184705,184705,0,-1315295,0
57126,134.0,"Drama, Music","A rising country-music songwriter works with a fallen star to work their way to fame, causing romantic complications along the way.",45.0,Shana Feste,Country Strong,2010,117,USA, 15000000,20218921,20529194,310273,5529194,1
47147,322.0,"Action, Thriller","With an unmanned, half-mile-long freight train barreling toward a city, a veteran engineer and a young conductor race against the clock to prevent a catastrophe.",69.0,Tony Scott,Unstoppable,2010,98,USA, 100000000,81562942,167805466,86242524,67805466,1
51793,186.0,"Action, Drama, Fantasy","The U.S. military makes a scarred bounty hunter with warrants on his own head an offer he cannot refuse: in exchange for his freedom, he must stop a terrorist who is ready to unleash Hell on Earth.",33.0,Jimmy Hayward,Jonah Hex,2010,81,USA, 47000000,10547117,10903312,356195,-36096688,0
50324,333.0,"Action, Mystery, Thriller",A CIA agent goes on the run after a defector accuses her of being a Russian spy.,65.0,Phillip Noyce,Salt,2010,100,USA, 110000000,118311368,293503354,175191986,183503354,1
50535,178.0,"Comedy, Romance","Family-patriarch Jack Byrnes wants to appoint a successor. Does his son-in-law, the male nurse Greg Focker, have what it takes?",27.0,Paul Weitz,Little Fockers,2010,98,USA, 100000000,148438600,310650585,162211985,210650585,1
57905,12.0,Drama,"Chronicles a day in the life of a grieving woman, and the twelve visitors who help her move forward.",71.0,Ava DuVernay,I Will Follow,2010,80,USA, 50000,135809,135809,0,85809,1
50700,402.0,"Action, Crime, Thriller","After being set-up and betrayed by the man who hired him to assassinate a Texas Senator, an ex-Federale launches a brutal rampage of revenge against his former boss.",60.0,"Ethan Maniquis, Robert Rodriguez",Machete,2010,105,USA, 10500000,26593646,44093316,17499670,33593316,1
54652,19.0,Drama,The story of three people from the same suburban town during the course of one curious autumn day.,69.0,Eric Mendelsohn,3 Backyards,2010,88,USA, 300000,43073,43073,0,-256927,0
50495,201.0,"Crime, Drama, History","Mary Surratt is the lone female charged as a co-conspirator in the assassination trial of Abraham Lincoln. As the whole nation turns against her, she is forced to rely on her reluctant lawyer to uncover the truth and save her life.",55.0,Robert Redford,The Conspirator,2010,122,USA, 25000000,11538204,15481161,3942957,-9518839,0
57217,225.0,"Action, Sci-Fi, Thriller","Strange lights descend on the city of Los Angeles, drawing people outside like moths to a flame where an extraterrestrial force threatens to swallow the entire human population off the face of the Earth.",26.0,"Colin Strause, Greg Strause",Skyline,2010,92,USA, 10000000,21393620,66821036,45427416,56821036,1
47331,213.0,"Action, Adventure, Crime","A CIA special forces team are betrayed and left for dead by their superiors, galvanizing them to mount an offensive on the CIA.",44.0,Sylvain White,The Losers,2010,97,USA, 25000000,23591432,29379723,5788291,4379723,1
45362,474.0,"Animation, Adventure, Comedy","The toys are mistakenly delivered to a day-care center instead of the attic right before Andy leaves for college, and it's up to Woody to convince the other toys that they weren't abandoned and to return home.",92.0,Lee Unkrich,Toy Story 3,2010,103,USA, 200000000,415004880,1066969703,651964823,866969703,1
50682,18.0,Drama,"Gabriel is a man who on the surface has it all-successful professional life as an architect, a beautiful wife, Annie, and a devoted young daughter, Elizabeth. But slowly it dawns on him ...",35.0,Brooks Branch,Multiple Sarcasms,2010,97,USA, 2500000,29731,29731,0,-2470269,0
56890,153.0,Drama,"When an alcoholic relapses, causing him to lose his wife and his job, he holds a yard sale on his front lawn in an attempt to start over. A new neighbor might be the key to his return to form.",65.0,Dan Rush,Everything Must Go,2010,97,USA, 5000000,2711643,2820490,108847,-2179510,0
50636,61.0,Comedy,Kevin Carson is a young man living in the projects who has to survive a three-day weekend after his opportunistic neighbors find out he's holding a winning lottery ticket worth $370 million.,50.0,Erik White,Lottery Ticket,2010,99,USA, 17000000,24719879,24719879,0,7719879,1
56881,108.0,"Crime, Drama, Thriller",A teenage girl is targeted by an online sexual predator.,60.0,David Schwimmer,Trust,2010,106,USA, 4000000,120016,595802,475786,-3404198,0
47863,78.0,"Comedy, Drama, Family","An adventurous young girl uses her imagination to escape her reality, that is quickly spinning out of reach.",56.0,Elizabeth Allen Rosenbaum,Ramona and Beezus,2010,103,USA, 15000000,26167002,27293743,1126741,12293743,1
52467,122.0,"Action, Crime, Thriller",A group of bank robbers find their multi-million dollar plan interrupted by a hard-boiled detective.,45.0,John Luessenhop,Takers,2010,107,USA, 32000000,57744720,80205382,22460662,48205382,1
50274,290.0,"Action, Adventure, Family","Follows the adventures of Aang, a young successor to a long line of Avatars, who must master all four elements and stop the Fire Nation from enslaving the Water Tribes and the Earth Kingdom.",20.0,M. Night Shyamalan,The Last Airbender,2010,103,USA, 150000000,131772187,319713881,187941694,169713881,1
52392,514.0,"Mystery, Thriller","In 1954, a U.S. Marshal investigates the disappearance of a murderer who escaped from a hospital for the criminally insane.",63.0,Martin Scorsese,Shutter Island,2010,138,USA, 80000000,128012934,294804195,166791261,214804195,1
56604,29.0,"Biography, Drama, Music",A young girl who has been abandoned by her former-groupie mother informs a fading rock star that she is his daughter.,52.0,David M. Rosenthal,Janie Jones,2010,114,USA, 3000000,6840,6840,0,-2993160,0
48131,223.0,"Comedy, Drama, Romance",A young woman suffering from Parkinson's befriends a drug rep working for Pfizer in 1990s Pittsburgh.,55.0,Edward Zwick,Love & Other Drugs,2010,112,USA, 30000000,32367005,102820008,70453003,72820008,1
51041,265.0,"Biography, Drama, Music",A coming-of-age biographical film about the 1970s teenage all-girl rock band,65.0,Floria Sigismondi,The Runaways,2010,106,USA, 10000000,3573673,4681651,1107978,-5318349,0
56647,246.0,"Action, Comedy, Drama","After his wife falls under the influence of a drug dealer, an everyday guy transforms himself into Crimson Bolt, a superhero with the best intentions, but lacking in heroic skills.",50.0,James Gunn,Super,2010,96,USA, 2500000,327716,422618,94902,-2077382,0
50257,245.0,Drama,Life for a happy couple is turned upside down after their young son dies in an accident.,76.0,John Cameron Mitchell,Rabbit Hole,2010,91,USA, 5000000,2229058,5132850,2903792,132850,1
56538,33.0,"Drama, Romance","The strained relationship of an engaged Brooklyn couple, Theo (Chris Messina) and Nat (Rashida Jones). Theo is bored with his job as a wedding photographer-the generic backgrounds, the ...",47.0,Dana Adam Shapiro,Monogamy,2010,96,USA, 5000000,21527,21527,0,-4978473,0
52365,25.0,"Drama, Sci-Fi",Berkeley record store clerk Nick Brady (Jonathan Scarfe) begins to experience strange visions from an entity he calls VALIS that cause him to uproot his family and move to Los Angeles where...,35.0,John Alan Simon,Radio Free Albemuth,2010,111,USA, 3600000,9365,9365,0,-3590635,0
52564,78.0,"Biography, Crime, Drama","In Brooklyn, a youth from an Orthodox Jewish community is lured into becoming an Ecstasy dealer by his pal who has ties to an Israeli drug cartel.",51.0,Kevin Asch,Holy Rollers,2010,89,USA, 1000000,303064,608027,304963,-391973,0
51001,466.0,"Adventure, Family, Fantasy","Nineteen-year-old Alice returns to the magical world from her childhood adventure, where she reunites with her old friends and learns of her true destiny: to end the Red Queen's reign of terror.",53.0,Tim Burton,Alice in Wonderland,2010,108,USA, 200000000,334191110,1025467110,691276000,825467110,1
52345,215.0,"Comedy, Drama, Romance",An upstart television producer accepts the challenge of reviving a struggling morning show program with warring co-hosts.,57.0,Roger Michell,Morning Glory,2010,107,USA, 40000000,31011732,60040976,29029244,20040976,1
51182,164.0,"Biography, Drama, Family","Penny Chenery Tweedy and colleagues guide her long-shot but precocious stallion to set, in 1973, the unbeaten record for winning the Triple Crown.",61.0,Randall Wallace,Secretariat,2010,123,USA, 35000000,59713955,60251371,537416,25251371,1
50885,231.0,"Animation, Action, Comedy","The supervillain Megamind finally defeats his nemesis, the superhero Metro Man. But without a hero, he loses all purpose and must find new meaning to his life.",63.0,Tom McGrath,Megamind,2010,95,USA, 130000000,148415853,321885765,173469912,191885765,1
56727,202.0,"Drama, Western",Settlers traveling through the Oregon desert in 1845 find themselves stranded in harsh conditions.,85.0,Kelly Reichardt,Meek's Cutoff,2010,104,USA, 2000000,977772,1205257,227485,-794743,0
52343,190.0,"Drama, Music, Musical",A small-town girl ventures to Los Angeles and finds her place in a neo-burlesque club run by a former dancer.,47.0,Steve Antin,Burlesque,2010,119,USA, 55000000,39440655,89519773,50079118,34519773,1
51168,298.0,Drama,"Now out of prison but still disgraced by his peers, Gordon Gekko works his future son-in-law, an idealistic stock broker, when he sees an opportunity to take down a Wall Street enemy and rebuild his empire.",59.0,Oliver Stone,Wall Street: Money Never Sleeps,2010,133,USA, 70000000,52474616,134748021,82273405,64748021,1
50989,294.0,"Action, Adventure, Comedy",A young woman gets mixed up with a disgraced spy who is trying to clear his name.,46.0,James Mangold,Knight and Day,2010,109,USA, 117000000,76423035,261989769,185566734,144989769,1
55207,144.0,Comedy,"A college student on suspension is coaxed into babysitting the kids next door, though he is fully unprepared for the wild night ahead of him.",39.0,David Gordon Green,The Sitter,2011,81,USA, 25000000,30441326,34942188,4500862,9942188,1
57214,203.0,"Comedy, Romance","On a weekend trip to Hawaii, a plastic surgeon convinces his loyal assistant to pose as his soon-to-be-divorced wife in order to cover up a careless lie he told to his much-younger girlfriend.",33.0,Dennis Dugan,Just Go with It,2011,117,USA, 80000000,103028109,214945591,111917482,134945591,1
57612,180.0,"Action, Mystery, Thriller",A thriller centered on a young man who sets out to uncover the truth about his life after finding his baby photo on a missing persons website.,25.0,John Singleton,Abduction,2011,106,USA, 35000000,28087155,82087155,54000000,47087155,1
57565,295.0,"Drama, Horror, Mystery","During the final days at the Yankee Pedlar Inn, two employees determined to reveal the hotel's haunted past begin to experience disturbing events as old guests check in for a stay.",64.0,Ti West,The Innkeepers,2011,101,USA, 750000,78396,1178831,1100435,428831,1
58922,111.0,"Drama, Romance, War","During the Bosnian War, Danijel, a soldier fighting for the Serbs, re-encounters Ajla, a Bosnian who's now a captive in his camp he oversees. Their once promising connection has become ambiguous as their motives have changed.",56.0,Angelina Jolie,In the Land of Blood and Honey,2011,127,USA, 13000000,303877,1203699,899822,-11796301,0
57582,110.0,"Biography, Drama, Family",Teenage surfer Bethany Hamilton overcomes the odds and her own fears of returning to the water after losing her left arm in a shark attack.,53.0,Sean McNamara,Soul Surfer,2011,112,USA, 18000000,43853424,47088990,3235566,29088990,1
55381,420.0,"Romance, Sci-Fi, Thriller",The affair between a politician and a contemporary dancer is affected by mysterious forces keeping the lovers apart.,60.0,George Nolfi,The Adjustment Bureau,2011,106,USA, 50200000,62495645,127869379,65373734,77669379,1
57495,180.0,"Comedy, Drama","Dispatched from his basement room on an errand for his widowed mother, slacker Jeff might discover his destiny (finally) when he spends the day with his unhappily married brother as he tracks his possibly adulterous wife.",60.0,"Jay Duplass, Mark Duplass","Jeff, Who Lives at Home",2011,83,USA, 10000000,4269426,4417580,148154,-5582420,0
57644,421.0,"Action, Adventure, Drama","After their plane crashes in Alaska, six oil workers are led by a skilled huntsman to survival, but a pack of merciless wolves haunts their every step.",64.0,Joe Carnahan,The Grey,2011,117,USA, 25000000,51580236,77278331,25698095,52278331,1
57255,20.0,"Comedy, Crime, Romance","A young pickpocket in the New York subways, living a fast, free, lifestyle is confronted by a woman with whom he had a one night affair.",35.0,Michael Corrente,Loosies,2011,89,USA, 3900000,3519,36145,32626,-3863855,0
57380,184.0,"Comedy, Drama",A man discovers that his best friend's wife is having an affair.,46.0,Ron Howard,The Dilemma,2011,111,USA, 70000000,48475290,69721966,21246676,-278034,0
57290,315.0,"Comedy, Drama, Romance","A middle-aged husband's life changes dramatically when his wife asks him for a divorce. He seeks to rediscover his manhood with the help of a newfound friend, Jacob, learning to pick up girls at bars.",68.0,"Glenn Ficarra, John Requa","Crazy, Stupid, Love.",2011,118,USA, 50000000,84351197,145051197,60700000,95051197,1
54910,179.0,"Comedy, Romance",A drunken playboy stands to lose a wealthy inheritance when he falls for a woman his family doesn't like.,36.0,Jason Winer,Arthur,2011,110,USA, 40000000,33035397,45735397,12700000,5735397,1
57823,404.0,"Biography, Crime, Drama","J. Edgar Hoover, powerful head of the F.B.I. for nearly fifty years, looks back on his professional and personal life.",59.0,Clint Eastwood,J. Edgar,2011,137,USA, 35000000,37306030,84920539,47614509,49920539,1
57796,55.0,"Drama, Music","Tale of a father who struggles to bond with his estranged son Gabriel, after Gabriel suffers from a brain tumor that prevents him from forming new memories. With Gabriel unable to shed the ...",60.0,Jim Kohlberg,The Music Never Stopped,2011,105,USA, 4000000,258223,342202,83979,-3657798,0
57808,304.0,"Drama, Thriller","Follows the key people at an investment bank, over a 24-hour period, during the early stages of the 2008 financial crisis.",76.0,J.C. Chandor,Margin Call,2011,107,USA, 3500000,5354039,19504039,14150000,16004039,1
54795,328.0,"Action, Adventure, Drama","The Quileutes close in on expecting parents Edward and Bella, whose unborn child poses a threat to the Wolf Pack and the towns people of Forks.",45.0,Bill Condon,The Twilight Saga: Breaking Dawn - Part 1,2011,117,USA, 110000000,281287133,712205856,430918723,602205856,1
57420,51.0,"Drama, Thriller",A young doctor goes to unconscionable extremes in order to remain in the service of a female patient with a kidney disorder.,52.0,Lance Daly,The Good Doctor,2011,91,USA, 6000000,5206,51017,45811,-5948983,0
57442,222.0,"Comedy, Drama, Romance","After losing his job, a middle-aged man reinvents himself by going back to college.",41.0,Tom Hanks,Larry Crowne,2011,98,USA, 30000000,35608245,72008245,36400000,42008245,1
59014,167.0,"Comedy, Drama, Romance","Two best friends decide to have a child together while keeping their relationship platonic, so they can avoid the toll kids can take on romantic relationships.",55.0,Jennifer Westfeldt,Friends with Kids,2011,107,USA, 10000000,7251073,13041254,5790181,3041254,1
59006,40.0,Drama,A college freshman's world is rocked when she learns she is the adopted survivor of a failed abortion.,32.0,"Andrew Erwin, Jon Erwin",October Baby,2011,107,USA, 1000000,5357328,5396618,39290,4396618,1
57696,16.0,"Biography, Drama, Music","At the end of 1952, with the best years of Hank Williams's career behind him, he hires a local kid to drive him through the Appalachian countryside for a pair of New Years shows in West Virginia and Ohio.",45.0,Harry Thomason,The Last Ride,2011,102,USA, 9000000,27000,27000,0,-8973000,0
57676,84.0,"Comedy, Drama, Family",A group of teenagers get ready for their high school prom.,50.0,Joe Nussbaum,Prom,2011,104,USA, 8000000,10130219,10702246,572027,2702246,1
57816,89.0,"Animation, Adventure, Comedy","Playing around while aboard a cruise ship, the Chipmunks and Chipettes accidentally go overboard and end up marooned in a tropical paradise. They discover their new turf is not as deserted as it seems.",24.0,Mike Mitchell,Alvin and the Chipmunks: Chipwrecked,2011,87,USA, 75000000,133110742,342695435,209584693,267695435,1
59075,382.0,"Crime, Drama, Thriller","When a debt puts a young man's life in danger, he turns to putting a hit out on his evil mother in order to collect the insurance.",62.0,William Friedkin,Killer Joe,2011,102,USA, 11000000,1987762,3665069,1677307,-7334931,0
58845,100.0,"Drama, Horror","Newlywed Molly moves into her deceased father's house in the countryside, where painful memories soon begin to haunt her.",50.0,Eduardo S√°nchez,Lovely Molly,2011,99,USA, 1000000,18464,638274,619810,-361726,0
57464,140.0,"Action, Biography, Crime",,43.0,Marc Forster,Machine Gun Preacher,2011,129,USA, 30000000,538690,3338690,2800000,-26661310,0
57750,14.0,"Comedy, Romance","When a male neurotic best-selling author on love finds his fianc√É¬© with another man, he's sent into a tailspin reflecting on his numerous romantic failures only to find hope again with a quirky antiquarian bookseller",33.0,Rocky Powell,Language of a Broken Heart,2011,100,USA, 350000,40645,40645,0,-309355,0
56530,304.0,"Action, Fantasy, Thriller",A vengeful father escapes from hell and chases after the men who killed his daughter and kidnapped his granddaughter.,44.0,Patrick Lussier,Drive Angry,2011,104,USA, 50000000,10721033,28931401,18210368,-21068599,0
57195,68.0,Drama,A chronicle of one woman's lifelong struggle with her faith.,74.0,Vera Farmiga,Higher Ground,2011,109,USA, 2000000,841733,1043262,201529,-956738,0
59289,161.0,"Comedy, Romance","A comedy centered on the life of Kate Reddy, a finance executive who is the breadwinner for her husband and two kids.",38.0,Douglas McGrath,I Don't Know How She Does It,2011,89,USA, 24000000,9662284,30551495,20889211,6551495,1
58650,114.0,"Comedy, Drama",Romance blooms between two tricenarians in arrested development: an avid toy collector who is the dark horse of his family and a depressed woman on the rebound.,66.0,Todd Solondz,Dark Horse,2011,86,USA, 2000000,166228,337150,170922,-1662850,0
58608,88.0,Horror,"In the back country of Louisiana, a group of friends unearth a terrible secret that unleashes a monster from the depths of the swamp.",31.0,Fred Andrews,Creature,2011,93,USA, 3000000,508714,533235,24521,-2466765,0
58501,340.0,"Drama, Horror, Thriller","Plagued by a series of apocalyptic visions, a young husband and father questions whether to shelter his family from a coming storm, or from himself.",85.0,Jeff Nichols,Take Shelter,2011,121,USA, 5000000,1730296,3099314,1369018,-1900686,0
59466,196.0,"Drama, Romance","A British college student falls for an American student, only to be separated from him when she's banned from the U.S. after overstaying her visa.",68.0,Drake Doremus,Like Crazy,2011,86,USA, 250000,3395391,3852409,457018,3602409,1
56314,214.0,Comedy,"Tim Lippe has no idea what he's in for when he's sent to Cedar Rapids, Iowa to represent his company at an annual insurance convention, where he soon finds himself under the ""guidance"" of three convention veterans.",70.0,Miguel Arteta,Cedar Rapids,2011,87,USA, 10000000,6861102,7728936,867834,-2271064,0
58193,557.0,"Mystery, Sci-Fi, Thriller","During the summer of 1979, a group of friends witness a train crash and investigate subsequent unexplained events in their small town.",72.0,J.J. Abrams,Super 8,2011,112,USA, 50000000,127004179,260095986,133091807,210095986,1
56319,384.0,"Comedy, Romance","Competition between the maid of honor and a bridesmaid, over who is the bride's best friend, threatens to upend the life of an out-of-work pastry chef.",75.0,Paul Feig,Bridesmaids,2011,125,USA, 32500000,169106725,288383523,119276798,255883523,1
56720,74.0,"Action, Adventure, Comedy","A retired spy is called back into action, and to bond with her new step-children, she invites them along for the adventure to stop the evil Timekeeper from taking over the world.",37.0,Robert Rodriguez,Spy Kids 4: All the Time in the World,2011,89,USA, 27000000,38538188,85564310,47026122,58564310,1
56177,86.0,"Action, Comedy, Crime",Malcolm Turner and his stepson Trent go undercover at an all-girls school to flush out a killer.,22.0,John Whitesell,"Big Mommas: Like Father, Like Son",2011,107,USA, 32000000,37915414,82686066,44770652,50686066,1
57997,76.0,"Action, Comedy, Crime","Two teenage assassins accept what they think will be a quick-and-easy job, until an unexpected target throws them off their plan.",43.0,Geoffrey Fletcher,Violet & Daisy,2011,88,USA, 8000000,17186,108139,90953,-7891861,0
58024,370.0,"Action, Sci-Fi, Thriller","In a future where people stop aging at 25, but are engineered to live only one more year, having the means to buy your way out of the situation is a shot at immortal youth. Here, Will Salas finds himself accused of murder and on the run with a hostage - a connection that becomes an important part of the way against the system.",53.0,Andrew Niccol,In Time,2011,109,USA, 40000000,37520095,173930596,136410501,133930596,1
56413,217.0,"Comedy, Fantasy","Dave is a married man with three kids and a loving wife, and Mitch is a single man who is at the prime of his sexual life. One fateful night while Mitch and Dave are peeing in a fountain, lightning strikes and they switch bodies.",39.0,David Dobkin,The Change-Up,2011,112,USA, 52000000,37081475,75450437,38368962,23450437,1
56493,160.0,"Drama, Romance",The story of a terminally ill teenage girl who falls for a boy who likes to attend funerals and their encounters with the ghost of a Japanese kamikaze pilot from WWII.,47.0,Gus Van Sant,Restless,2011,91,USA, 8000000,163265,2518012,2354747,-5481988,0
58187,101.0,"Comedy, Family","Back in middle school after summer vacation, Greg Heffley and his older brother Rodrick must deal with their parents' misguided attempts to have them bond.",51.0,David Bowers,Diary of a Wimpy Kid: Rodrick Rules,2011,99,USA, 21000000,52698535,72417394,19718859,51417394,1
57603,202.0,"Comedy, Romance",The lives of several couples and singles in New York City intertwine over the course of New Year's Eve.,22.0,Garry Marshall,New Year's Eve,2011,113,USA, 56000000,54544638,142044638,87500000,86044638,1
59617,253.0,"Horror, Mystery, Thriller","In 1988, young sisters Katie and Kristi befriend an invisible entity who resides in their home.",59.0,"Henry Joost, Ariel Schulman",Paranormal Activity 3,2011,83,USA, 5000000,104028807,207039844,103011037,202039844,1
58026,180.0,"Comedy, Drama",A comedy centered on an idealist who barges into the lives of his three sisters.,60.0,Jesse Peretz,Our Idiot Brother,2011,90,USA, 5000000,24816118,25804448,988330,20804448,1
58064,49.0,"Comedy, Drama",Two very different families converge on Martha's Vineyard one weekend for a wedding.,56.0,Salim Akil,Jumping the Broom,2011,112,USA, 6600000,37295394,37710610,415216,31110610,1
56507,343.0,"Comedy, Crime",Three friends conspire to murder their awful bosses when they realize they are standing in the way of their happiness.,57.0,Seth Gordon,Horrible Bosses,2011,98,USA, 35000000,117538559,209838559,92300000,174838559,1
60564,23.0,"Drama, Romance","When, Mia, a dance teacher, lands in the hospital after an accident, Armando, a would-be dancer who admires her from afar, persuades her to train for an upcoming wheelchair ballroom dancing contest.",46.0,Susan Seidelman,Musical Chairs,2011,102,USA, 2500000,31478,31478,0,-2468522,0
58814,236.0,"Biography, Comedy, Crime","In small-town Texas, an affable mortician strikes up a friendship with a wealthy widow, though when she starts to become controlling, he goes to great lengths to separate himself from her grasp.",75.0,Richard Linklater,Bernie,2011,99,USA, 5000000,9206470,10173061,966591,5173061,1
57989,236.0,"Horror, Thriller",A weekend at a lake house in the Louisiana Gulf turns into a nightmare for seven vacationers as they are subjected to shark attacks.,22.0,David R. Ellis,Shark Night 3D,2011,90,USA, 25000000,18877153,40136479,21259326,15136479,1
56036,166.0,"Animation, Adventure, Comedy","While searching for honey, Pooh and his friends embark on an adventure to find Eeyore's missing tail and rescue Christopher Robin from an unknown monster called, The Backson.",74.0,"Stephen J. Anderson, Don Hall",Winnie the Pooh,2011,63,USA, 30000000,26692846,49871429,23178583,19871429,1
59770,22.0,"Biography, Drama",The last day in the life of the actor,41.0,James Franco,Sal,2011,103,USA, 7000000,6883,6883,0,-6993117,0
57116,92.0,"Drama, Romance",A gardener in East L.A. struggles to keep his son away from gangs and immigration agents while trying to give his son the opportunities he never had.,64.0,Chris Weitz,A Better Life,2011,98,USA, 10000000,1759252,1863506,104254,-8136494,0
55424,261.0,"Comedy, Drama, Family","Set in Southern California, a father moves his young family to the countryside to renovate and re-open a struggling zoo.",58.0,Cameron Crowe,We Bought a Zoo,2011,124,USA, 50000000,75624550,120081841,44457291,70081841,1
57886,224.0,"Action, Comedy, Crime","Two fledgling criminals kidnap a pizza delivery guy, strap a bomb to his chest, and inform him that he has mere hours to rob a bank or else...",49.0,Ruben Fleischer,30 Minutes or Less,2011,83,USA, 28000000,37053924,40547440,3493516,12547440,1
55482,186.0,"Comedy, Family, Fantasy","The life of a businessman begins to change after he inherits six penguins, and as he transforms his apartment into a winter wonderland, his professional side starts to unravel.",53.0,Mark Waters,Mr. Popper's Penguins,2011,94,USA, 55000000,68224452,187361754,119137302,132361754,1
55509,433.0,"Action, Adventure, Sci-Fi","The Autobots learn of a Cybertronian spacecraft hidden on the moon, and race against the Decepticons to reach it and to learn its secrets.",42.0,Michael Bay,Transformers: Dark of the Moon,2011,154,USA, 195000000,352390543,1123794079,771403536,928794079,1
57912,337.0,"Comedy, Drama","Soon after her divorce, a fiction writer returns to her home in small-town Minnesota, looking to rekindle a romance with her ex-boyfriend, who is now happily married and has a newborn daughter.",71.0,Jason Reitman,Young Adult,2011,94,USA, 12000000,16311571,22939027,6627456,10939027,1
57085,250.0,"Drama, Romance, Sci-Fi","On the night of the discovery of a duplicate Earth in the Solar system, an ambitious young student and an accomplished composer cross paths in a tragic accident.",66.0,Mike Cahill,Another Earth,2011,92,USA, 100000,1321194,1776935,455741,1676935,1
58066,208.0,"Crime, Drama","Set in 1999 Los Angeles, veteran police officer Dave Brown, the last of the renegade cops, works to take care of his family, and struggles for his own survival.",70.0,Oren Moverman,Rampart,2011,108,USA, 12000000,972512,1567905,595393,-10432095,0
57069,61.0,"Comedy, Family",Third grader Judy Moody sets out to have the most thrilling summer of her life.,37.0,John Schultz,Judy Moody and the Not Bummer Summer,2011,91,USA, 20000000,15013650,15691640,677990,-4308360,0
57930,19.0,"Drama, Family, Fantasy",A man looks back 15 years to the injury that ended his career as a promising high-school football player.,56.0,Don Handfield,Touchback,2011,118,USA, 5000000,204232,204232,0,-4795768,0
55622,244.0,"Comedy, Romance","A guy and girl try to keep their relationship strictly physical, but it's not long before they learn that they want something more.",50.0,Ivan Reitman,No Strings Attached,2011,108,USA, 25000000,70662220,149228077,78565857,124228077,1
55626,49.0,Comedy,"A kid from the Midwest moves out to Hollywood in order to follow in his parents footsteps, and become a porn star.",9.0,Tom Brady,Bucky Larson: Born to Be a Star,2011,97,USA, 10000000,2529395,2530394,999,-7469606,0
58742,48.0,"Drama, Sport","After a disastrous debut on the pro circuit, a young golfer finds himself unexpectedly stranded in Utopia, Texas and welcomed by an eccentric rancher.",37.0,Matthew Dean Russell,Seven Days in Utopia,2011,100,USA, 7500000,4373074,4373074,0,-3126926,0
57961,35.0,"Drama, Fantasy","When a tragedy strikes close to home, four police officers struggle with their faith and their roles as husbands and fathers; together they make a decision that will change all of their lives.",42.0,Alex Kendrick,Courageous,2011,129,USA, 2000000,34522221,35185884,663663,33185884,1
59288,173.0,"Comedy, Drama","Iris invites her friend Jack to stay at her family's island getaway after the death of his brother. At their remote cabin, Jack's drunken encounter with Hannah, Iris' sister, kicks off a revealing stretch of days.",72.0,Lynn Shelton,Your Sister's Sister,2011,90,USA, 125000,1636190,3242802,1606612,3117802,1
56958,60.0,"Action, Crime, Drama","A young cop is assigned to a precinct in the working class neighborhood where he grew up, and an old secret threatens to destroy his life and his family.",36.0,Dito Montiel,The Son of No One,2011,90,USA, 15000000,30680,1091132,1060452,-13908868,0
55680,83.0,"Biography, Crime, Drama","The true story of Danny Greene, a tough Irish thug working for mobsters in Cleveland during the 1970's.",50.0,Jonathan Hensleigh,Kill the Irishman,2011,106,USA, 12000000,1188194,1188194,0,-10811806,0
57983,239.0,"Comedy, Romance","A young man and woman decide to take their friendship to the next level without becoming a couple, but soon discover that adding sex only leads to complications.",63.0,Will Gluck,Friends with Benefits,2011,109,USA, 35000000,55802754,149542245,93739491,114542245,1
55897,18.0,Comedy,A happy newlywed marriage counselor's views on wedded bliss get thrown for a loop when she finds out her parents are getting divorced.,13.0,Dermot Mulroney,"Love, Wedding, Marriage",2011,90,USA, 12000000,1926,515823,513897,-11484177,0
55916,364.0,"Comedy, Horror","When a nice new neighbor moves in next door, Charley discovers that he is an ancient vampire who preys on the community. Can he save his neighborhood from the creature with the help of the famous ""vampire killer"", Peter Vincent?",64.0,Craig Gillespie,Fright Night,2011,106,USA, 30000000,18302607,41002607,22700000,11002607,1
59718,31.0,"Comedy, Drama","The crazy and comical Mabel Simmons, otherwise known as Madea, tries to wrangle her fighting family together for a family dinner regarding the health of her niece Shirley.",45.0,Tyler Perry,Madea's Big Happy Family,2011,106,USA, 25000000,53345287,54161287,816000,29161287,1
58183,50.0,"Comedy, Drama, Music",An uptight New York City lawyer takes her two teenagers to her hippie mother's farmhouse upstate for a family vacation.,45.0,Bruce Beresford,"Peace, Love & Misunderstanding",2011,96,USA, 10000000,590700,1105020,514320,-8894980,0
49023,199.0,"Action, Horror, Thriller",A priest disobeys church law to track down the vampires who kidnapped his niece.,41.0,Scott Stewart,Priest,2011,87,USA, 60000000,29137000,78309505,49172505,18309505,1
54577,8.0,"Drama, Musical","A student must decide between follwing her dream to become a dancer, or to follow the wishes of her family.",44.0,Carmen Marr√≥n,Go for It!,2011,105,USA, 200000,180237,180237,0,-19763,0
51673,276.0,"Drama, Romance","Set in the 1930s, a former veterinary student takes a job in a travelling circus and falls in love with the ringmaster's wife.",52.0,Francis Lawrence,Water for Elephants,2011,120,USA, 38000000,58709717,117094902,58385185,79094902,1
51682,159.0,"Comedy, Drama, Music","City teenager Ren MacCormack moves to a small town where rock music and dancing have been banned, and his rebellious spirit shakes up the populace.",58.0,Craig Brewer,Footloose,2011,113,USA, 24000000,51802742,63543328,11740586,39543328,1
52316,432.0,"Drama, Thriller",An idealistic staffer for a new presidential candidate gets a crash course on dirty politics during his stint on the campaign trail.,67.0,George Clooney,The Ides of March,2011,101,USA, 12500000,40962534,75993061,35030527,63493061,1
52449,452.0,"Action, Adventure, Sci-Fi","Reckless test pilot Hal Jordan is granted an alien ring that bestows him with otherworldly powers that inducts him into an intergalactic police force, the Green Lantern Corps.",39.0,Martin Campbell,Green Lantern,2011,114,USA, 200000000,116601172,219851172,103250000,19851172,1
52665,143.0,"Drama, Fantasy, Romance","A modern-day take on the ""Beauty and the Beast"" tale where a New York teen is transformed into a hideous monster in order to find true love.",40.0,Daniel Barnz,Beastly,2011,86,USA, 17000000,27865571,43165571,15300000,26165571,1
53089,277.0,"Crime, Drama, Thriller",A lawyer defending a wealthy man begins to believe his client is guilty of more than just one crime.,63.0,Brad Furman,The Lincoln Lawyer,2011,118,USA, 40000000,58009200,75009200,17000000,35009200,1
53129,373.0,"Animation, Adventure, Comedy","Rango is an ordinary chameleon who accidentally winds up in the town of Dirt, a lawless outpost in the Wild West in desperate need of a new sheriff.",75.0,Gore Verbinski,Rango,2011,107,USA, 135000000,123477607,245724603,122246996,110724603,1
51256,555.0,"Comedy, Drama",A land baron tries to reconnect with his two daughters after his wife is seriously injured in a boating accident.,84.0,Alexander Payne,The Descendants,2011,115,USA, 20000000,82584160,177243185,94659025,157243185,1
53252,402.0,"Adventure, Comedy, Family",A Muppet fanatic with some help from his 2 human compatriots must regroup the Muppet gang to stop an avaricious oil mogul from taking down one of their precious life-longing treasures.,75.0,James Bobin,The Muppets,2011,103,USA, 45000000,88631237,165184237,76553000,120184237,1
53383,127.0,"Action, Crime, Drama","After his wife is assaulted, a husband enlists the services of a vigilante group to help him settle the score. Then he discovers they want a 'favor' from him in return.",38.0,Roger Donaldson,Seeking Justice,2011,105,USA, 17000000,411746,12355798,11944052,-4644202,0
53392,316.0,"Animation, Adventure, Comedy",Star race car Lightning McQueen and his pal Mater head overseas to compete in the World Grand Prix race. But the road to the championship becomes rocky as Mater gets caught up in an intriguing adventure of his own: international espionage.,57.0,"John Lasseter, Bradford Lewis",Cars 2,2011,106,USA, 200000000,191452396,559852396,368400000,359852396,1
53411,358.0,"Action, Adventure, Fantasy",A squad of U.S. Marines becomes the last line of defense against a global invasion.,37.0,Jonathan Liebesman,Battle Los Angeles,2011,116,USA, 70000000,83552429,211819354,128266925,141819354,1
53424,385.0,"Sci-Fi, Thriller","With the help of a mysterious pill that enables the user to access one hundred percent of his brain abilities, a struggling writer becomes a financial wizard, but it also puts him in a new world with lots of dangers.",59.0,Neil Burger,Limitless,2011,105,USA, 27000000,79249455,161849455,82600000,134849455,1
53472,179.0,"Comedy, Family, Fantasy","A group of zoo animals decide to break their code of silence in order to help their lovable zookeeper find love, without opting to leave his current job for something more illustrious.",30.0,Frank Coraci,Zookeeper,2011,102,USA, 80000000,80360843,169852759,89491916,89852759,1
53632,98.0,Drama,"A Brooklyn teenager juggles conflicting identities and risks friendship, heartbreak, and family in a desperate search for sexual expression.",79.0,Dee Rees,Pariah,2011,86,USA, 450000,769552,769552,0,319552,1
53321,433.0,"Biography, Drama, Sport",Oakland A's general manager Billy Beane's successful attempt to assemble a baseball team on a lean budget by employing computer-generated analysis to acquire new players.,87.0,Bennett Miller,Moneyball,2011,133,USA, 50000000,75605492,110206216,34600724,60206216,1
53755,214.0,"Comedy, Fantasy","When Prince Fabious's bride is kidnapped, he goes on a quest to rescue her... accompanied by his lazy useless brother Thadeous.",31.0,David Gordon Green,Your Highness,2011,102,USA, 49900000,21596445,24856478,3260033,-25043522,0
45845,251.0,"Animation, Action, Adventure","An outlaw cat, his childhood egg-friend and a seductive thief kitty set out in search for the eggs of the fabled Golden Goose to clear his name, restore his lost honor and regain the trust of his mother and town.",65.0,Chris Miller,Puss in Boots,2011,90,USA, 130000000,149260504,554987477,405726973,424987477,1
46711,120.0,Drama,"A young woman witnesses a bus accident, and is caught up in the aftermath, where the question of whether or not it was intentional affects many people's lives.",61.0,Kenneth Lonergan,Margaret,2011,150,USA, 14000000,46495,564864,518369,-13435136,0
48924,328.0,"Action, Adventure, Fantasy",A vengeful barbarian warrior sets off to get his revenge on the evil warlord who attacked his village and murdered his father when he was a boy.,36.0,Marcus Nispel,Conan the Barbarian,2011,113,USA, 90000000,21295021,48795021,27500000,-41204979,0
48810,161.0,Comedy,"Family guy Jack Sadelstein prepares for the annual event he dreads: the Thanksgiving visit of his fraternal twin sister, the needy and passive-aggressive Jill, who then refuses to leave.",23.0,Dennis Dugan,Jack and Jill,2011,91,USA, 79000000,74158157,149673788,75515631,70673788,1
48619,549.0,"Action, Adventure, Fantasy","The powerful but arrogant god Thor is cast out of Asgard to live amongst humans in Midgard (Earth), where he soon becomes one of their finest defenders.",57.0,Kenneth Branagh,Thor,2011,115,USA, 150000000,181030624,449326618,268295994,299326618,1
49667,282.0,"Action, Crime, Horror","Set in Middle America, a group of teens receive an online invitation for sex, though they soon encounter fundamentalists with a much more sinister agenda.",50.0,Kevin Smith,Red State,2011,88,USA, 4000000,1104682,1874460,769778,-2125540,0
48346,706.0,"Crime, Drama",A mysterious Hollywood stuntman and mechanic moonlights as a getaway driver and finds himself in trouble when he helps out his neighbor in this action drama.,78.0,Nicolas Winding Refn,Drive,2011,100,USA, 15000000,35061555,76176032,41114477,61176032,1
48247,147.0,"Comedy, Romance",A woman looks back at the past nineteen men she's had relationships with in her life and wonders if one of them might be her one true love.,35.0,Mark Mylod,What's Your Number?,2011,106,USA, 20000000,14011084,30426096,16415012,10426096,1
47769,131.0,"Comedy, Drama, Romance","Friendships are tested and secrets come to the surface when terminally single Rachel falls for Dex, her best friend Darcy's fianc√©.",36.0,Luke Greenfield,Something Borrowed,2011,112,USA, 35000000,39046489,60183821,21137332,25183821,1
46325,545.0,"Action, Adventure, Sci-Fi","Steve Rogers, a rejected military soldier transforms into Captain America after taking a dose of a ""Super-Soldier serum"". But being Captain America comes at a price as he attempts to take down a war monger and a terrorist organization.",66.0,Joe Johnston,Captain America: The First Avenger,2011,124,USA, 140000000,176654505,370569774,193915269,230569774,1
47347,236.0,"Comedy, Romance","Rick and Fred, two husbands who are having difficulty in their marriages, are given a Hall Pass by their wives: for one week, they can do whatever they want.",45.0,"Bobby Farrelly, Peter Farrelly",Hall Pass,2011,105,USA, 36000000,45060734,83160734,38100000,47160734,1
47316,285.0,"Action, Adventure, Fantasy","Fourteenth century knights transport a suspected witch to a monastery, where monks deduce her powers could be the source of the Black Plague.",28.0,Dominic Sena,Season of the Witch,2011,95,USA, 40000000,24827228,91627228,66800000,51627228,1
47221,605.0,"Drama, Fantasy","The story of a family in Waco, Texas in 1956. The eldest son witnesses the loss of innocence and struggles with his parents' conflicting teachings.",85.0,Terrence Malick,The Tree of Life,2011,139,USA, 32000000,13303319,54303319,41000000,22303319,1
47159,288.0,"Adventure, Drama, Mystery","A nine-year-old amateur inventor, Francophile, and pacifist searches New York City for the lock that matches a mysterious key left behind by his father, who died in the World Trade Center on September 11, 2001.",46.0,Stephen Daldry,Extremely Loud & Incredibly Close,2011,129,USA, 40000000,31847881,55247881,23400000,15247881,1
46947,260.0,"Action, Thriller",An elite hitman teaches his trade to an apprentice who has a connection to one of his previous victims.,49.0,Simon West,The Mechanic,2011,93,USA, 40000000,29121498,76129642,47008144,36129642,1
50747,449.0,"Action, Comedy, Crime","Following the death of his father, Britt Reid, heir to his father's large company, teams up with his late dad's assistant Kato to become a masked crime fighting team.",39.0,Michel Gondry,The Green Hornet,2011,119,USA, 120000000,98780042,227817248,129037206,107817248,1
50862,194.0,"Action, Drama, Thriller","Los Angeles screenwriter David Sumner relocates with his wife to her hometown in the deep South. There, while tensions build between them, a brewing conflict with locals becomes a threat to them both.",45.0,Rod Lurie,Straw Dogs,2011,110,USA, 25000000,10324441,11168712,844271,-13831288,0
46897,236.0,"Action, Comedy, Crime","When a group of hard-working guys find out they've fallen victim to their wealthy employer's Ponzi scheme, they conspire to rob his high-rise residence.",59.0,Brett Ratner,Tower Heist,2011,104,USA, 75000000,78046570,152930623,74884053,77930623,1
47327,64.0,"Drama, Mystery, Sci-Fi",Railroad executive Dagny Taggart and steel mogul Henry Rearden form an alliance to fight the increasingly authoritarian government of the United States.,28.0,Paul Johansson,Atlas Shrugged: Part I,2011,97,USA, 20000000,4627375,4627375,0,-15372625,0
53786,259.0,"Action, Drama, Romance","Two friends spend all their free time building flame-throwers and weapons of mass destruction in hopes that a global apocalypse will occur and clear the runway for their imaginary gang ""Mother Medusa"".",72.0,Evan Glodell,Bellflower,2011,106,USA, 17000,168226,172935,4709,155935,1
58990,45.0,"Comedy, Drama",A wedding at her parents' Annapolis estate hurls high-strung Lynn into the center of touchy family dynamics.,46.0,Sam Levinson,Another Happy Day,2011,119,USA, 4000000,8464,355688,347224,-3644312,0
54260,290.0,"Comedy, Romance","A lazy, incompetent middle school teacher who hates her job, her students, and her co-workers is forced to return to teaching to make enough money for breast implants after her wealthy fianc√© dumps her.",47.0,Jake Kasdan,Bad Teacher,2011,92,USA, 20000000,100292856,216197492,115904636,196197492,1
54444,65.0,"Action, Comedy, Drama","In a post apocalyptic future, two rival gangs fight for control of Frazier Park by playing ""Beat Beat Revelation"", a deadly version of Dance, Dance, Revolution(TM).",48.0,"Brandon Trost, Jason Trost",The FP,2011,82,USA, 60000,40557,40557,0,-19443,0
54229,8.0,"Drama, History, War",A drama based on a true story when the Stirn family lived next to a Nazi POW camp in Wisconsin during W.W.II.,47.0,"Kate Connor, Michael Worth",Fort McCoy,2011,100,USA, 3000000,78948,78948,0,-2921052,0
54562,334.0,"Comedy, Drama, Romance","Inspired by a true story, a comedy centered on a 27-year-old guy who learns of his cancer diagnosis and his subsequent struggle to beat the disease.",72.0,Jonathan Levine,50/50,2011,100,USA, 8000000,35014192,39187783,4173591,31187783,1
54386,333.0,"Drama, Sport","The youngest son of an alcoholic former boxer returns home, where he's trained by his father for competition in a mixed martial arts tournament - a path that puts the fighter on a collision course with his estranged, older brother.",71.0,Gavin O'Connor,Warrior,2011,140,USA, 25000000,13657115,23057115,9400000,-1942885,0
53891,45.0,"Action, Comedy, Drama",Set in the world of mega-churches in which a former Deadhead-turned-born again-Christian finds himself on the run from fundamentalist members of his mega-church who will do anything to protect their larger-than-life pastor.,35.0,George Ratliff,Salvation Boulevard,2011,96,USA, 5500000,28468,89182,60714,-5410818,0
54080,166.0,"Adventure, Comedy","Six years after their Guantanamo Bay adventure, stoner buds Harold Lee and Kumar Patel cause a holiday fracas by inadvertently burning down Harold's father-in-law's prize Christmas tree.",61.0,Todd Strauss-Schulson,A Very Harold & Kumar 3D Christmas,2011,90,USA, 19000000,35061031,35387212,326181,16387212,1
54536,132.0,"Animation, Action, Adventure",A young boy named Milo gains a deeper appreciation for his mom after Martians come to Earth to take her away.,49.0,Simon Wells,Mars Needs Moms,2011,88,USA, 150000000,21392758,38992758,17600000,-111007242,0
54006,428.0,"Horror, Mystery","Ten years have passed, and Sidney Prescott, who has put herself back together thanks in part to her writing, is visited by the Ghostface Killer.",52.0,Wes Craven,Scream 4,2011,111,USA, 40000000,38180928,97231420,59050492,57231420,1
53955,669.0,Horror,"Five friends go for a break at a remote cabin, where they get more than they bargained for, discovering the truth behind the cabin in the woods.",72.0,Drew Goddard,The Cabin in the Woods,2011,95,USA, 30000000,42073277,94348403,52275126,64348403,1
54047,138.0,"Drama, Thriller","When college freshman Sara arrives on campus for the first time, she befriends her roommate, Rebecca, unaware that the girl is becoming dangerously obsessed with her.",23.0,Christian E. Christiansen,The Roommate,2011,91,USA, 16000000,37300000,40492652,3192652,24492652,1
54502,288.0,"Animation, Action, Adventure","Po and his friends fight to stop a peacock villain from conquering China with a deadly new weapon, but first the Dragon Warrior must come to terms with his past.",67.0,Jennifer Yuh Nelson,Kung Fu Panda 2,2011,90,USA, 150000000,165249063,665692281,500443218,515692281,1
57535,216.0,"Action, Adventure, Drama",An elite team of Navy SEALs embark on a covert mission to recover a kidnapped CIA agent.,40.0,"Mike McCoy, Scott Waugh",Act of Valor,2012,110,USA, 12000000,70012847,81275130,11262283,69275130,1
57583,243.0,"Action, Comedy, Romance",A pair of C.I.A. operatives wage an epic battle against one another when they discover they are dating the same woman.,31.0,McG,This Means War,2012,103,USA, 65000000,54760791,156491279,101730488,91491279,1
57604,125.0,"Action, Comedy, Crime","Unemployed and newly-divorced Stephanie Plum lands a job at her cousin's bail-bond business, where her first assignment puts her on the trail of a wanted local cop from her romantic past.",22.0,Julie Anne Robinson,One for the Money,2012,91,USA, 40000000,26414527,36897094,10482567,-3102906,0
59828,122.0,"Drama, Music, Romance","Emily arrives in Miami with aspirations to become a professional dancer. She sparks with Sean, the leader of a dance crew whose neighborhood is threatened by Emily's father's development plans.",43.0,Scott Speer,Step Up Revolution,2012,99,USA, 33000000,35074677,140470746,105396069,107470746,1
57684,295.0,Comedy,"Jim, Michelle, Stifler, and their friends reunite in East Great Falls, Michigan for their high school reunion.",49.0,"Jon Hurwitz, Hayden Schlossberg",American Reunion,2012,113,USA, 50000000,57011521,234989584,177978063,184989584,1
57715,214.0,"Drama, Romance","A car accident puts Paige in a coma, and when she wakes up with severe memory loss, her husband Leo works to win her heart again.",43.0,Michael Sucsy,The Vow,2012,104,USA, 30000000,125014030,196114570,71100540,166114570,1
54816,169.0,"Drama, Mystery, Romance",A Marine travels to Louisiana after serving three tours in Iraq and searches for the unknown woman he believes was his good luck charm during the war.,39.0,Scott Hicks,The Lucky One,2012,101,USA, 25000000,60457138,99357138,38900000,74357138,1
57805,344.0,"Crime, Drama, Thriller",Pot growers Ben and Chon face off against the Mexican drug cartel who kidnapped their shared girlfriend.,59.0,Oliver Stone,Savages,2012,131,USA, 45000000,47382068,82966152,35584084,37966152,1
57869,76.0,"Comedy, Romance",Four friends conspire to turn the tables on their women when they discover the ladies have been using Steve Harvey's relationship advice against them.,51.0,Tim Story,Think Like a Man,2012,122,USA, 12000000,91547205,96070507,4523302,84070507,1
59739,259.0,Comedy,An incumbent Representative embroiled in personal scandal faces a no-holds-barred challenge from a naive newcomer funded by two unscrupulous billionaire lobbyist brothers.,50.0,Jay Roach,The Campaign,2012,85,USA, 95000000,86907746,104907746,18000000,9907746,1
57893,338.0,"Animation, Adventure, Comedy","A misunderstood boy takes on ghosts, zombies and grown-ups to save his town from a centuries-old curse.",72.0,"Chris Butler, Sam Fell",ParaNorman,2012,92,USA, 60000000,56003051,107139399,51136348,47139399,1
57681,6.0,Comedy,A desperate TV producer convinces an old Armenian Uncle to star in a new reality show. Cultures collide when Uncle Rafael is thrown into the Schumacher family household where he has one ...,36.0,Marc Fusco,My Uncle Rafael,2012,102,USA, 1300000,243616,243616,0,-1056384,0
57461,168.0,"Comedy, Drama, Romance","Follows the lives of five interconnected couples as they experience the thrills and surprises of having a baby and realize that no matter what you plan for, life does not always deliver what is expected.",41.0,Kirk Jones,What to Expect When You're Expecting,2012,110,USA, 40000000,41152203,84384002,43231799,44384002,1
60981,388.0,Drama,Two young boys encounter a fugitive and form a pact to help him evade the vigilantes that are on his trail and to reunite him with his true love.,76.0,Jeff Nichols,Mud,2012,130,USA, 10000000,21590086,32613173,11023087,22613173,1
59981,431.0,"Crime, Drama, Thriller","A motorcycle stunt rider turns to robbing banks as a way to provide for his lover and their newborn child, a decision that puts him on a collision course with an ambitious rookie cop navigating a department ruled by a corrupt detective.",68.0,Derek Cianfrance,The Place Beyond the Pines,2012,140,USA, 15000000,21403519,35485608,14082089,20485608,1
43927,477.0,"Action, Adventure, Sci-Fi","Transported to Barsoom, a Civil War vet discovers a barren planet seemingly inhabited by 12-foot tall barbarians. Finding himself prisoner of these creatures, he escapes, only to encounter Woola and a princess in desperate need of a savior.",51.0,Andrew Stanton,John Carter,2012,132,USA, 250000000,73078100,284139100,211061000,34139100,1
54593,291.0,"Action, Crime, Thriller","After watching their respective partners die, a New Orleans hitman and a Washington, D.C. detective form an alliance in order to bring down their common enemy.",48.0,Walter Hill,Bullet to the Head,2012,92,USA, 55000000,9489829,21947209,12457380,-33052791,0
57004,136.0,"Comedy, Romance, Sport",A former sports star who's fallen on hard times starts coaching his son's football team as a way to get his life together. His attempts to become an adult are met with challenges from the attractive football moms who pursue him at every turn.,27.0,Gabriele Muccino,Playing for Keeps,2012,105,USA, 35000000,13103272,30962335,17859063,-4037665,0
57047,53.0,"Comedy, Horror, Romance",Two female vampires in modern-day New York City are faced with daunting romantic possibilities.,57.0,Amy Heckerling,Vamps,2012,92,USA, 16000000,3361,92748,89387,-15907252,0
57070,254.0,"Action, Thriller","In Manhattan, a bike messenger picks up an envelope that attracts the interest of a dirty cop, who pursues the cyclist throughout the city.",66.0,David Koepp,Premium Rush,2012,91,USA, 35000000,20275446,31083599,10808153,-3916401,0
54927,362.0,"Comedy, Drama, Musical",A small town girl and a city boy meet on the Sunset Strip while pursuing their Hollywood dreams.,47.0,Adam Shankman,Rock of Ages,2012,123,USA, 75000000,38518613,59418613,20900000,-15581387,0
63116,29.0,"Comedy, Crime, Drama",A Wall Street investment banker who has been set up as the linchpin of his company's mob-backed Ponzi scheme is relocated with his family to Aunt Madea's southern home.,42.0,Tyler Perry,Madea's Witness Protection,2012,114,USA, 20000000,65653242,66899242,1246000,46899242,1
57176,499.0,Drama,A Naval veteran arrives home from war unsettled and uncertain of his future - until he is tantalized by the Cause and its charismatic leader.,86.0,Paul Thomas Anderson,The Master,2012,138,USA, 32000000,16377274,28258060,11880786,-3741940,0
57184,226.0,Horror,"In Italy, a woman becomes involved in a series of unauthorized exorcisms during her mission to discover what happened to her mother, who allegedly murdered three people during her own exorcism.",18.0,William Brent Bell,The Devil Inside,2012,83,USA, 1000000,53261944,101758490,48496546,100758490,1
61328,233.0,"Comedy, Music, Romance","Beca, a freshman at Barden University, is cajoled into joining The Bellas, her school's all-girls singing group. Injecting some much needed energy into their repertoire, The Bellas take on their male rivals in a campus competition.",66.0,Jason Moore,Pitch Perfect,2012,112,USA, 17000000,65001093,115350426,50349333,98350426,1
59984,30.0,"Comedy, Drama","As single mom Grace juggles work, bills, and her affair with a married doctor, her daughter, Ansiedad, plots a shortcut to adulthood after finding inspiration in the coming-of-age stories she's reading for school.",45.0,Patricia Riggen,Girl in Progress,2012,93,USA, 5000000,2609412,4599888,1990476,-400112,0
51456,139.0,"Comedy, Family",Artie and Diane agree to look after their three grandkids when their type-A helicopter parents need to leave town for work. Problems arise when the kids' 21st-century behavior collides with Artie and Diane's old-school methods.,36.0,Andy Fickman,Parental Guidance,2012,105,USA, 25000000,77267296,119772232,42504936,94772232,1
51425,543.0,"Comedy, Drama, Romance","After a stint in a mental institution, former teacher Pat Solitano moves back in with his parents and tries to reconcile with his ex-wife. Things get more challenging when Pat meets Tiffany, a mysterious girl with problems of her own.",81.0,David O. Russell,Silver Linings Playbook,2012,122,USA, 21000000,132092958,236412453,104319495,215412453,1
57256,259.0,"Action, Adventure, Crime","As a police psychologist works to talk down an ex-con who is threatening to jump from a Manhattan hotel rooftop, the biggest diamond heist ever committed is in motion.",40.0,Asger Leth,Man on a Ledge,2012,102,USA, 42000000,18620000,46221189,27601189,4221189,1
51144,21.0,Comedy,The People I've Slept With - a promiscuous woman who finds herself with an unplanned pregnancy and needs to figure out who the baby daddy is...NOW. Angela Yang loves sex. She loves it so ...,45.0,Quentin Lee,The People I've Slept With,2012,89,USA, 3000000,19137,19137,0,-2980863,0
61115,22.0,"Drama, Sport",A story centered on a Native American lacrosse team making its way through a prep school league tournament.,42.0,Steve Rash,Crooked Arrows,2012,105,USA, 13000000,1832541,1832541,0,-11167459,0
47553,147.0,"Action, Drama, History","A crew of African American pilots in the Tuskegee training program, having faced segregation while kept mostly on the ground during World War II, are called into duty under the guidance of Col. A.J. Bullard.",46.0,Anthony Hemingway,Red Tails,2012,125,USA, 58000000,49876377,50365377,489000,-7634623,0
59462,36.0,"Comedy, Drama","Don, a nineteen-year-old sophomore at a Texas junior college, tries to escape his Bible Belt upbringing for life in the Pacific Northwest at the most godless campus in America.",48.0,Steve Taylor,Blue Like Jazz,2012,108,USA, 1200000,595018,595018,0,-604982,0
58403,234.0,"Animation, Adventure, Comedy","Manny, Diego, and Sid embark upon another adventure after their continent is set adrift. Using an iceberg as a ship, they encounter sea creatures and battle pirates as they explore a new world.",49.0,"Steve Martino, Mike Thurmeier",Ice Age: Continental Drift,2012,88,USA, 95000000,161321843,877244782,715922939,782244782,1
58470,328.0,"Adventure, Drama, Fantasy","After the birth of Renesmee/Nessie, the Cullens gather other vampire clans in order to protect the child from a false allegation that puts the family in front of the Volturi.",52.0,Bill Condon,The Twilight Saga: Breaking Dawn - Part 2,2012,115,USA, 120000000,292324737,829746820,537422083,709746820,1
59337,149.0,"Horror, Thriller","A man who escapes from the vicious grips of the serial killer known as ""The Collector"" is then forced to help rescue an innocent girl from the killer's booby-trapped lair.",38.0,Marcus Dunstan,The Collection,2012,82,USA, 7500000,6842058,9929706,3087648,2429706,1
58325,12.0,Comedy,"Zach is guy for whom the party never ends. But when he meets the girl he nicknames ""Crazy Eyes,"" the inability to have her, combined with family matters, are signs that his idle life might be due for a change.",31.0,Adam Sherman,Crazy Eyes,2012,95,USA, 10000000,6141,6141,0,-9993859,0
59329,501.0,"Comedy, Drama, Romance","A pair of young lovers flee their New England town, which causes a local search party to fan out to find them.",84.0,Wes Anderson,Moonrise Kingdom,2012,94,USA, 16000000,45512466,68263166,22750700,52263166,1
58698,150.0,"Comedy, Drama","As inventor Andy Brewster is about to embark on the road trip of a lifetime, a quick stop at his mom's house turns into an unexpected cross-country voyage with her along for the ride.",50.0,Anne Fletcher,The Guilt Trip,2012,95,USA, 40000000,37134215,41863726,4729511,1863726,1
49418,738.0,"Action, Adventure, Sci-Fi",Earth's mightiest heroes must come together and learn to fight as a team if they are going to stop the mischievous Loki and his alien army from enslaving humanity.,69.0,Joss Whedon,The Avengers,2012,143,USA, 220000000,623357910,1518812988,895455078,1298812988,1
58834,421.0,"Drama, Sci-Fi, Thriller",Three high school friends gain superpowers after making an incredible discovery underground. Soon they find their lives spinning out of control and their bond tested as they embrace their darker sides.,69.0,Josh Trank,Chronicle,2012,84,USA, 12000000,64575175,126636097,62060922,114636097,1
49249,271.0,"Animation, Comedy, Family","Dracula, who operates a high-end resort away from the human world, goes into overprotective mode when a boy discovers the resort and falls for the count's teenaged daughter.",47.0,Genndy Tartakovsky,Hotel Transylvania,2012,91,USA, 85000000,148313048,358375603,210062555,273375603,1
58869,96.0,"Comedy, Drama, Music","G.G. Sparrow faces off with her choir's newly appointed director, Vi Rose Hill, over the group's direction as they head into a national competition.",44.0,Todd Graff,Joyful Noise,2012,118,USA, 25000000,30932113,31158113,226000,6158113,1
54571,270.0,"Adventure, Comedy, Drama","As an asteroid nears Earth, a man finds himself alone after his wife leaves in a panic. He decides to take a road trip to reunite with his high school sweetheart. Accompanying him is a neighbor who inadvertently puts a wrench in his plan.",59.0,Lorene Scafaria,Seeking a Friend for the End of the World,2012,101,USA, 10000000,7078738,9636289,2557551,-363711,0
58960,107.0,"Comedy, Drama","While settling his recently deceased father's estate, a salesman discovers he has a sister whom he never knew about, leading both siblings to re-examine their perceptions about family and life choices.",49.0,Alex Kurtzman,People Like Us,2012,114,USA, 16000000,12434778,12558931,124153,-3441069,0
48479,413.0,"Action, Crime, Thriller",A homicide investigator digs deeper into a case involving a trained military sniper who shot five random victims.,50.0,Christopher McQuarrie,Jack Reacher,2012,130,USA, 60000000,80070736,218340595,138269859,158340595,1
58314,76.0,"Adventure, Comedy","Wren's Halloween plans go awry when she's made to babysit her brother, who disappears into a sea of trick-or-treaters. With her best friend and two nerds at her side, she needs to find her brother before her mom finds out he's missing.",37.0,Josh Schwartz,Fun Size,2012,86,USA, 14000000,9409538,11417362,2007824,-2582638,0
59470,289.0,"Comedy, Romance","Pete and Debbie are both about to turn 40, their kids hate each other, both of their businesses are failing, they're on the verge of losing their house, and their relationship is threatening to fall apart.",59.0,Judd Apatow,This Is 40,2012,134,USA, 35000000,67544505,88058786,20514281,53058786,1
59490,20.0,"Comedy, Drama, Romance",A shy senior and a down-to-earth junior fall in love over one weekend.,55.0,Jonathan Kasdan,The First Time,2012,95,USA, 2000000,22836,92654,69818,-1907346,0
50350,625.0,"Action, Sci-Fi","After Peter Parker is bitten by a genetically altered spider, he gains newfound, spider-like powers and ventures out to save the city from the machinations of a mysterious reptilian foe.",66.0,Marc Webb,The Amazing Spider-Man,2012,136,USA, 230000000,262030663,757930663,495900000,527930663,1
56943,234.0,"Comedy, Drama, Romance","After thirty years of marriage, a middle-aged couple attends an intense, week-long counseling session to work on their relationship.",65.0,David Frankel,Hope Springs,2012,100,USA, 30000000,63536011,114281051,50745040,84281051,1
64239,10.0,"Drama, War","The son of a fallen soldier, years after his father's death, tries to reconnect with his grandfather, who is still grieving the loss of his child.",11.0,"Darrel Campbell, Kevin McAfee",Last Ounce of Courage,2012,101,USA, 1200000,3329674,3329674,0,2129674,1
58014,229.0,Comedy,"3 high school seniors throw a birthday party to make a name for themselves. As the night progresses, things spiral out of control as word of the party spreads.",48.0,Nima Nourizadeh,Project X,2012,88,USA, 12000000,54731865,102731865,48000000,90731865,1
58029,463.0,Comedy,"John Bennett, a man whose childhood wish of bringing his teddy bear to life came true, now must decide between keeping the relationship with the bear or his girlfriend, Lori.",62.0,Seth MacFarlane,Ted,2012,106,USA, 50000000,218815487,549368315,330552828,499368315,1
48186,71.0,"Comedy, Drama","After stretching the truth on a deal with a spiritual guru, literary agent Jack McCall finds a Bodhi tree on his property. Its appearance holds a valuable lesson on the consequences of every word he speaks.",26.0,Brian Robbins,A Thousand Words,2012,91,USA, 40000000,18450127,24397992,5947865,-15602008,0
58112,317.0,Comedy,The heroic story of a dictator who risked his life to ensure that democracy would never come to the country he so lovingly oppressed.,58.0,Larry Charles,The Dictator,2012,83,USA, 65000000,59650222,179379533,119729311,114379533,1
58163,154.0,"Action, Comedy, Sport",A high school biology teacher looks to become a successful mixed-martial arts fighter in an effort to raise money to prevent extra-curricular activities from being axed at his cash-strapped school.,40.0,Frank Coraci,Here Comes the Boom,2012,105,USA, 42000000,45290318,73100172,27809854,31100172,1
54477,268.0,"Action, Comedy, Horror",Four men who form a neighborhood watch group as a way to get out of their day-to-day family routines find themselves defending the Earth from an alien invasion.,36.0,Akiva Schaffer,The Watch,2012,102,USA, 68000000,35353000,68267862,32914862,267862,1
61226,294.0,"Biography, Crime, Drama","A normal Friday service at a fast food restaurant becomes interrupted by a police officer who claims an employee stole from a customer, but something more sinister is going on.",68.0,Craig Zobel,Compliance,2012,90,USA, 270000,319285,592116,272831,322116,1
58264,104.0,"Action, Crime, Thriller","A former thief frantically searches for his missing daughter, who has been kidnapped and locked in the trunk of a taxi.",43.0,Simon West,Stolen,2012,96,USA, 35000000,304318,2106557,1802239,-32893443,0
58265,262.0,"Action, Crime, Thriller","Mei, a young girl whose memory holds a priceless numerical code, finds herself pursued by the Triads, the Russian mob, and corrupt NYC cops. Coming to her aid is an ex-cage fighter whose life was destroyed by the gangsters on Mei's trail.",55.0,Boaz Yakin,Safe,2012,94,USA, 30000000,17142080,40346186,23204106,10346186,1
59548,392.0,"Animation, Adventure, Comedy","A video game villain wants to be a hero and sets out to fulfill his dream, but his quest brings havoc to the whole arcade where he lives.",72.0,Rich Moore,Wreck-It Ralph,2012,101,USA, 165000000,189422889,471222889,281800000,306222889,1
59497,424.0,"Crime, Drama, Thriller","Jackie Cogan is an enforcer hired to restore order after three dumb guys rob a Mob protected card game, causing the local criminal economy to collapse.",64.0,Andrew Dominik,Killing Them Softly,2012,97,USA, 15000000,15026056,37930465,22904409,22930465,1
58285,378.0,Drama,An introvert freshman is taken under the wings of two seniors who welcome him to the real world.,67.0,Stephen Chbosky,The Perks of Being a Wallflower,2012,103,USA, 13000000,17742948,33384127,15641179,20384127,1
58288,126.0,"Action, Horror, Mystery","John looks to take down Luc Deveraux after a home invasion claims his wife and daughter. The fight pits John against Andrew Scott and an army of genetically enhanced warriors; meanwhile, he must contend with a UniSol in relentless pursuit.",58.0,John Hyams,Universal Soldier: Day of Reckoning,2012,114,USA, 11500000,5460,369179,363719,-11130821,0
57957,120.0,"Biography, Drama, Sport","When young Jay Moriarity discovers that the mythic Mavericks surf break, one of the biggest waves on Earth, exists just miles from his Santa Cruz home, he enlists the help of local legend Frosty Hesson to train him to survive it.",45.0,"Michael Apted, Curtis Hanson",Chasing Mavericks,2012,116,USA, 20000000,6002756,6633207,630451,-13366793,0
60228,274.0,"Comedy, Drama, Fantasy","A novelist struggling with writer's block finds romance in a most unusual way: by creating a female character he thinks will love him, then willing her into existence.",67.0,"Jonathan Dayton, Valerie Faris",Ruby Sparks,2012,104,USA, 8000000,2540106,9368803,6828697,1368803,1
60578,80.0,"Drama, Music","In the 1960s, three sisters form a girl group and soon become local sensations with major label interest, but fame becomes a challenge as the close-knit family begins to fall apart.",54.0,Salim Akil,Sparkle,2012,116,USA, 14000000,24397469,24637469,240000,10637469,1
60462,276.0,"Comedy, Drama, Romance",Three magazine employees head out on an assignment to interview a guy who placed a classified advertisement seeking a companion for time travel.,72.0,Colin Trevorrow,Safety Not Guaranteed,2012,86,USA, 750000,4010957,4424699,413742,3674699,1
53668,238.0,"Action, Adventure, Crime",A group of teenagers look to save their town from an invasion of North Korean soldiers.,31.0,Dan Bradley,Red Dawn,2012,93,USA, 65000000,44806783,50950296,6143513,-14049704,0
61396,64.0,Thriller,A Secret Service Agent is held captive in the trunk of a car and endures mental and physical torture as terrorists attempt to extract information for their plot against the President of the United States.,38.0,Gabe Torres,Brake,2012,92,USA, 500000,4876,102819,97943,-397181,0
53618,385.0,"Action, Comedy, Crime",A pair of underachieving cops are sent back to a local high school to blend in and bring down a synthetic drug ring.,69.0,"Phil Lord, Christopher Miller",21 Jump Street,2012,109,USA, 42000000,138447667,201585328,63137661,159585328,1
60499,342.0,"Biography, Comedy, Drama",A man in an iron lung who wishes to lose his virginity contacts a professional sex surrogate with the help of his therapist and priest.,79.0,Ben Lewin,The Sessions,2012,95,USA, 1000000,6002451,9138338,3135887,8138338,1
53606,158.0,Comedy,"While in his teens, Donny fathered a son, Todd, and raised him as a single parent until Todd's 18th birthday. Now Donny resurfaces just before Todd's wedding after years apart, sending the groom-to-be's world crashing down.",31.0,Sean Anders,That's My Boy,2012,116,USA, 70000000,36931089,57719093,20788004,-12280907,0
60522,16.0,"Drama, Music",A promising hip-hop rhymer from Los Angeles finds herself in a gray area when a record producer offers her a compromising shot at stardom.,57.0,"Youssef Delara, Michael D. Olmos",Filly Brown,2012,80,USA, 2000000,2850357,2940411,90054,940411,1
53577,103.0,Drama,"Set in suburban New Jersey in the 1960s, a group of friends form a rock band and try to make it big.",65.0,David Chase,Not Fade Away,2012,112,USA, 20000000,610792,636399,25607,-19363601,0
61435,114.0,Comedy,"Former college frenemies Lauren and Katie move into a fabulous Gramercy Park apartment, and in order to make ends meet, the unlikely pair start a phone sex line together.",55.0,Jamie Travis,"For a Good Time, Call...",2012,85,USA, 850000,1251749,1386088,134339,536088,1
60555,156.0,"Comedy, Drama, Romance","When 30-something Jesse returns to his alma mater for a professor's retirement party, he falls for Zibby, a college student, and is faced with a powerful attraction that springs up between them.",55.0,Josh Radnor,Liberal Arts,2012,97,USA, 2000000,327345,1150681,823336,-849319,0
62069,241.0,"Drama, Sport","A daughter tries to remedy her dysfunctional relationship with her ailing father, a decorated baseball scout by helping him in a recruiting trip which could be his last.",58.0,Robert Lorenz,Trouble with the Curve,2012,111,USA, 30000000,35763137,48963137,13200000,18963137,1
55498,180.0,"Action, Adventure, Comedy","Sean Anderson partners with his mom's husband on a mission to find his grandfather, who is thought to be missing on a mythical island.",41.0,Brad Peyton,Journey 2: The Mysterious Island,2012,94,USA, 79000000,103860290,335260290,231400000,256260290,1
60573,15.0,Drama,"A journalist interviews a sixteen year old boy, who is in police custody after he shot and killed 42 people at his high school.",27.0,Michelle Danner,Hello Herman,2012,90,USA, 1500000,8437,8437,0,-1491563,0
60839,159.0,"Comedy, Romance",Three friends are asked to be bridesmaids at a wedding of a woman they used to ridicule back in high school.,53.0,Leslye Headland,Bachelorette,2012,87,USA, 3000000,447954,11947954,11500000,8947954,1
60820,37.0,Drama,A former Britpop rocker who now works on a farm gets caught driving drunk and faces deportation after living in Los Angeles for many years. His efforts to stay in the U.S. force him to confront the past and current demons in his life.,62.0,Marshall Lewy,California Solo,2012,94,USA, 200000,15433,15433,0,-184567,0
60996,62.0,"Comedy, Fantasy, Thriller","When a couple discovers that a brass teapot makes them money whenever they hurt themselves, they must come to terms with how far they are willing to go.",43.0,Ramaa Mosley,The Brass Teapot,2012,101,USA, 900000,6997,245027,238030,-654973,0
62000,126.0,Comedy,"A burgeoning stand-up comedian struggles with the stress of a stalled career, a stale relationship, and the wild spurts of severe sleepwalking he is desperate to ignore.",71.0,"Mike Birbiglia, Seth Barrish",Sleepwalk with Me,2012,81,USA, 1000000,2266067,2266067,0,1266067,1
60812,331.0,"Comedy, Drama","A male stripper teaches a younger performer how to party, pick up women, and make easy money.",72.0,Steven Soderbergh,Magic Mike,2012,110,USA, 7000000,113721571,167221571,53500000,160221571,1
56168,162.0,"Comedy, Drama, Family","A childless couple bury a box in their backyard, containing all of their wishes for an infant. Soon, a child is born, though Timothy Green is not all that he appears.",47.0,Peter Hedges,The Odd Life of Timothy Green,2012,105,USA, 25000000,51854875,56012642,4157767,31012642,1
60782,42.0,"Crime, Drama",An 11-year-old boy gets a crash course in what it means to be a man when he spends a day with the ex-convict uncle he idolizes.,52.0,Sheldon Candis,LUV,2012,94,USA, 3000000,156996,156996,0,-2843004,0
61851,113.0,Drama,A married couple whose bond is built on a mutual love of alcohol gets their relationship put to the test when the wife decides to get sober.,71.0,James Ponsoldt,Smashed,2012,81,USA, 500000,376597,499725,123128,-275,0
55866,128.0,"Drama, Thriller",A drama centered on a group of people searching for human connections in today's wired world.,64.0,Henry Alex Rubin,Disconnect,2012,115,USA, 10000000,1436900,3428048,1991148,-6571952,0
60640,21.0,"Comedy, Drama","A newlywed couple cancels their honeymoon and returns to the snowy Midwest to make the funeral arrangements for their best man, who died unexpectedly after their ceremony.",36.0,Ted Koland,Best Man Down,2012,89,USA, 1500000,1938,1938,0,-1498062,0
53335,37.0,Drama,"When her husband is sentenced to eight years in prison, Ruby drops out of medical school in order to focus on her husband's well-being while he's incarcerated - leading her on a journey of self-discovery in the process.",75.0,Ava DuVernay,Middle of Nowhere,2012,97,USA, 200000,236806,236806,0,36806,1
53351,363.0,"Crime, Drama","Set in Depression-era Franklin County, Virginia, a trio of bootlegging brothers are threatened by a new special deputy and other authorities angling for a cut of their profits.",58.0,John Hillcoat,Lawless,2012,116,USA, 26000000,37400127,53676628,16276501,27676628,1
56010,266.0,"Animation, Action, Adventure","When the evil spirit Pitch launches an assault on Earth, the Immortal Guardians team up to protect the innocence of children all around the world.",57.0,Peter Ramsey,Rise of the Guardians,2012,97,USA, 145000000,103412758,306941670,203528912,161941670,1
61056,51.0,Drama,"A troubled young woman moves to San Francisco, where she becomes involved in pornography and aligns herself with a cocaine-addicted lawyer.",33.0,Stephen Elliott,About Cherry,2012,98,USA, 2500000,3003,8315,5312,-2491685,0
56440,225.0,"Biography, Crime, Drama","The story of Richard Kuklinski, the notorious contract killer and family man. When finally arrested in 1986, neither his wife nor daughters had any clue about his real profession.",60.0,Ariel Vromen,The Iceman,2012,106,USA, 10000000,1969193,4552970,2583777,-5447030,0
62209,174.0,"Action, Comedy",Former getaway driver Charles Bronson jeopardizes his Witness Protection Plan identity in order to help his girlfriend get to Los Angeles. The feds and Charles' former gang chase them on the road.,50.0,"David Palmer, Dax Shepard",Hit and Run,2012,100,USA, 2000000,13749300,14453354,704054,12453354,1
55939,390.0,"Action, Adventure, Sci-Fi",A fleet of ships is forced to do battle with an armada of unknown origins in order to discover and thwart their destructive goals.,41.0,Peter Berg,Battleship,2012,131,USA, 209000000,65422625,303025485,237602860,94025485,1
60393,365.0,"Action, Crime, Drama","Shot documentary-style, this film follows the daily grind of two young police officers in LA who are partners and friends, and what happens when they meet criminal forces greater than themselves.",68.0,David Ayer,End of Watch,2012,109,USA, 7000000,41003371,48126384,7123013,41126384,1
56747,27.0,"Adventure, Family, Fantasy","The Oogieloves, Goobie, Zoozie, and Toofie, set out to find five magical balloons that will make their good friend Schluufy's surprise birthday party extra special.",32.0,Matthew Diamond,The Oogieloves in the Big Balloon Adventure,2012,88,USA, 20000000,1065907,1065907,0,-18934093,0
60957,173.0,Drama,"In New York City, a young girl is caught in the middle of her parents' bitter custody battle.",74.0,"Scott McGehee, David Siegel",What Maisie Knew,2012,99,USA, 6000000,1066471,2711379,1644908,-3288621,0
61424,16.0,"Drama, Musical","A young businessman who lands a community service sentence falls in with a group of misfit kids who need mentoring. With the help of a pro instructor, he works to get the kids ready for a big underground dance competition.",31.0,Chris Stokes,Battlefield America,2012,106,USA, 15000000,172000,252805,80805,-14747195,0
60377,829.0,"Drama, Western","With the help of a German bounty hunter, a freed slave sets out to rescue his wife from a brutal Mississippi plantation owner.",81.0,Quentin Tarantino,Django Unchained,2012,165,USA, 100000000,162805434,425368238,262562804,325368238,1
60295,30.0,"Comedy, Drama","Peter, a family man who works for a failing supermarket chain finds his life shaken up by his new boss, Susan, who starts to groom him for an executive position. Money and opportunities are within his grasp, but at what price?",67.0,Michael Walker,Price Check,2012,92,USA, 2000000,7413,7413,0,-1992587,0
62443,639.0,"Adventure, Drama, Fantasy","Faced with both her hot-tempered father's fading health and melting ice-caps that flood her ramshackle bayou community and unleash ancient aurochs, six-year-old Hushpuppy must learn the ways of courage and love.",86.0,Benh Zeitlin,Beasts of the Southern Wild,2012,93,USA, 1800000,12795746,21107746,8312000,19307746,1
60400,83.0,Comedy,"Two guys get a billion dollars to make a movie, only to watch their dream run off course. In order to make the money back, they then attempt to revitalize a failing shopping mall.",40.0,"Tim Heidecker, Eric Wareheim",Tim and Eric's Billion Dollar Movie,2012,93,USA, 3000000,201436,223580,22144,-2776420,0
61400,257.0,"Comedy, Crime, Drama","In the near future, an ex-jewel thief receives a gift from his son: a robot butler programmed to look after him. But soon the two companions try their luck as a heist team.",67.0,Jake Schreier,Robot & Frank,2012,89,USA, 2500000,3325038,4806423,1481385,2306423,1
54181,213.0,"Animation, Adventure, Comedy","The Madagascar animals join a struggling European circus to get back to New York, but find themselves being pursued by a psychotic animal control officer.",60.0,"Eric Darnell, Tom McGrath",Madagascar 3: Europe's Most Wanted,2012,93,USA, 145000000,216391482,746921274,530529792,601921274,1
61341,23.0,"Drama, Mystery, Sci-Fi",Railroad owner Dagny Taggart and steel mogul Henry Rearden search desperately for the inventor of a revolutionary motor as the U.S. government continues to spread its control over the national economy.,26.0,John Putch,Atlas Shrugged II: The Strike,2012,111,USA, 10000000,3336053,3336053,0,-6663947,0
55454,680.0,"Action, Adventure, Sci-Fi",Katniss Everdeen voluntarily takes her younger sister's place in the Hunger Games: a televised competition in which two teenagers from each of the twelve Districts of Panem are chosen at random to fight to the death.,68.0,Gary Ross,The Hunger Games,2012,142,USA, 78000000,408010692,694394724,286384032,616394724,1
43210,163.0,"Comedy, Family","While trying to save their childhood orphanage, Moe, Larry and Curly inadvertently stumble into a murder plot and wind up starring in a reality television show.",56.0,"Bobby Farrelly, Peter Farrelly",The Three Stooges,2012,92,USA, 30000000,44338224,54819301,10481077,24819301,1
60945,35.0,Drama,A political strategist juggling three clients questions whether or not to take the high road as the ugly side of his work begins to haunt him.,34.0,Bill Guttentag,Knife Fight,2012,100,USA, 7000000,5661,5661,0,-6994339,0
61425,40.0,"Comedy, Drama",A dropout comes to the aid of a chubby and suicidal high-school kid by recruiting him as the drummer for his upstart punk-rock band.,54.0,Matthew Lillard,Fat Kid Rules the World,2012,98,USA, 750000,41000,41000,0,-709000,0
56477,249.0,"Crime, Drama, Mystery",A reporter returns to his Florida hometown to investigate a case involving a death row inmate.,45.0,Lee Daniels,The Paperboy,2012,107,USA, 12500000,693286,1353868,660582,-11146132,0
61427,75.0,"Comedy, Drama",Four couples meet for Sunday brunch only to discover they are stuck in a house together as the world may be about to end.,57.0,Todd Berger,It's a Disaster,2012,88,USA, 500000,60818,60818,0,-439182,0
61059,18.0,Drama,A scheduling mistake leads to an estranged father and son sharing a vacation home with their respective girlfriends.,51.0,Brian Savelson,In Our Nature,2012,103,USA, 1000000,6543,6543,0,-993457,0
62321,257.0,"Horror, Mystery, Thriller","It has been five years since the disappearance of Katie and Hunter, and a suburban family witness strange events in their neighborhood when a woman and a mysterious child move in.",40.0,"Henry Joost, Ariel Schulman",Paranormal Activity 4,2012,88,USA, 5000000,53885000,142802657,88917657,137802657,1
55420,185.0,"Comedy, Crime, Thriller",A pair of aging stickup men try to get the old gang back together for one last hurrah before one of the guys takes his last assignment - to kill his comrade.,41.0,Fisher Stevens,Stand Up Guys,2012,95,USA, 15000000,3310031,5072654,1762623,-9927346,0
52556,386.0,"Animation, Comedy, Family","When a boy's beloved dog passes away suddenly, he attempts to bring the animal back to life through a powerful science experiment.",74.0,Tim Burton,Frankenweenie,2012,87,USA, 39000000,35291068,81491068,46200000,42491068,1
60239,217.0,"Drama, Mystery, Romance",A writer at the peak of his literary success discovers the steep price he must pay for stealing another man's work.,37.0,"Brian Klugman, Lee Sternthal",The Words,2012,102,USA, 6000000,11494838,13231461,1736623,7231461,1
59709,38.0,"Drama, Music","A look at the New York City punk-rock scene and the venerable nightclub, CBGB.",30.0,Randall Miller,CBGB,2013,102,USA, 5000000,40400,40400,0,-4959600,0
60799,287.0,"Crime, Drama, Horror","When a veteran 911 operator takes a life-altering call from a teenage girl who has just been abducted, she realizes that she must confront a killer from her past in order to save the girl's life.",51.0,Brad Anderson,The Call,2013,94,USA, 13000000,51872378,68572378,16700000,55572378,1
61612,260.0,"Comedy, Crime, Drama",Mild mannered businessman Sandy Patterson travels from Denver to Florida to confront the deceptively harmless looking woman who has been living it up after stealing Sandy's identity.,35.0,Seth Gordon,Identity Thief,2013,111,USA, 35000000,134506920,173965010,39458090,138965010,1
64476,204.0,"Horror, Thriller","A news team trails a man as he travels into the world of Eden Parish to find his missing sister, where it becomes apparent that this paradise may not be as it seems.",49.0,Ti West,The Sacrament,2013,99,USA, 4000000,9221,9221,0,-3990779,0
67226,160.0,Comedy,"86-year-old Irving Zisman takes a trip from Nebraska to North Carolina to take his 8 year-old grandson, Billy, back to his real father.",54.0,Jeff Tremaine,Bad Grandpa,2013,92,USA, 15000000,102003019,151826547,49823528,136826547,1
64473,243.0,"Crime, Drama","An ex-con, who is the unlikeliest of role models, meets a 15-year-old boy and is faced with the choice of redemption or ruin.",74.0,David Gordon Green,Joe,2013,117,USA, 4000000,373375,2431443,2058068,-1568557,0
61585,365.0,"Action, Adventure, Drama","After a collision with a shipping container at sea, a resourceful sailor finds himself, despite all efforts to the contrary, staring his mortality in the face.",87.0,J.C. Chandor,All Is Lost,2013,106,USA, 9000000,6263670,13627519,7363849,4627519,1
59622,15.0,"Drama, Romance",A billionaire with questionable priorities re-examines his life after discovering his grandfather's journal.,19.0,Michael Landon Jr.,The Ultimate Life,2013,105,USA, 3100000,1327841,1327841,0,-1772159,0
64775,42.0,Drama,"In 1985, a gay dance understudy hopes for his on-stage chance while fearing the growing AIDS epidemic.",70.0,Chris Mason Johnson,Test,2013,89,USA, 250000,18823,18823,0,-231177,0
60944,138.0,"Comedy, Drama, Romance",A long-divorced couple fakes being married as their family unites for a wedding.,28.0,Justin Zackham,The Big Wedding,2013,89,USA, 35000000,21819348,46519348,24700000,11519348,1
64748,277.0,"Action, Comedy, Crime",An uptight FBI Special Agent is paired with a foul-mouthed Boston cop to take down a ruthless drug lord.,60.0,Paul Feig,The Heat,2013,117,USA, 43000000,159582188,229930771,70348583,186930771,1
65024,53.0,"Drama, Romance","A wild teenage girl orchestrates a romance between her nanny and her father, who is a recovering addict.",59.0,Liza Johnson,Hateship Loveship,2013,104,USA, 5000000,54030,83008,28978,-4916992,0
64565,240.0,"Comedy, Drama, Romance",A divorced woman who decides to pursue the man she's interested in learns he's her new friend's ex-husband.,78.0,Nicole Holofcener,Enough Said,2013,93,USA, 8000000,17550872,25288872,7738000,17288872,1
59269,45.0,"Action, Comedy, Crime","An anthology of stories involving meth addicted white supremacists, a man looking for his kidnapped wife and an Elvis impersonator.",26.0,Wayne Kramer,Pawn Shop Chronicles,2013,112,USA, 5000000,8088,10080,1992,-4989920,0
64551,201.0,"Comedy, Crime, Drama",A scheming couple put a struggling family man and his old friend through a series of increasingly twisted dares over the course of an evening at a local bar.,63.0,E.L. Katz,Cheap Thrills,2013,88,USA, 200000,59424,59424,0,-140576,0
65635,25.0,"Comedy, Drama, Romance",Madea dispenses her unique form of holiday spirit on rural town when she's coaxed into helping a friend pay her daughter a surprise visit in the country for Christmas.,28.0,Tyler Perry,A Madea Christmas,2013,100,USA, 25000000,52543354,53396354,853000,28396354,1
59155,334.0,"Action, Adventure, Fantasy","Young Ender Wiggin is recruited by the International Military to lead the fight against the Formics, an insectoid alien race who had previously tried to invade Earth and had inflicted heavy losses on humankind.",51.0,Gavin Hood,Ender's Game,2013,114,USA, 110000000,61737191,125537191,63800000,15537191,1
64521,256.0,"Horror, Sci-Fi, Thriller","As the Barrett family's peaceful suburban life is rocked by an escalating series of disturbing events, they come to learn that a terrifying and deadly force is after them, one which may have arrived from beyond the stars.",50.0,Scott Stewart,Dark Skies,2013,97,USA, 3500000,17418667,26421747,9003080,22921747,1
59468,99.0,"Comedy, Romance","Feeling pressured to become more sexually experienced before she goes to college, Brandy Klark makes a list of things to accomplish before hitting campus in the fall.",61.0,Maggie Carey,The To Do List,2013,104,USA, 1500000,3491669,3566225,74556,2066225,1
64753,12.0,Drama,An Upstate New York family is torn apart during the American Civil War.,34.0,Ron Maxwell,Copperhead,2013,120,USA, 12000000,171740,171740,0,-11828260,0
59092,286.0,"Comedy, Drama","Shy 14-year-old Duncan goes on summer vacation with his mother, her overbearing boyfriend, and her boyfriend's daughter. Having a rough time fitting in, Duncan finds an unexpected friend in Owen, manager of the Water Wizz water park.",68.0,"Nat Faxon, Jim Rash",The Way Way Back,2013,103,USA, 5000000,21506546,23198652,1692106,18198652,1
64540,355.0,"Horror, Mystery","A woman tries to exonerate her brother, who was convicted of murder, by proving that the crime was committed by a supernatural phenomenon.",61.0,Mike Flanagan,Oculus,2013,104,USA, 5000000,27695246,44043910,16348664,39043910,1
60872,82.0,"Drama, History, Thriller","The haunted Captain of a Soviet submarine holds the fate of the world in his hands. Forced to leave his family behind, he is charged with leading a covert mission cloaked in mystery.",40.0,Todd Robinson,Phantom,2013,98,USA, 18000000,1034589,1197759,163170,-16802241,0
60213,55.0,"Drama, Thriller","A troubled girl becomes preoccupied with her mysterious new neighbor, who bears a striking resemblance to her dead mother.",41.0,Francesca Gregorini,The Truth About Emanuel,2013,95,USA, 1300000,4404,4404,0,-1295596,0
59867,53.0,Drama,Based on the classic novel by,50.0,James Franco,As I Lay Dying,2013,110,USA, 5000000,16697,71759,55062,-4928241,0
63704,432.0,"Animation, Adventure, Comedy","When the newly-crowned Queen Elsa accidentally uses her power to turn things into ice to curse her home in infinite winter, her sister Anna teams up with a mountain man, his playful reindeer, and a snowman to change the weather condition.",74.0,"Chris Buck, Jennifer Lee",Frozen,2013,102,USA, 150000000,400738009,1274219009,873481000,1124219009,1
63691,169.0,"Drama, Thriller","When Christian, an LA trust-fund kid with casual ties to Hollywood, learns of a secret affair between Tara and the lead of his film project, Ryan, he spirals out of control, and his cruel mind games escalate into an act of bloody violence.",36.0,Paul Schrader,The Canyons,2013,99,USA, 250000,56825,270185,213360,20185,1
59932,152.0,"Comedy, Drama, Romance",A Princeton admissions officer who is up for a major promotion takes a professional risk after she meets a college-bound alternative school kid who just might be the son she gave up years ago in a secret adoption.,48.0,Paul Weitz,Admission,2013,107,USA, 13000000,18007317,18637201,629884,5637201,1
59966,365.0,"Action, Adventure, Drama","A crash landing leaves Kitai Raige and his father Cypher stranded on Earth, a millennium after events forced humanity's escape. With Cypher injured, Kitai must embark on a perilous journey to signal for help.",33.0,M. Night Shyamalan,After Earth,2013,100,USA, 130000000,60522097,243611982,183089885,113611982,1
63564,9.0,"Drama, Romance",A womanizing husband inadvertently falls back in love with his wife over the phone when she pretends to be another woman.,31.0,Kees Van Oostrum,A Perfect Man,2013,95,USA, 5000000,7117,14147,7030,-4985853,0
63330,131.0,"Comedy, Fantasy","Malcolm and Kisha move into their dream home, but soon learn a demon also resides there. When Kisha becomes possessed, Malcolm - determined to keep his sex life on track - turns to a priest, a psychic, and a team of ghost-busters for help.",20.0,Michael Tiddes,A Haunted House,2013,86,USA, 2500000,40041683,60141683,20100000,57641683,1
62233,222.0,"Action, Crime, Drama","In New York City, a crime lord's right-hand man is helped by a woman seeking retribution.",39.0,Niels Arden Oplev,Dead Man Down,2013,118,USA, 30000000,10895295,18074539,7179244,-11925461,0
61102,240.0,"Drama, Romance",1921. An innocent immigrant woman is tricked into a life of burlesque and vaudeville until a dazzling magician tries to save her and reunite her with her sister who is being held in the confines of Ellis Island.,77.0,James Gray,The Immigrant,2013,120,USA, 16000000,2025328,5867686,3842358,-10132314,0
63253,251.0,Comedy,"Two salesmen whose careers have been torpedoed by the digital age find their way into a coveted internship at Google, where they must compete with a group of young, tech-savvy geniuses for a shot at employment.",42.0,Shawn Levy,The Internship,2013,119,USA, 58000000,44672764,93492844,48820080,35492844,1
60447,167.0,"Animation, Adventure, Comedy",A freak accident might just help an everyday garden snail achieve his biggest dream: winning the Indy 500.,58.0,David Soren,Turbo,2013,96,USA, 135000000,83028128,282570682,199542554,147570682,1
63213,374.0,"Comedy, Drama, Romance","A New Jersey guy dedicated to his family, friends, and church, develops unrealistic expectations from watching porn and works to find happiness and intimacy with his potential true love.",66.0,Joseph Gordon-Levitt,Don Jon,2013,90,USA, 3000000,24477704,28277704,3800000,25277704,1
63169,47.0,"Thriller, Western","In the late 1800s, a fanatical religious leader, a renegade Sheriff, and a former prostitute collide in a blood triangle on the rugged plains of the New Mexico Territory.",38.0,"Logan Miller, Noah Miller",Sweetwater,2013,95,USA, 7000000,6147,6147,0,-6993853,0
60021,444.0,"Adventure, Comedy, Drama","An aging, booze-addled father makes the trip from Montana to Nebraska with his estranged son in order to claim a million-dollar Mega Sweepstakes Marketing prize.",86.0,Alexander Payne,Nebraska,2013,115,USA, 12000000,17654912,27682872,10027960,15682872,1
62687,124.0,"Comedy, Drama",A spelling bee loser sets out to exact revenge by finding a loophole and attempting to win as an adult.,57.0,Jason Bateman,Bad Words,2013,89,USA, 10000000,7779614,7804337,24723,-2195663,0
60069,3.0,Comedy,"Follow actor J Kimball as he researches what it's like to be old for a role in an upcoming movie. When he meets the residents at The Coconuts convalescent home, he quickly discovers that ...",9.0,Michelle Schumacher,3 Geezers!,2013,81,USA, 1000000,4175,4175,0,-995825,0
60386,188.0,"Adventure, Family, Fantasy","In order to restore their dying safe haven, the son of Poseidon and his friends embark on a quest to the Sea of Monsters, to find the mythical Golden Fleece, all the while trying to stop an ancient evil from rising.",39.0,Thor Freudenthal,Percy Jackson: Sea of Monsters,2013,106,USA, 90000000,68559554,199850315,131290761,109850315,1
62964,197.0,"Comedy, Drama",Two highway road workers spend the summer of 1988 away from their city lives. The isolated landscape becomes a place of misadventure as the men find themselves at odds with each other and the women they left behind.,73.0,David Gordon Green,Prince Avalanche,2013,94,USA, 725000,205139,442313,237174,-282687,0
62925,138.0,Comedy,"After moving his family back to his hometown to be with his friends and their kids, Lenny finds out that between old bullies, new bullies, schizo bus drivers, drunk cops on skis, and four hundred costumed party crashers sometimes crazy follows you.",19.0,Dennis Dugan,Grown Ups 2,2013,101,USA, 80000000,133668525,246984278,113315753,166984278,1
62718,109.0,Music,"Trip, a young roadie for Metallica, is sent on an urgent mission during the band's show. But what seems like a simple assignment turns into a surreal adventure.",61.0,Nimr√≥d Antal,Metallica Through the Never,2013,93,USA, 18000000,3419967,7972967,4553000,-10027033,0
63771,378.0,"Action, Thriller",Disgraced Secret Service agent Mike Banning finds himself trapped inside the White House in the wake of a terrorist attack and works with national security to rescue the President from his kidnappers.,41.0,Antoine Fuqua,Olympus Has Fallen,2013,119,USA, 70000000,98925640,170270201,71344561,100270201,1
63840,214.0,"Action, Thriller","A former DEA agent moves his family to a quiet town, where he soon tangles with a local meth druglord.",40.0,Gary Fleder,Homefront,2013,100,USA, 22000000,20158898,43058898,22900000,21058898,1
61321,515.0,"Action, Adventure, Fantasy","When the Dark Elves attempt to plunge the universe into darkness, Thor must embark on a perilous and personal journey that will reunite him with doctor Jane Foster.",54.0,Alan Taylor,Thor: The Dark World,2013,112,USA, 170000000,206362140,644783140,438421000,474783140,1
64299,187.0,"Crime, Thriller","When a poor college student who cracks an online poker game goes bust, he arranges a face-to-face with the man he thinks cheated him, a sly offshore entrepreneur.",36.0,Brad Furman,Runner Runner,2013,88,USA, 30000000,19316646,62675095,43358449,32675095,1
60756,228.0,"Action, Crime, Thriller","A thief with a unique code of professional ethics is double-crossed by his crew and left for dead. Assuming a new disguise and forming an unlikely alliance with a woman on the inside, he looks to hijack the score of the crew's latest heist.",42.0,Taylor Hackford,Parker,2013,118,USA, 35000000,17616641,46216641,28600000,11216641,1
61775,462.0,"Crime, Drama, Mystery",A young woman's world unravels when a drug prescribed by her psychiatrist has unexpected side effects.,75.0,Steven Soderbergh,Side Effects,2013,106,USA, 30000000,32172757,63372757,31200000,33372757,1
64133,141.0,"Drama, History, Mystery",A recounting of the chaotic events that occurred at Dallas' Parkland Hospital on the day U.S. President,51.0,Peter Landesman,Parkland,2013,93,USA, 10000000,653651,1412181,758530,-8587819,0
61210,221.0,"Drama, Romance","Depressed single mom Adele and her son Henry offer a wounded, fearsome man a ride. As police search town for the escaped convict, the mother and son gradually learn his true story as their options become increasingly limited.",52.0,Jason Reitman,Labor Day,2013,111,USA, 18000000,13371528,20275812,6904284,2275812,1
61020,373.0,"Drama, Horror","A shy girl, outcasted by her peers and sheltered by her religious mother, unleashes telekinetic terror on her small town after being pushed too far at her senior prom.",53.0,Kimberly Peirce,Carrie,2013,100,USA, 30000000,35266619,84790678,49524059,54790678,1
60233,61.0,"Drama, Mystery, Romance",A widow falls for a guy who bears a striking resemblance to her late husband.,51.0,Arie Posin,The Face of Love,2013,92,USA, 4000000,350006,1806548,1456542,-2193452,0
64060,351.0,"Action, Drama, Thriller","While on a tour of the White House with his young daughter, a Capitol policeman springs into action to save his child and protect the president from a heavily armed group of paramilitary invaders.",52.0,Roland Emmerich,White House Down,2013,131,USA, 150000000,73103784,205366737,132262953,55366737,1
62067,58.0,"Comedy, Drama","When college friends reunite after 15 years over the Christmas holidays, they discover just how easy it is for long-forgotten rivalries and romances to be reignited.",59.0,Malcolm D. Lee,The Best Man Holiday,2013,123,USA, 17000000,70525195,72835710,2310515,55835710,1
61106,520.0,"Action, Adventure, Sci-Fi",Katniss Everdeen and Peeta Mellark become targets of the Capitol after their victory in the 74th Hunger Games sparks a rebellion in the Districts of Panem.,76.0,Francis Lawrence,The Hunger Games: Catching Fire,2013,146,USA, 130000000,424668047,865011746,440343699,735011746,1
59788,13.0,"Drama, Family, History",Drama about the friendship between an Oxford-educated Southerner and a former black slave in turn-of-the-century Savannah.,25.0,Annette Haywood-Carter,Savannah,2013,101,USA, 5000000,37240,37240,0,-4962760,0
59802,35.0,Drama,"Martin Bonner has just moved to Nevada from the East Coast, leaving behind his two adult children and a life he spent more than two decades building.",71.0,Chad Hartigan,This Is Martin Bonner,2013,83,USA, 42000,13888,13888,0,-28112,0
59806,600.0,"Drama, Romance, Sci-Fi","In a near future, a lonely writer develops an unlikely relationship with an operating system designed to meet his every need.",90.0,Spike Jonze,Her,2013,126,USA, 23000000,25568251,47351251,21783000,24351251,1
61307,345.0,"Comedy, Crime, Drama",A trio of bodybuilders in Florida get caught up in an extortion ring and a kidnapping scheme that goes terribly wrong.,45.0,Michael Bay,Pain & Gain,2013,129,USA, 26000000,49875291,86175291,36300000,60175291,1
61311,291.0,"Comedy, Drama, Music","A chance encounter between a disgraced music-business executive and a young singer-songwriter, new to Manhattan, turns into a promising collaboration between the two talents.",62.0,John Carney,Begin Again,2013,104,USA, 8000000,16170632,63464861,47294229,55464861,1
61350,180.0,"Animation, Adventure, Comedy","Flint Lockwood now works at The Live Corp Company for his idol Chester V. But he's forced to leave his post when he learns that his most infamous machine is still operational, and is churning out menacing food-animal hybrids.",59.0,"Cody Cameron, Kris Pearn",Cloudy with a Chance of Meatballs 2,2013,95,USA, 78000000,119793567,274325949,154532382,196325949,1
64059,439.0,Drama,"A New York socialite, deeply troubled and in denial, arrives in San Francisco to impose upon her sister. She looks a million, but isn't bringing money, peace, or love...",78.0,Woody Allen,Blue Jasmine,2013,98,USA, 18000000,33405481,97505481,64100000,79505481,1
61105,332.0,"Comedy, Crime","When one of their own is kidnapped by an angry gangster, the Wolf Pack must track down Mr. Chow, who has escaped from prison and is on the run.",30.0,Todd Phillips,The Hangover Part III,2013,100,USA, 103000000,112200072,362000072,249800000,259000072,1
59815,553.0,"Crime, Drama","A con man, Irving Rosenfeld, along with his seductive partner Sydney Prosser, is forced to work for a wild F.B.I. Agent, Richie DiMaso, who pushes them into a world of Jersey powerbrokers and the Mafia.",90.0,David O. Russell,American Hustle,2013,138,USA, 40000000,150117807,251171807,101054000,211171807,1
62082,273.0,"Drama, Sci-Fi","A man and woman are drawn together, entangled in the life cycle of an ageless organism. Identity becomes an illusion as they struggle to assemble the loose fragments of wrecked lives.",81.0,Shane Carruth,Upstream Color,2013,96,USA, 50000,444098,587174,143076,537174,1
64052,322.0,"Biography, Drama, Romance","The story of Oscar Grant III, a 22-year-old Bay Area resident, who crosses paths with friends, enemies, family, and strangers on the last day of 2008.",85.0,Ryan Coogler,Fruitvale Station,2013,85,USA, 900000,16101339,17385830,1284491,16485830,1
63888,75.0,"Comedy, Horror",An expectant couple who moves into the most haunted house in New Orleans call upon the services of the Vatican's elite exorcism team to save them from a demonic baby.,41.0,"Robert Ben Garant, Thomas Lennon",Hell Baby,2013,98,USA, 2500000,8785,8785,0,-2491215,0
64431,10.0,Comedy,"""Cavemen"" is a comedic film with a slight edge of drama revolving around the lives of somewhat single, somewhat unemployed guys living in a warehouse converted to living quarters in the '...",19.0,Herschel Faber,Cavemen,2013,88,USA, 1200000,5948,5948,0,-1194052,0
63222,32.0,Drama,"A man surprises his former mistress by claiming to have left his wife. However, before long, a dark history between the two comes into focus.",54.0,Neil LaBute,Some Velvet Morning,2013,84,USA, 2000000,6420,6420,0,-1993580,0
58761,41.0,"Comedy, Romance",Sparks fly when Wade Walker crashes the Peeples annual reunion in the Hamptons to ask for their precious daughter Grace's hand in marriage.,52.0,Tina Gordon,Peeples,2013,95,USA, 15000000,9177065,9307065,130000,-5692935,0
58920,230.0,"Comedy, Drama, Romance","A hard-partying high school senior's philosophy on life changes when he meets the not-so-typical ""nice girl.""",82.0,James Ponsoldt,The Spectacular Now,2013,95,USA, 2500000,6854611,6918591,63980,4418591,1
54751,428.0,"Action, Crime, Drama","It's 1949 Los Angeles, the city is run by gangsters and a malicious mobster, Mickey Cohen. Determined to end the corruption, John O'Mara assembles a team of cops, ready to take down the ruthless leader and restore peace to the city.",40.0,Ruben Fleischer,Gangster Squad,2013,113,USA, 60000000,46000903,105200903,59200000,45200903,1
54755,316.0,"Comedy, Drama","A look at the lives of the strong-willed women of the Weston family, whose paths have diverged until a family crisis brings them back to the Oklahoma house they grew up in, and to the dysfunctional woman who raised them.",58.0,John Wells,August: Osage County,2013,121,USA, 25000000,37738810,74188937,36450127,49188937,1
54821,309.0,"Biography, Drama","As Cecil Gaines serves eight presidents during his tenure as a butler at the White House, the civil rights movement, Vietnam, and other major events affect this man's life, family, and American society.",66.0,Lee Daniels,The Butler,2013,132,USA, 30000000,116632095,176598908,59966813,146598908,1
54896,185.0,Comedy,A series of interconnected short films follows a washed-up producer as he pitches insane story lines featuring some of the biggest stars in Hollywood.,18.0,"Elizabeth Banks, Steven Brill",Movie 43,2013,94,USA, 6000000,8840453,32443111,23602658,26443111,1
55457,488.0,"Crime, Drama, Mystery","When Keller Dover's daughter and her friend go missing, he takes matters into his own hands as the police pursue multiple leads and the pressure mounts.",74.0,Denis Villeneuve,Prisoners,2013,153,USA, 46000000,61002302,122126687,61124385,76126687,1
55595,616.0,"Action, Adventure, Sci-Fi","After the crew of the Enterprise find an unstoppable force of terror from within their own organization, Captain Kirk leads a manhunt to a war-zone world to capture a one-man weapon of mass destruction.",72.0,J.J. Abrams,Star Trek Into Darkness,2013,132,USA, 190000000,228778661,467365246,238586585,277365246,1
55765,43.0,"Drama, Family, Music","A street-wise teen from Baltimore who has been raised by a single mother travels to New York City to spend the Christmas holiday with his estranged relatives, where he embarks on a surprising and inspirational journey.",48.0,Kasi Lemmons,Black Nativity,2013,93,USA, 17500000,7018189,7454185,435996,-10045815,0
55773,251.0,"Biography, Drama",The story of,51.0,"Rob Epstein, Jeffrey Friedman",Lovelace,2013,93,USA, 10000000,356582,1585582,1229000,-8414418,0
56073,389.0,"Animation, Adventure, Comedy",A look at the relationship between Mike and Sulley during their days at Monsters University -- when they weren't necessarily the best of friends.,65.0,Dan Scanlon,Monsters University,2013,104,USA, 200000000,268492764,743559607,475066843,543559607,1
56123,555.0,"Horror, Mystery, Thriller",Paranormal investigators Ed and Lorraine Warren work to help a family terrorized by a dark presence in their farmhouse.,68.0,James Wan,The Conjuring,2013,112,USA, 20000000,137400141,319494638,182094497,299494638,1
56178,13.0,Drama,"Love, science, sex, infidelity, disease and comedy, the wild, mostly true story of the irrepressible Annie Parker and the almost discovery of a cure for cancer.",56.0,Steven Bernstein,Decoding Annie Parker,2013,91,USA, 2000000,48390,60048,11658,-1939952,0
56358,557.0,"Action, Adventure, Sci-Fi",A veteran assigned to extract Earth's remaining resources begins to question what he knows about his mission and himself.,54.0,Joseph Kosinski,Oblivion,2013,124,USA, 120000000,89107235,286168572,197061337,166168572,1
56360,65.0,"Comedy, Romance",Two parents fall in love over the course of a single day while playing hooky from their children's college tour.,60.0,Adam Rodgers,At Middleton,2013,99,USA, 2500000,53837,82993,29156,-2417007,0
56387,5.0,"Crime, Drama, History","When a series of package bombs show up on the doorsteps of prominent politicians and businessmen in the summer of 1919, U.S. Bureau of Investigation Agent William Flynn (Strathairn) is ...",48.0,Terry Green,"No God, No Master",2013,94,USA, 6000000,6796,6796,0,-5993204,0
56903,1.0,"Action, Crime, Thriller","Four friends from the rough side of town grow apart when two are consumed by a life of crime, and the other two become FBI agents sent deep undercover - to bring down those childhood friends.",24.0,Bryan Ramirez,Line of Duty,2013,100,USA, 2500000,54204,54204,0,-2445796,0
56906,64.0,"Drama, Music","Battle of the Year attracts all the best teams from around the world, but the Americans haven't won in fifteen years. Dante enlists Blake to assemble a team of the best dancers and bring the Trophy back to America where it started.",29.0,Benson Lee,Battle of the Year,2013,110,USA, 20000000,8888355,16549477,7661122,-3450523,0
56937,497.0,"Action, Drama, Sci-Fi","In the year 2154, the very wealthy live on a man-made space station while the rest of the population resides on a ruined Earth. A man takes on a mission that could bring equality to the polarized worlds.",61.0,Neill Blomkamp,Elysium,2013,109,USA, 115000000,93050117,286140700,193090583,171140700,1
56938,505.0,"Biography, Drama, Thriller","The true story of Captain Richard Phillips and the 2009 hijacking by Somali pirates of the U.S.-flagged MV Maersk Alabama, the first American cargo ship to be hijacked in two hundred years.",83.0,Paul Greengrass,Captain Phillips,2013,134,USA, 55000000,107100855,218791811,111690956,163791811,1
57090,385.0,"Action, Thriller","The leader of a drug cartel busts out of a courthouse and speeds to the Mexican border, where the only thing in his path is a sheriff and his inexperienced staff.",54.0,Jee-woon Kim,The Last Stand,2013,107,USA, 45000000,12050299,48330757,36280458,3330757,1
57166,212.0,"Drama, Fantasy, Romance","Ethan longs to escape his small Southern town. He meets a mysterious new girl, Lena. Together, they uncover dark secrets about their respective families, their history and their town.",52.0,Richard LaGravenese,Beautiful Creatures,2013,124,USA, 60000000,19452138,60052138,40600000,52138,1
54746,260.0,"Action, Drama, Mystery","Obsessed with vengeance, a man sets out to find out why he was kidnapped and locked into solitary confinement for twenty years without reason.",49.0,Spike Lee,Oldboy,2013,104,USA, 30000000,2193658,4861022,2667364,-25138978,0
54491,639.0,"Action, Adventure, Sci-Fi","When Tony Stark's world is torn apart by a formidable terrorist called the Mandarin, he starts an odyssey of rebuilding and retribution.",62.0,Shane Black,Iron Man Three,2013,130,USA, 200000000,409013994,1214811252,805797258,1014811252,1
54219,7.0,"Comedy, Romance","After being abandoned at the altar, Jason courts the girl of his dreams in cyberspace. When she arrives in LA for their wedding, she turns out to be completely different than expected.",42.0,Christine Yoo,Wedding Palace,2013,98,USA, 1000000,19908,27183,7275,-972817,0
48465,259.0,Comedy,"A veteran Vegas magician tries to revive his career after his longtime partner quits, he gets fired from his casino act, and an edgy new ""street magician"" steals his thunder.",44.0,Don Scardino,The Incredible Burt Wonderstone,2013,100,USA, 30000000,22537881,27437881,4900000,-2562119,0
48466,488.0,"Biography, Drama","In 1985 Dallas, electrician and hustler Ron Woodroof works around the system to help AIDS patients get the medication they need after he is diagnosed with the disease.",84.0,Jean-Marc Vall√©e,Dallas Buyers Club,2013,117,USA, 5000000,27298285,55198285,27900000,50198285,1
48480,212.0,"Action, Adventure, Comedy",A recently slain cop joins a team of undead police officers working for the Rest in Peace Department and tries to find the man who murdered him.,25.0,Robert Schwentke,R.I.P.D.,2013,96,USA, 130000000,33618855,78324220,44705365,-51675780,0
49421,208.0,"Animation, Adventure, Family",A teenager finds herself transported to a deep forest setting where a battle between the forces of good and the forces of evil is taking place. She bands together with a rag-tag group of characters in order to save their world -- and ours.,52.0,Chris Wedge,Epic,2013,102,USA, 100000000,107518682,268426634,160907952,168426634,1
48541,157.0,Comedy,"A couple begin to experience some unusual activity after bringing their lost nieces and nephew home. With the help of home-surveillance cameras, they learn they're being stalked by a nefarious demon.",11.0,"Malcolm D. Lee, David Zucker",Scary Movie 5,2013,86,USA, 20000000,32015787,78378744,46362957,58378744,1
47378,268.0,"Animation, Action, Adventure","After their cave is destroyed, a caveman family must trek through an unfamiliar fantastical world with the help of an inventive boy.",55.0,"Kirk DeMicco, Chris Sanders",The Croods,2013,98,USA, 135000000,187168425,587204668,400036243,452204668,1
50775,638.0,"Biography, Crime, Drama",Based on the true story of,75.0,Martin Scorsese,The Wolf of Wall Street,2013,180,USA, 100000000,116900694,392000694,275100000,292000694,1
46096,220.0,"Biography, Drama, Sport","In 1947,",62.0,Brian Helgeland,42,2013,128,USA, 40000000,95020213,97470701,2450488,57470701,1
51995,344.0,"Action, Biography, Drama","Marcus Luttrell and his team set out on a mission to capture or kill notorious Taliban leader Ahmad Shah, in late June 2005. Marcus and his team are left to fight for their lives in one of the most valiant efforts of modern warfare.",60.0,Peter Berg,Lone Survivor,2013,121,USA, 40000000,125095601,154802912,29707311,114802912,1
52834,54.0,"Comedy, Romance","Pledging to keep herself from being the oldest and the only woman in her entire family never to wed, Montana embarks on a thirty-day, thirty-thousand-mile expedition to charm a potential suitor into becoming her fianc√©.",34.0,David E. Talbert,Baggage Claim,2013,96,USA, 8500000,21569509,22456509,887000,13956509,1
53258,228.0,"Comedy, Drama",Four friends take a break from their day-to-day lives to throw a bachelor party in Las Vegas for their last remaining single pal.,48.0,Jon Turteltaub,Last Vegas,2013,105,USA, 28000000,63914167,134409025,70494858,106409025,1
53330,464.0,"Action, Adventure, Comedy","Native American warrior Tonto recounts the untold tales that transformed John Reid, a man of the law, into a legend of justice.",37.0,Gore Verbinski,The Lone Ranger,2013,150,USA, 215000000,89302115,260502115,171200000,45502115,1
53336,301.0,"Action, Thriller","When a structural-security authority finds himself set up and incarcerated in the world's most secret and secure prison, he has to use his skills to escape with help from the inside.",49.0,Mikael H√•fstr√∂m,Escape Plan,2013,115,USA, 50000000,25135965,137328301,112192336,87328301,1
53556,277.0,Comedy,"With the 1970s behind them, San Diego's top-rated newsman, Ron Burgundy, returns to take New York City's first twenty-four-hour news channel by storm.",61.0,Adam McKay,Anchorman 2: The Legend Continues,2013,119,USA, 50000000,127352707,173649931,46297224,123649931,1
53687,300.0,"Crime, Drama, Thriller","In a city rife with injustice, ex-cop Billy Taggart seeks redemption and revenge after being double-crossed and then framed by its most powerful figure: Mayor Nicholas Hostetler.",49.0,Allen Hughes,Broken City,2013,109,USA, 35000000,19701164,34737199,15036035,-262801,0
53828,408.0,Comedy,"6 Los Angeles celebrities are stuck in James Franco's house after a series of devastating events just destroyed the city. Inside, the group not only have to face the apocalypse, but themselves.",67.0,"Evan Goldberg, Seth Rogen",This Is the End,2013,107,USA, 32000000,101470202,126041322,24571120,94041322,1
54128,274.0,"Action, Comedy, Thriller","Two hardened criminals get into trouble with the US border patrol after meeting with a Mexican drug lord, and then revelations start to unfold.",55.0,Baltasar Korm√°kur,2 Guns,2013,109,USA, 61000000,75612460,131940411,56327951,70940411,1
51677,41.0,"Comedy, Drama","A naive college graduate, Amy, who believes she's destined to be a great poet, begrudgingly accepts a job in a shop while she pursues a mentorship with reclusive writer Rat Billings.",61.0,Scott Coffey,Adult World,2013,97,USA, 4000000,25368,37887,12519,-3962113,0
57443,357.0,"Action, Adventure, Sci-Fi",The G.I. Joes are not only fighting their mortal enemy Cobra; they are forced to contend with threats from within the government that jeopardize their very existence.,41.0,Jon M. Chu,G.I. Joe: Retaliation,2013,110,USA, 130000000,122523060,375740705,253217645,245740705,1
54331,562.0,"Fantasy, Horror, Thriller","Five friends head to a remote cabin, where the discovery of a Book of the Dead leads them to unwittingly summon up demons living in the nearby woods.",57.0,Fede Alvarez,Evil Dead,2013,91,USA, 17000000,54239856,97542952,43303096,80542952,1
58319,92.0,"Comedy, Crime",Two common criminals get more than they bargained for after kidnapping the wife of a corrupt real-estate developer who shows no interest in paying the $1 million dollar ransom for her safe return.,60.0,Daniel Schechter,Life of Crime,2013,98,USA, 12000000,265452,1456675,1191223,-10543325,0
58301,225.0,"Comedy, Drama, Sport","A pair of aging boxing rivals are coaxed out of retirement to fight one final bout, thirty years after their last match.",35.0,Peter Segal,Grudge Match,2013,113,USA, 40000000,29807260,44907260,15100000,4907260,1
58275,68.0,Drama,"A pregnant teenager flees her abusive mother in search of her father, only to be rejected by her stepmother and forced to survive on the streets until a compassionate stranger offers a hopeful alternative.",37.0,Ron Krauss,Gimme Shelter,2013,101,USA, 2000000,1359910,1362018,2108,-637982,0
58331,600.0,"Action, Adventure, Sci-Fi","As a war between humankind and monstrous sea creatures wages on, a former pilot and a trainee are paired up to drive a seemingly obsolete special weapon in a desperate effort to save the world from the apocalypse.",65.0,Guillermo del Toro,Pacific Rim,2013,131,USA, 190000000,101802906,411002906,309200000,221002906,1
58670,175.0,"Animation, Adventure, Comedy",A cropdusting plane with a fear of heights lives his dream of competing in a famous around-the-world aerial race.,39.0,Klay Hall,Planes,2013,91,USA, 50000000,90288712,239258712,148970000,189258712,1
57891,540.0,"Adventure, Family, Fantasy","A frustrated circus magician from Kansas is transported to a magical land called Oz, where he will have to fulfill a prophecy to become the king, and release the land from the Wicked Witches using his great (but fake) powers.",44.0,Sam Raimi,Oz the Great and Powerful,2013,130,USA, 215000000,234911825,493311825,258400000,278311825,1
57868,124.0,"Animation, Adventure, Comedy","Two turkeys from opposite sides of the tracks must put aside their differences and team up to travel back in time to change the course of history, and get Turkeys off the Thanksgiving menu for good.",38.0,Jimmy Hayward,Free Birds,2013,91,USA, 55000000,55750480,110387072,54636592,55387072,1
57840,8.0,"Crime, Drama, Romance","Miles Montego (Ja Rule) has it all - cars, boats, good looks, mansion, money, women, but more importantly, he has a past. Miles is a retired high level drug trafficker who is now completely...",23.0,Steve Race,I'm in Love with a Church Girl,2013,118,USA, 5000000,2387730,2503392,115662,-2496608,0
58790,184.0,"Drama, Romance, Thriller","A young woman with a mysterious past lands in Southport, North Carolina where her bond with a widower forces her to confront the dark secret that haunts her.",34.0,Lasse Hallstr√∂m,Safe Haven,2013,115,USA, 28000000,71349120,97594140,26245020,69594140,1
58307,45.0,Horror,A family's journey toward a better life is interrupted by an unstable man of the cloth.,12.0,Anthony Leonardi III,Nothing Left to Fear,2013,100,USA, 3000000,7886,1675381,1667495,-1324619,0
58884,172.0,Comedy,"The night before his big medical school interview, a promising student celebrates his 21st birthday with his two best friends.",34.0,"Jon Lucas, Scott Moore",21 & Over,2013,93,USA, 13000000,25682380,48065672,22383292,35065672,1
64215,165.0,"Animation, Adventure, Comedy","It's a jungle out there for Blu, Jewel and their three kids after they're hurtled from Rio de Janeiro to the wilds of the Amazon. As Blu tries to fit in, he goes beak-to-beak with the vengeful Nigel, and meets his father-in-law.",49.0,Carlos Saldanha,Rio 2,2014,101,USA, 103000000,131538435,498781117,367242682,395781117,1
62278,236.0,"Action, Adventure, Drama","Storm trackers, thrill-seekers, and everyday townspeople document an unprecedented onslaught of tornadoes touching down in the town of Silverton.",44.0,Steven Quale,Into the Storm,2014,89,USA, 50000000,47602194,161502194,113900000,111502194,1
66528,96.0,Drama,"A grieving widower is drawn into a custody battle over his granddaughter, whom he helped raise her entire life.",45.0,Mike Binder,Black or White,2014,121,USA, 9000000,21571189,21833967,262778,12833967,1
66495,548.0,"Crime, Drama, Thriller","When Louis Bloom, a con man desperate for work, muscles into the world of L.A. crime journalism, he blurs the line between observer and participant to become the star of his own story.",76.0,Dan Gilroy,Nightcrawler,2014,117,USA, 8500000,32381217,38697217,6316000,30197217,1
66485,154.0,"Comedy, Drama","A struggling actor, father and husband finds himself at a major crossroads, which forces him to examine his life, his family and his career.",43.0,Zach Braff,Wish I Was Here,2014,106,USA, 6000000,3591299,5483299,1892000,-516701,0
66484,213.0,"Horror, Mystery, Thriller","When a team of explorers ventures into the catacombs that lie beneath the streets of Paris, they uncover the dark secret that lies within this city of the dead.",38.0,John Erick Dowdle,"As Above, So Below",2014,93,USA, 5000000,21321100,41898409,20577309,36898409,1
66360,70.0,"Comedy, Fantasy","Having exorcised the demons of his ex, Malcolm is starting fresh with his new girlfriend and her two children. After moving into their dream home, however, Malcolm is once again plagued by bizarre paranormal events.",17.0,Michael Tiddes,A Haunted House 2,2014,86,USA, 4000000,17329486,23959486,6630000,19959486,1
66276,15.0,"Drama, Mystery, Sci-Fi","In a post-apocalyptic America, the iron fist of the totalitarian government seeks to crush one mysterious man named John Galt, who has the power and influence to change everything..",9.0,James Manera,Atlas Shrugged: Part III,2014,99,USA, 5000000,846704,846704,0,-4153296,0
66236,295.0,"Action, Adventure, Comedy","Dave Skylark and his producer Aaron Rapaport run the celebrity tabloid show ""Skylark Tonight"". When they land an interview with a surprise fan, North Korean dictator",52.0,"Evan Goldberg, Seth Rogen",The Interview,2014,112,USA, 44000000,6105175,11305175,5200000,-32694825,0
66220,163.0,"Comedy, Romance",A comedian tries to make it as a serious actor when his reality television star fianc√©e talks him into broadcasting their wedding on her television show.,81.0,Chris Rock,Top Five,2014,102,USA, 12000000,25317471,26117471,800000,14117471,1
62692,205.0,"Comedy, Crime","Dale, Kurt and Nick decide to start their own business but things don't go as planned because of a slick investor, prompting the trio to pull off a harebrained and misguided kidnapping scheme.",40.0,Sean Anders,Horrible Bosses 2,2014,108,USA, 42000000,54445357,107645357,53200000,65645357,1
62694,269.0,"Comedy, Drama","A young boy whose parents have just divorced finds an unlikely friend and mentor in the misanthropic, bawdy, hedonistic war veteran who lives next door.",64.0,Theodore Melfi,St. Vincent,2014,102,USA, 13000000,44137712,54837234,10699522,41837234,1
66129,26.0,"Adventure, Comedy",A pair of friends embark on a mission to reunite their pal with the woman he was going to marry.,22.0,Scot Armstrong,Search Party,2014,93,USA, 20000000,4571,118263,113692,-19881737,0
62769,518.0,"Action, Biography, Drama","Navy S.E.A.L. sniper Chris Kyle's (Bradley Cooper's) pinpoint accuracy saves countless lives on the battlefield and turns him into a legend. Back home to his wife and kids after four tours of duty, however, Chris finds that it is the war he can't leave behind.",72.0,Clint Eastwood,American Sniper,2014,133,USA, 58800000,350126372,547426372,197300000,488626372,1
62785,341.0,"Adventure, Comedy, Drama",A witch tasks a childless baker and his wife with procuring magical items from classic fairy tales to reverse the curse put on their family tree.,69.0,Rob Marshall,Into the Woods,2014,125,USA, 50000000,128002372,212902372,84900000,162902372,1
62828,45.0,"Drama, Music",A young woman strikes up a relationship with her ailing brother's favorite musician.,48.0,Kate Barker-Froyland,Song One,2014,86,USA, 6000000,32251,408918,376667,-5591082,0
62829,115.0,"Adventure, Family, Sci-Fi","After receiving a bizarre series of encrypted messages, a group of kids embark on an adventure with an alien who needs their help.",53.0,Dave Green,Earth to Echo,2014,91,USA, 13000000,38934842,45336704,6401862,32336704,1
52110,459.0,"Biography, Drama, Sport",U.S. Olympic wrestling champions and brothers,81.0,Bennett Miller,Foxcatcher,2014,134,USA, 24000000,12096300,19206513,7110213,-4793487,0
62259,147.0,"Comedy, Romance","After losing her job and learning that her husband has been unfaithful, a woman hits the road with her profane, hard-drinking grandmother.",39.0,Ben Falcone,Tammy,2014,97,USA, 20000000,84525432,100375432,15850000,80375432,1
66530,319.0,"Adventure, Comedy, Drama","A head chef quits his restaurant job and buys a food truck in an effort to reclaim his creative promise, while piecing back together his estranged family.",68.0,Jon Favreau,Chef,2014,114,USA, 11000000,31424003,45967935,14543932,34967935,1
42347,272.0,"Action, Crime, Drama",Private investigator Matthew Scudder is hired by a drug kingpin to find out who kidnapped and murdered his wife.,57.0,Scott Frank,A Walk Among the Tombstones,2014,114,USA, 28000000,26307600,53181600,26874000,25181600,1
66551,210.0,Drama,A recently unemployed single father struggles to get back his foreclosed home by working for the real estate broker who is the source of his frustration.,76.0,Ramin Bahrani,99 Homes,2014,112,USA, 8000000,1411927,1828232,416305,-6171768,0
61533,59.0,"Action, Crime, Drama",An unstable escaped convict terrorizes a woman who is alone with her two children.,26.0,Sam Miller,No Good Deed,2014,84,USA, 13200000,52543632,54323210,1779578,41123210,1
61570,707.0,"Action, Adventure, Comedy",A group of intergalactic criminals must pull together to stop a fanatical warrior with plans to purge the universe.,76.0,James Gunn,Guardians of the Galaxy,2014,121,USA, 170000000,333176600,772776600,439600000,602776600,1
66806,65.0,"Comedy, Drama","After a break up, Jenny moves in with writer Kelly, her filmmaker husband, and their child. Despite a rocky start, Jenny's influence helps Kelly realize that an evolution in her life, career and relationship is necessary for her happiness.",70.0,Joe Swanberg,Happy Christmas,2014,82,USA, 70000,30312,30312,0,-39688,0
66703,75.0,"Comedy, Drama",A long-time married couple who've spent their lives together in the same New York apartment become overwhelmed by personal and real estate-related issues when they plan to move away.,55.0,Richard Loncraine,5 Flights Up,2014,88,USA, 6000000,1020921,3679847,2658926,-2320153,0
48355,19.0,"Biography, Comedy, Crime",An eighteen year old high school drop out and his twenty-seven year old friend start trafficking marijuana across the border of Canada in order to make money and their lives are changed forever.,54.0,John Stockwell,Kid Cannabis,2014,110,USA, 5000000,5565,5565,0,-4994435,0
61650,125.0,"Comedy, Drama, Romance","In the throes of a quarter-life crisis, Megan panics when her boyfriend proposes, then, taking an opportunity to escape for a week, hides out in the home of her new friend, 16-year-old Annika, who lives with her world-weary single dad.",63.0,Lynn Shelton,Laggies,2014,99,USA, 5000000,1066981,2379154,1312173,-2620846,0
61674,179.0,"Crime, Drama, Thriller","Literature professor and gambler Jim Bennett's debt causes him to borrow money from his mother and a loan shark. Further complicating his situation, is his relationship with one of his students. Will Bennett risk his life for a second chance?",55.0,Rupert Wyatt,The Gambler,2014,111,USA, 25000000,33680992,39280992,5600000,14280992,1
51928,177.0,"Comedy, Romance","After a bad blind date, a man and woman find themselves stuck together at a resort for families, where their attraction grows as their respective kids benefit from the burgeoning relationship.",31.0,Frank Coraci,Blended,2014,117,USA, 40000000,46294610,127994610,81700000,87994610,1
61741,44.0,"Drama, Romance","A reformed frat boy opens an antique store in a college town, and falls for the free-spirited girl who moves into the apartment above his shop. In time, this unlikely pair fall into a traditional courtship..",29.0,Rik Swartzwelder,Old Fashioned,2014,115,USA, 600000,1914090,1914090,0,1314090,1
66655,106.0,"Crime, Drama","A blue collar worker tries to cover things up when his stepson is killed in a suspicious accident, but a local reporter senses that something's amiss.",51.0,John Slattery,God's Pocket,2014,88,USA, 1000000,169976,413567,243591,-586433,0
61812,103.0,"Horror, Thriller","A cryptic phone call sets off a dangerous game of risks for Elliot, a down-on-his luck salesman. The game promises increasing rewards for completing 13 tasks, each more sinister than the last.",44.0,Daniel Stamm,13 Sins,2014,93,USA, 4000000,13809,826913,813104,-3173087,0
48443,230.0,"Animation, Adventure, Comedy",A young orphaned boy raised by underground cave-dwelling trash collectors tries to save his friends from an evil exterminator.,61.0,"Graham Annable, Anthony Stacchi",The Boxtrolls,2014,96,USA, 60000000,50837305,108255770,57418465,48255770,1
53259,202.0,"Horror, Mystery, Thriller",A group of friends must confront their most terrifying fears when they awaken the dark powers of an ancient spirit board.,38.0,Stiles White,Ouija,2014,89,USA, 5000000,50856010,103687316,52831306,98687316,1
66617,447.0,"Action, Crime, Thriller",An ex-hit-man comes out of retirement to track down the gangsters that killed his dog and took everything from him.,68.0,"Chad Stahelski, David Leitch",John Wick,2014,101,USA, 20000000,43037835,86013056,42975221,66013056,1
66612,172.0,"Drama, Mystery, Sci-Fi","On a road trip, Nic and two friends are drawn to an isolated area by a computer genius. When everything suddenly goes dark, Nic regains consciousness - only to find himself in a waking nightmare.",54.0,William Eubank,The Signal,2014,97,USA, 4000000,600896,2595622,1994726,-1404378,0
62205,228.0,Comedy,"20 years since their first adventure, Lloyd and Harry go on a road trip to find Harry's newly discovered daughter, who was given up for adoption.",36.0,"Bobby Farrelly, Peter Farrelly",Dumb and Dumber To,2014,109,USA, 40000000,86208010,169837010,83629000,129837010,1
66554,113.0,Drama,"Left heartbroken by the woman he loved and lost many years ago, Manglehorn, an eccentric small-town locksmith, tries to start his life over again with the help of a new friend.",56.0,David Gordon Green,Manglehorn,2014,97,USA, 4000000,143101,459636,316535,-3540364,0
57476,425.0,"Action, Adventure, Family","A vengeful fairy is driven to curse an infant princess, only to discover that the child may be the one person who can restore peace to their troubled land.",56.0,Robert Stromberg,Maleficent,2014,97,USA, 180000000,241410378,758410378,517000000,578410378,1
66123,112.0,"Drama, Fantasy, Mystery","A troubled couple vacate to a beautiful getaway, but bizarre circumstances further complicate their situation.",66.0,Charlie McDowell,The One I Love,2014,91,USA, 100000,513447,596933,83486,496933,1
63026,204.0,"Comedy, Romance","After discovering her boyfriend is married, Carly soon meets the wife he's been betraying. And when yet another love affair is discovered, all three women team up to plot revenge on the three-timing S.O.B.",39.0,Nick Cassavetes,The Other Woman,2014,109,USA, 40000000,83911193,196710396,112799203,156710396,1
63035,10.0,"Drama, Thriller",A gallerist risks her family and flourishing career when she enters into an affair with a talented painter and slowly loses control of her life.,32.0,Bille Woodruff,Addicted,2014,106,USA, 5000000,17390770,17534314,143544,12534314,1
63697,343.0,"Action, Comedy, Crime","After making their way through high school (twice), big changes are in store for officers Schmidt and Jenko when they go deep undercover at a local college.",71.0,"Phil Lord, Christopher Miller",22 Jump Street,2014,112,USA, 50000000,191719337,331333876,139614539,281333876,1
65406,298.0,"Comedy, Western","As a cowardly farmer begins to fall for the mysterious new woman in town, he must put his newly found courage to the test when her husband, a notorious gun-slinger, announces his arrival.",44.0,Seth MacFarlane,A Million Ways to Die in the West,2014,116,USA, 40000000,43139300,87189756,44050456,47189756,1
63718,37.0,"Action, Adventure, Crime","Chapman is an ex-marine in Brazil's slums, battling the yakuza outfit who attacked his sister and left her for dead.",49.0,Ernie Barbarash,Falcon Rising,2014,103,USA, 4500000,11774,267476,255702,-4232524,0
63739,16.0,"Comedy, Drama",A group of women launch a movement to remove the censor of women's breasts all over America.,33.0,Lina Esco,Free the Nipple,2014,78,USA, 937000,4198,4198,0,-932802,0
51016,24.0,"Drama, Mystery, Thriller","When a teenage girl says she's the victim of a secret network called The Sisterhood of Night, a quiet suburban town becomes the backdrop for a modern-day Salem witch trial.",60.0,Caryn Waechter,The Sisterhood of Night,2014,104,USA, 1000000,6870,6870,0,-993130,0
63778,15.0,"Drama, Family, Sport","When a high school football star is suddenly stricken with irreversible total blindness, he must decide whether to live a safe handicapped life or bravely return to the life he once knew and the sport he still loves.",45.0,Dylan Baker,23 Blast,2014,98,USA, 1000000,549185,549185,0,-450815,0
63787,362.0,"Biography, Drama",A chronicle of one woman's one thousand one hundred mile solo hike undertaken as a way to recover from a recent personal tragedy.,76.0,Jean-Marc Vall√©e,Wild,2014,115,USA, 15000000,37880356,52501541,14621185,37501541,1
65280,56.0,Drama,"College philosophy professor Mr. Radisson's curriculum is challenged by his new student, Josh, who believes God exists.",16.0,Harold Cronk,God's Not Dead,2014,113,USA, 2000000,60755732,64676349,3920617,62676349,1
65432,615.0,"Comedy, Drama","A washed-up superhero actor attempts to revive his fading career by writing, directing, and starring in a Broadway production.",87.0,Alejandro G. I√±√°rritu,Birdman or (The Unexpected Virtue of Ignorance),2014,119,USA, 18000000,42340598,103215094,60874496,85215094,1
46334,356.0,"Action, Crime, Thriller",Some of Sin City's most hard-boiled citizens cross paths with a few of its more reviled inhabitants.,46.0,"Frank Miller, Robert Rodriguez",Sin City: A Dame to Kill For,2014,102,USA, 65000000,13757804,39407616,25649812,-25592384,0
65064,81.0,"Comedy, Drama, Musical",A struggling actress and her novelist lover each illustrate the struggle and deconstruction of their love affair.,60.0,Richard LaGravenese,The Last Five Years,2014,94,USA, 2000000,145427,292092,146665,-1707908,0
63969,38.0,"Drama, Music","Twin brothers are unknowingly separated at birth; one of them becomes an iconic rock 'n' roll star, while the other struggles to balance his love for music and pleasing his father.",25.0,Dustin Marcellino,The Identical,2014,107,USA, 16000000,2827666,2840991,13325,-13159009,0
65059,227.0,"Horror, Mystery, Thriller","When a young man becomes the target of a malevolent entity, he must uncover its true intentions before it takes complete control of him.",42.0,Christopher Landon,Paranormal Activity: The Marked Ones,2014,84,USA, 5000000,32462372,90894962,58432590,85894962,1
59281,253.0,"Biography, Drama, Music",The story of four young men from the wrong side of the tracks in New Jersey who came together to form the iconic 1960s rock group The Four Seasons.,54.0,Clint Eastwood,Jersey Boys,2014,134,USA, 40000000,47047013,67647013,20600000,27647013,1
65036,114.0,"Comedy, Drama, Romance",A self-absorbed realtor enlists the help of his neighbor when he's suddenly left in charge of the granddaughter he never knew existed until his estranged son drops her off at his home.,38.0,Rob Reiner,And So It Goes,2014,94,USA, 18000000,15160801,25419147,10258346,7419147,1
64312,201.0,"Drama, Fantasy, Mystery","A single mother is swept into a dark underworld, while her teenage son discovers a road that leads him to a secret underwater town.",42.0,Ryan Gosling,Lost River,2014,95,USA, 2000000,45431,615500,570069,-1384500,0
65035,20.0,"Comedy, Drama","When five struggling single moms put aside their differences to form a support group, they find inspiration and laughter in their new sisterhood, and help each other overcome the obstacles that stand in their way.",31.0,Tyler Perry,The Single Moms Club,2014,111,USA, 8000000,15973881,16337881,364000,8337881,1
64195,27.0,"Comedy, Drama, Romance","The ""black sheep"" son of a wealthy family meets a young psychiatric patient who's been raised in isolation her entire life. He then takes the naive young woman home for his brother's wedding.",22.0,Andrew Fleming,Barefoot,2014,90,USA, 6000000,15071,15071,0,-5984929,0
63882,100.0,"Drama, Romance",The story of a privileged girl and a charismatic boy whose instant desire sparks a love affair made only more reckless by parents trying to keep them apart.,30.0,Shana Feste,Endless Love,2014,104,USA, 20000000,23438250,34718173,11279923,14718173,1
46192,321.0,"Action, Crime, Thriller","A man believes he has put his mysterious past behind him and has dedicated himself to beginning a new, quiet life. But when he meets a young girl under the control of ultra-violent Russian gangsters, he can't stand idly by - he has to help her.",57.0,Antoine Fuqua,The Equalizer,2014,132,USA, 55000000,101530738,192330738,90800000,137330738,1
59286,246.0,"Action, Crime, Drama",Members of an elite DEA task force find themselves being taken down one by one after they rob a drug cartel safe house.,41.0,David Ayer,Sabotage,2014,109,USA, 35000000,10508518,17508518,7000000,-17491482,0
66116,140.0,"Horror, Mystery, Thriller","After a mysterious, lost night on their honeymoon, a newlywed couple finds themselves dealing with an earlier-than-planned pregnancy.",34.0,"Matt Bettinelli-Olpin, Tyler Gillett",Devil's Due,2014,89,USA, 7000000,15821461,36921560,21100099,29921560,1
63168,165.0,"Drama, Sport","At the NFL Draft, General Manager Sonny Weaver has the opportunity to rebuild his team when he trades for the number one pick. He must decide what he's willing to sacrifice on a life-changing day for a few hundred young men with NFL dreams.",54.0,Ivan Reitman,Draft Day,2014,110,USA, 25000000,28842237,29462046,619809,4462046,1
51644,576.0,Drama,"The life of Mason, from early childhood to his arrival at college.",100.0,Richard Linklater,Boyhood,2014,165,USA, 4000000,25352281,44495281,19143000,40495281,1
61478,360.0,Comedy,"After they are forced to live next to a fraternity house, a couple with a newborn baby do whatever they can to take them down.",68.0,Nicholas Stoller,Neighbors,2014,97,USA, 18000000,150157400,270665134,120507734,252665134,1
51402,172.0,"Action, Adventure, Fantasy","The origin story of the mythical Greek hero. Betrayed by his stepfather, the King, and exiled and sold into slavery because of a forbidden love, Hercules must use his formidable powers to fight his way back to his rightful kingdom.",22.0,Renny Harlin,The Legend of Hercules,2014,99,USA, 70000000,18848538,61279452,42430914,-8720548,0
63296,52.0,"Comedy, Romance","All the couples are back for a wedding in Las Vegas, but plans for a romantic weekend go awry when their various misadventures get them into some compromising situations that threaten to derail the big event.",38.0,Tim Story,Think Like a Man Too,2014,106,USA, 24000000,65182182,70181428,4999246,46181428,1
65703,69.0,"Drama, Music, Romance","All-stars from the previous Step Up installments come together in glittering Las Vegas, battling for a victory that could define their dreams and their careers.",45.0,Trish Sie,Step Up All In,2014,112,USA, 45000000,14904384,86165646,71261262,41165646,1
63342,408.0,"Animation, Action, Adventure","The special bond that develops between plus-sized inflatable robot Baymax, and prodigy Hiro Hamada, who team up with a group of friends to form a band of high-tech heroes.",74.0,"Don Hall, Chris Williams",Big Hero 6,2014,102,USA, 165000000,222527828,657827828,435300000,492827828,1
64410,248.0,"Horror, Mystery, Thriller","New York police officer Ralph Sarchie investigates a series of crimes. He joins forces with an unconventional priest, schooled in the rites of exorcism, to combat the possessions that are terrorizing their city.",40.0,Scott Derrickson,Deliver Us from Evil,2014,118,USA, 30000000,30577122,87937815,57360693,57937815,1
63483,162.0,"Animation, Adventure, Comedy","Manolo, a young man who is torn between fulfilling the expectations of his family and following his heart, embarks on an adventure that spans three fantastic worlds where he must face his greatest fears.",67.0,Jorge R. Guti√©rrez,The Book of Life,2014,95,USA, 50000000,50151543,99783556,49632013,49783556,1
63520,614.0,"Drama, Mystery, Thriller","With his wife's disappearance having become the focus of an intense media circus, a man sees the spotlight turned on him when it's suspected that he may not be innocent.",79.0,David Fincher,Gone Girl,2014,149,USA, 61000000,167767189,369330363,201563174,308330363,1
65531,332.0,"Drama, Romance",Two teenage cancer patients begin a life-affirming journey to visit a reclusive author in Amsterdam.,69.0,Josh Boone,The Fault in Our Stars,2014,126,USA, 12000000,124872350,307166834,182294484,295166834,1
58732,123.0,"Comedy, Family","Alexander's day begins with gum stuck in his hair, followed by more calamities. However, he finds little sympathy from his family and begins to wonder if bad things only happen to him, his mom, dad, brother and sister - who all find themselves living through their own terrible, horrible, no good, very bad day.",54.0,Miguel Arteta,"Alexander and the Terrible, Horrible, No Good, Very Bad Day",2014,81,USA, 28000000,66954149,100654149,33700000,72654149,1
65530,569.0,"Drama, Music",A promising young drummer enrolls at a cut-throat music conservatory where his dreams of greatness are mentored by an instructor who will stop at nothing to realize a student's potential.,88.0,Damien Chazelle,Whiplash,2014,106,USA, 3300000,13092000,48982041,35890041,45682041,1
49993,271.0,"Biography, Drama, Music","In the 1960s, Beach Boys leader Brian Wilson struggles with emerging psychosis as he attempts to craft his avant-garde pop masterpiece. In the 1980s, he is a broken, confused man under the 24-hour watch of shady therapist Dr. Eugene Landy.",80.0,Bill Pohlad,Love & Mercy,2014,121,USA, 10000000,12551031,28641776,16090745,18641776,1
63619,280.0,"Adventure, Comedy, Crime","While on a grand world tour,",61.0,James Bobin,Muppets Most Wanted,2014,107,USA, 50000000,51183113,80383113,29200000,30383113,1
65516,170.0,"Comedy, Fantasy, Horror","A young man's recently deceased girlfriend mysteriously returns from the dead, but he slowly realizes she is not the way he remembered her.",50.0,Jeff Baena,Life After Beth,2014,89,USA, 2400000,88273,274717,186444,-2125283,0
63371,51.0,"Drama, Sport","The journey of legendary football coach Bob Ladouceur, who took the De La Salle High School Spartans from obscurity to a 151-game winning streak that shattered all records for any American sport.",41.0,Thomas Carter,When the Game Stands Tall,2014,115,USA, 15000000,30127963,30138754,10791,15138754,1
66115,134.0,"Biography, Drama",Iranian-Canadian journalist Maziar Bahari is detained by Iranian forces who brutally interrogate him under suspicion that he is a spy.,67.0,Jon Stewart,Rosewater,2014,103,USA, 5000000,3128941,3171593,42652,-1828407,0
59902,332.0,"Biography, Drama, Sport","After a near-fatal plane crash in WWII, Olympian Louis Zamperini spends a harrowing 47 days in a raft with two fellow crewmen before he's caught by the Japanese navy and sent to a prisoner-of-war camp.",59.0,Angelina Jolie,Unbroken,2014,137,USA, 65000000,115637895,161459297,45821402,96459297,1
66901,56.0,"Drama, Family",The team of people who saved Winter's life reassemble in the wake of her surrogate mother's passing in order to find her a companion so she can remain at the Clearwater Marine Hospital.,58.0,Charles Martin Smith,Dolphin Tale 2,2014,107,USA, 36000000,42024533,57824533,15800000,21824533,1
58137,313.0,"Animation, Action, Adventure","When Hiccup and Toothless discover an ice cave that is home to hundreds of new wild dragons and the mysterious Dragon Rider, the two friends find themselves at the center of a battle to protect the peace.",76.0,Dean DeBlois,How to Train Your Dragon 2,2014,102,USA, 145000000,177002924,621537519,444534595,476537519,1
67726,180.0,"Horror, Mystery, Thriller",A newlywed couple finds their lake-country honeymoon descend into chaos after Paul finds Bea wandering and disoriented in the middle of the night.,65.0,Leigh Janiak,Honeymoon,2014,87,USA, 1000000,9318,24343,15025,-975657,0
55118,148.0,"Drama, Fantasy, Music","Life changes in an instant for young Mia Hall after a car accident puts her in a coma. During an out-of-body experience, she must decide whether to wake up and live a life far different than she had imagined. The choice is hers if she can go on.",46.0,R.J. Cutler,If I Stay,2014,107,USA, 11000000,50474843,78274843,27800000,67274843,1
67733,161.0,"Comedy, Drama","A group of high school teenagers and their parents attempt to navigate the many ways the Internet has changed their relationships, their communications, their self-images, and their love lives.",38.0,Jason Reitman,"Men, Women & Children",2014,119,USA, 16000000,705908,1705908,1000000,-14294092,0
55244,165.0,"Comedy, Drama","When their father passes away, four grown siblings are forced to return to their childhood home and live under the same roof together for a week, along with their over-sharing mother and an assortment of spouses, exes and might-have-beens.",44.0,Shawn Levy,This Is Where I Leave You,2014,103,USA, 19800000,34296320,41296320,7000000,21496320,1
67866,61.0,"Biography, Drama, History","The life story of Jesus is told from his humble birth through his teachings, crucifixion and ultimate resurrection.",37.0,Christopher Spencer,Son of God,2014,138,USA, 22000000,59700064,67800064,8100000,45800064,1
67966,598.0,"Horror, Mystery, Thriller",A young woman is followed by an unknown supernatural force after a sexual encounter.,83.0,David Robert Mitchell,It Follows,2014,100,USA, 1000000,14674076,21528593,6854517,20528593,1
60925,88.0,"Biography, Drama, Family","A small-town father must find the courage and conviction to share his son's extraordinary, life-changing experience with the world.",47.0,Randall Wallace,Heaven Is for Real,2014,99,USA, 12000000,91443253,101332962,9889709,89332962,1
60890,134.0,"Action, Comedy, Crime","Two struggling pals dress as police officers for a costume party and become neighborhood sensations. But when these newly-minted ""heroes"" get tangled in a real life web of mobsters and dirty detectives, they must put their fake badges on the line.",30.0,Luke Greenfield,Let's Be Cops,2014,104,USA, 17000000,82390774,138224951,55834177,121224951,1
55597,153.0,"Action, Comedy, Crime","Security guard Ben must prove himself to his girlfriend's brother, top police officer James. He rides along James on a 24-hour patrol of Atlanta.",41.0,Tim Story,Ride Along,2014,99,USA, 25000000,134938200,154468902,19530702,129468902,1
68281,300.0,"Horror, Mystery, Thriller",A couple begins to experience terrifying supernatural occurrences involving a vintage doll shortly after their home is invaded by satanic cultists.,37.0,John R. Leonetti,Annabelle,2014,99,USA, 6500000,84273813,257047661,172773848,250547661,1
60800,163.0,"Animation, Adventure, Comedy","Skipper, Kowalski, Rico and Private join forces with undercover organization The North Wind to stop the villainous Dr. Octavius Brine from destroying the world as we know it.",53.0,"Eric Darnell, Simon J. Smith",Penguins of Madagascar,2014,92,USA, 132000000,83850911,373515621,289664710,241515621,1
59741,431.0,"Comedy, Crime, Drama","In 1970, drug-fueled Los Angeles private investigator Larry ""Doc"" Sportello investigates the disappearance of a former girlfriend.",81.0,Paul Thomas Anderson,Inherent Vice,2014,148,USA, 20000000,8110975,14710975,6600000,-5289025,0
56001,22.0,Drama,"A drama that explores the life of Mother Teresa through letters she wrote to her longtime friend and spiritual advisor, Father Celeste van Exem over a nearly 50-year period.",25.0,William Riead,The Letters,2014,114,USA, 20000000,1647416,1647416,0,-18352584,0
59747,281.0,"Comedy, Drama, Mystery",A middle-aged couple's career and marriage are overturned when a disarming young couple enters their lives.,77.0,Noah Baumbach,While We're Young,2014,97,USA, 10000000,7587485,21075757,13488272,11075757,1
68716,165.0,Drama,"Claire becomes fascinated by the suicide of a woman in her chronic pain support group while grappling with her own, very raw personal tragedy.",49.0,Daniel Barnz,Cake,2014,102,USA, 7000000,1951776,2433850,482074,-4566150,0
57581,149.0,"Biography, Drama, Sport","Set during the Cold War, American chess prodigy Bobby Fischer finds himself caught between two superpowers and his own struggles as he challenges the Soviet Empire.",65.0,Edward Zwick,Pawn Sacrifice,2014,115,USA, 19000000,2436633,5578519,3141886,-13421481,0
69878,122.0,"Drama, Romance",One couple's story as they try to reclaim the life and love they once knew and pick up the pieces of a past that may be too far gone.,57.0,Ned Benson,The Disappearance of Eleanor Rigby: Them,2014,123,USA, 3000000,587774,985007,397233,-2014993,0
60054,180.0,"Comedy, Drama, Family","A foster kid, who lives with her mean foster mom, sees her life change when business tycoon and New York City mayoral candidate Will Stacks makes a thinly-veiled campaign move and takes her in.",33.0,Will Gluck,Annie,2014,118,USA, 65000000,85911262,133821816,47910554,68821816,1
57613,301.0,"Crime, Drama","Bob Saginowski finds himself at the center of a robbery gone awry and entwined in an investigation that digs deep into the neighborhood's past where friends, families, and foes all work together to make a living - no matter the cost.",69.0,Micha√´l R. Roskam,The Drop,2014,106,USA, 12600000,10724389,18658381,7933992,6058381,1
60079,91.0,"Comedy, Romance",Follow two couples as they journey from the bar to the bedroom and are eventually put to the test in the real world.,62.0,Steve Pink,About Last Night,2014,100,USA, 12500000,48637684,49002684,365000,36502684,1
60209,191.0,"Drama, Fantasy, Mystery","A burglar falls for an heiress as she dies in his arms. When he learns that he has the gift of reincarnation, he sets out to save her.",31.0,Akiva Goldsman,Winter's Tale,2014,118,USA, 60000000,12600231,30800231,18200000,-29199769,0
61107,427.0,"Action, Adventure, Sci-Fi","Katniss Everdeen is in District 13 after she shatters the games forever. Under the leadership of President Coin and the advice of her trusted friends, Katniss spreads her wings as she fights to save Peeta and a nation moved by her courage.",64.0,Francis Lawrence,The Hunger Games: Mockingjay - Part 1,2014,123,USA, 125000000,337135885,755356711,418220826,630356711,1
59816,163.0,"Comedy, Romance","Three best friends find themselves where we've all been - at that confusing moment in every dating relationship when you have to decide ""So...where is this going?""",36.0,Tom Gormican,That Awkward Moment,2014,94,USA, 8000000,26068955,40468955,14400000,32468955,1
60271,604.0,"Action, Adventure, Sci-Fi","As Steve Rogers struggles to embrace his role in the modern world, he teams up with a fellow Avenger and S.H.I.E.L.D agent, Black Widow, to battle a new threat from history: an assassin known as the Winter Soldier.",70.0,"Anthony Russo, Joe Russo",Captain America: The Winter Soldier,2014,136,USA, 170000000,259766572,714421503,454654931,544421503,1
69260,7.0,"Comedy, Drama, Romance","A group of modern day Pittsburgh teenagers spend their Thanksgiving break experiencing a mixture of love, friendship, partying, and sex.",1.0,Shane Dawson,Not Cool,2014,93,USA, 800000,36026,36026,0,-763974,0
60552,531.0,"Action, Adventure, Sci-Fi","When New York is put under siege by Oscorp, it is up to Spider-Man to save the city he swore to protect as well as his loved ones.",53.0,Marc Webb,The Amazing Spider-Man 2,2014,142,USA, 200000000,202853933,708982323,506128390,508982323,1
60553,286.0,"Crime, Drama","Big-city lawyer Hank Palmer returns to his childhood home where his father, the town's judge, is suspected of murder. Hank sets out to discover the truth and, along the way, reconnects with his estranged family.",48.0,David Dobkin,The Judge,2014,141,USA, 50000000,47119388,84419388,37300000,34419388,1
59800,49.0,"Comedy, Drama, Music","A grieving father in a downward spiral stumbles across a box of his recently deceased son's demo tapes and lyrics. Shocked by the discovery of this unknown talent, he forms a band in the hope of finding some catharsis.",52.0,William H. Macy,Rudderless,2014,105,USA, 5000000,58293,546149,487856,-4453851,0
60236,472.0,"Action, Adventure, Mystery","In a world divided by factions based on virtues, Tris learns she's Divergent and won't fit in. When she discovers a plot to destroy Divergents, Tris and the mysterious Four must find out what makes Divergents dangerous before it's too late.",48.0,Neil Burger,Divergent,2014,139,USA, 85000000,150947895,288885818,137937923,203885818,1
58153,153.0,"Biography, Drama, Sport",A sports agent stages an unconventional recruitment strategy to get talented Indian cricket players to play Major League Baseball.,56.0,Craig Gillespie,Million Dollar Arm,2014,124,USA, 25000000,36457627,38307627,1850000,13307627,1
49563,203.0,"Animation, Adventure, Comedy","The time-travelling adventures of an advanced canine and his adopted son, as they endeavor to fix a time rift they created.",59.0,Rob Minkoff,Mr. Peabody & Sherman,2014,92,USA, 145000000,111506430,275698039,164191609,130698039,1
54375,360.0,"Action, Adventure, Comedy","When a kingpin threatens New York City, a group of mutated turtle warriors must emerge from the shadows to protect their home.",31.0,Jonathan Liebesman,Teenage Mutant Ninja Turtles,2014,101,USA, 125000000,191204754,485004754,293800000,360004754,1
61140,206.0,"Comedy, Romance","A married couple wake up to discover that the sex tape they made the evening before has gone missing, leading to a frantic search for its whereabouts.",36.0,Jake Kasdan,Sex Tape,2014,94,USA, 40000000,38543473,126069509,87526036,86069509,1
70807,27.0,"Comedy, Family","His annual Christmas party faltering thanks to his cynical brother-in-law, former Growing Pains star Kirk Cameron attempts to save the day by showing him that Jesus Christ remains a crucial component of the over-commercialized holiday..",18.0,Darren Doane,Saving Christmas,2014,79,USA, 500000,2783970,2783970,0,2283970,1
67366,273.0,"Comedy, Drama, Horror",A brash and arrogant podcaster gets more than he bargained for when he travels to Canada to interview a mysterious recluse... who has a rather disturbing fondness for walruses.,55.0,Kevin Smith,Tusk,2014,102,USA, 3000000,1826705,1882074,55369,-1117926,0
67492,69.0,"Drama, Music, Romance","The pressures of fame have superstar singer Noni on the edge, until she meets Kaz, a young cop who works to help her find the courage to develop her own voice and break free to become the artist she was meant to be.",73.0,Gina Prince-Bythewood,Beyond the Lights,2014,116,USA, 7000000,14618727,14618727,0,7618727,1
61240,90.0,"Drama, Romance",A pair of former high school sweethearts reunite after many years when they return to visit their small hometown.,29.0,Michael Hoffman,The Best of Me,2014,118,USA, 26000000,26766213,35926213,9160000,9926213,1
67048,53.0,Comedy,"Hardworking mom Allyson has a crazy night out with her friends, while their husbands watch their children.",25.0,"Andrew Erwin, Jon Erwin",Moms' Night Out,2014,98,USA, 5000000,10429707,10536956,107249,5536956,1
66963,100.0,"Drama, War",A soldier assigned to Guantanamo Bay befriends a man who has been imprisoned there.,54.0,Peter Sattler,Camp X-Ray,2014,117,USA, 1000000,13302,79624,66322,-920376,0
61217,102.0,"Comedy, Drama, Romance","A father struggling with bipolar disorder tries to win back his wife by attempting to take full responsibility of their two young, spirited daughters, who don't make the overwhelming task any easier.",64.0,Maya Forbes,Infinitely Polar Bear,2014,90,USA, 6700000,1430655,1824678,394023,-4875322,0
67559,10.0,"Action, Horror, Thriller","Follows Reagan, a track star, who is kidnapped by a pair of sociopaths after her car breaks down on a deserted road.",42.0,Simeon Rice,Unsullied,2014,93,USA, 1500000,510957,510957,0,-989043,0
53913,376.0,Action,"Greek general Themistokles leads the charge against invading Persian forces led by mortal-turned-god Xerxes and Artemisia, vengeful commander of the Persian navy.",48.0,Noam Murro,300: Rise of an Empire,2014,102,USA, 110000000,106580051,337580051,231000000,227580051,1
59612,9.0,Drama,"A bunch of New Mexico cowboys head for the Kentucky Derby 2009 with their horse. It only gets 50 to 1 odds in this classy, int'l race.",37.0,Jim Wilson,50 to 1,2014,110,USA, 10000000,1064454,1064454,0,-8935546,0
53669,518.0,"Action, Crime, Sci-Fi","In 2028 Detroit, when Alex Murphy, a loving husband, father and good cop, is critically injured in the line of duty, the multinational conglomerate OmniCorp sees their chance for a part-man, part-robot police officer.",52.0,Jos√© Padilha,RoboCop,2014,117,USA, 100000000,58607007,242688965,184081958,142688965,1
61159,443.0,"Action, Adventure, Drama",Noah (Russell Crowe) is chosen by God to undertake a momentous mission before an apocalyptic flood cleanses the world.,68.0,Darren Aronofsky,Noah,2014,138,USA, 125000000,101200044,359200044,258000000,234200044,1
59477,29.0,"Action, Drama, Mystery",An evangelist finds himself framed for murder and on the run after he refuses to back a senator's proposition calling for sweeping religious reform.,11.0,Daniel Lusko,Persecuted,2014,91,USA, 1500000,1558836,1558836,0,58836,1
53759,9.0,Thriller,Skip delves into the mysteries of an old locker. His sage supervisor recounts chilling tales that underscore the importance of making the right choice. The stories come into play when Skip faces a life-or-death decision of his own.,22.0,"Bruce Dellis, Jason Marsden",Locker 13,2014,90,USA, 300000,3496,3496,0,-296504,0
66917,129.0,"Animation, Adventure, Comedy","When Dusty learns that his engine is damaged and he may never race again, he joins a forest fire and rescue unit to be trained as a firefighter, or else his air strip will be shut down.",48.0,Roberts Gannaway,Planes: Fire & Rescue,2014,83,USA, 50000000,59165787,146965787,87800000,96965787,1
64965,238.0,"Animation, Adventure, Comedy","Snoopy embarks upon his greatest mission as he and his team take to the skies to pursue their archnemesis, while his best pal Charlie Brown begins his own epic quest back home to win the love of his life.",67.0,Steve Martino,The Peanuts Movie,2015,88,USA, 99000000,130178411,246233113,116054702,147233113,1
68796,680.0,"Crime, Drama, Mystery","In the dead of a Wyoming winter, a bounty hunter and his prisoner find shelter in a cabin currently inhabited by a collection of nefarious characters.",68.0,Quentin Tarantino,The Hateful Eight,2015,168,USA, 44000000,54117416,155760117,101642701,111760117,1
68935,369.0,"Adventure, Biography, Drama","In 1974, high-wire artist Philippe Petit recruits a team of people to help him realize his dream: to walk the immense void between the World Trade Center towers.",70.0,Robert Zemeckis,The Walk,2015,123,USA, 35000000,10137502,61181942,51044440,26181942,1
66851,173.0,"Action, Comedy, Crime",An uptight and by-the-book cop tries to protect the outgoing widow of a drug boss as they race through Texas pursued by crooked cops and murderous gunmen.,31.0,Anne Fletcher,Hot Pursuit,2015,87,USA, 35000000,34580201,51380201,16800000,16380201,1
69111,169.0,"Comedy, Fantasy","On Christmas eve, three lifelong friends spend the night in New York City looking for the Holy Grail of Christmas parties.",58.0,Jonathan Levine,The Night Before,2015,101,USA, 25000000,43047372,52395996,9348624,27395996,1
69253,416.0,"Horror, Mystery, Thriller",Two siblings become increasingly frightened by their grandparents' disturbing behavior while visiting them on vacation.,55.0,M. Night Shyamalan,The Visit,2015,94,USA, 5000000,65206105,98450062,33243957,93450062,1
69832,30.0,"Biography, Drama, Sport","Freddie Steinmark, an underdog on the gridiron, faces the toughest challenge of his life after leading his team to a championship season.",34.0,Angelo Pizzo,My All-American,2015,118,USA, 20000000,2246000,2246000,0,-17754000,0
65203,177.0,"Animation, Comedy, Family","Dracula and his friends try to bring out the monster in his half human, half vampire grandson in order to keep Mavis from leaving the hotel.",44.0,Genndy Tartakovsky,Hotel Transylvania 2,2015,89,USA, 80000000,169700110,474800000,305099890,394800000,1
67057,81.0,"Drama, History",A young man's political awakening and coming of age during the days and weeks leading up to the Stonewall Riots.,30.0,Roland Emmerich,Stonewall,2015,129,USA, 13500000,187674,292669,104995,-13207331,0
65123,883.0,"Action, Adventure, Sci-Fi","Three decades after the Empire's defeat, a new threat arises in the militant First Order. Defected stormtrooper Finn and the scavenger Rey are caught up in the Resistance's search for the missing Luke Skywalker.",81.0,J.J. Abrams,Star Wars: Episode VII - The Force Awakens,2015,138,USA, 245000000,936662225,2068223624,1131561399,1823223624,1
72183,96.0,"Comedy, Drama, Romance",An aging widow from New York City follows her daughter to Los Angeles in hopes of starting a new life after her husband passes away.,68.0,Lorene Scafaria,The Meddler,2015,103,USA, 3200000,4267218,5425148,1157930,2225148,1
71761,16.0,Drama,"A man involved in a horrific car crash is pronounced dead, only to come back to life an hour and a half later, claiming to have seen Heaven.",28.0,Michael Polish,90 Minutes in Heaven,2015,121,USA, 5000000,4842699,4842699,0,-157301,0
69414,64.0,"Adventure, Drama, Family","As a small-town girl catapults from underground video sensation to global superstar, she and her three sisters begin a journey of discovering that some talents are too special to keep hidden.",42.0,Jon M. Chu,Jem and the Holograms,2015,118,USA, 5000000,2184640,2333684,149044,-2666316,0
69447,195.0,"Comedy, Drama, Music","A musician who gave up everything for her dream of rock-and-roll stardom returns home, looking to make things right with her family.",54.0,Jonathan Demme,Ricki and the Flash,2015,101,USA, 18000000,26822144,41325328,14503184,23325328,1
71916,8.0,"Comedy, Music, Romance","Sonia is a neurotic jingle writer who's always dreamt of a big and exciting life. Surprised by a sudden proposal and subsequent ultimatum from her easy-going boyfriend, Chris, Sonia has to ...",68.0,Sasha Gordon,It Had to Be You,2015,85,USA, 6000000,7162,7162,0,-5992838,0
65056,137.0,"Horror, Mystery, Thriller","Using a special camera that can see spirits, a family must protect their daughter from an evil entity with a sinister plan.",30.0,Gregory Plotkin,Paranormal Activity: The Ghost Dimension,2015,88,USA, 10000000,18300124,78903124,60603000,68903124,1
70013,109.0,"Comedy, Drama, Romance",A self-help seminar inspires a sixty-something woman to romantically pursue her younger co-worker.,63.0,Michael Showalter,"Hello, My Name Is Doris",2015,90,USA, 1000000,14444999,14659448,214449,13659448,1
64946,346.0,Drama,"Joy is the story of the title character, who rose to become founder and matriarch of a powerful family business dynasty.",56.0,David O. Russell,Joy,2015,124,USA, 60000000,56451232,101134059,44682827,41134059,1
69498,52.0,Drama,"Laney Brooks does bad things. Married with kids, she takes the drugs she wants, sleeps with the men she wants, disappears when she wants. Now, with the destruction of her family looming, ...",59.0,Adam Salky,I Smile Back,2015,85,USA, 495000,58738,63373,4635,-431627,0
70909,275.0,"Action, Sci-Fi, Thriller","After having escaped the Maze, the Gladers now face a new set of challenges on the open roads of a desolate landscape filled with unimaginable obstacles.",43.0,Wes Ball,Maze Runner: The Scorch Trials,2015,131,USA, 61000000,81697192,312296056,230598864,251296056,1
71574,144.0,"Comedy, Drama","A teenager facing an unplanned pregnancy seeks help from her acerbic grandmother, a woman who is long estranged from her daughter.",77.0,Paul Weitz,Grandma,2015,79,USA, 600000,6980524,7087452,106928,6487452,1
70202,202.0,"Comedy, Crime, Drama",A hooker tears through Tinseltown on Christmas Eve searching for the pimp who broke her heart.,85.0,Sean Baker,Tangerine,2015,88,USA, 100000,702354,828874,126520,728874,1
69806,283.0,"Comedy, Drama",A tormented philosophy professor finds a will to live when he commits an existential act.,53.0,Woody Allen,Irrational Man,2015,95,USA, 11000000,4030360,27391084,23360724,16391084,1
70163,169.0,"Crime, Thriller",A small-town sheriff sets out to find the two kids who have taken his car on a joy ride.,66.0,Jon Watts,Cop Car,2015,88,USA, 800000,134552,143658,9106,-656342,0
69444,202.0,"Comedy, Drama, Mystery","After an all-night adventure, Quentin's lifelong crush, Margo, disappears, leaving behind clues that Quentin and his friends follow on the journey of a lifetime.",56.0,Jake Schreier,Paper Towns,2015,109,USA, 12000000,32000304,85512300,53511996,73512300,1
64615,682.0,"Action, Adventure, Sci-Fi","When Tony Stark and Bruce Banner try to jump-start a dormant peacekeeping program called Ultron, things go horribly wrong and it's up to Earth's mightiest heroes to stop the villainous Ultron from enacting his terrible plan.",66.0,Joss Whedon,Avengers: Age of Ultron,2015,141,USA, 250000000,459005868,1402805868,943800000,1152805868,1
65430,185.0,"Comedy, Crime","When millionaire James King is jailed for fraud and bound for San Quentin, he turns to Darnell Lewis to prep him to go behind bars.",34.0,Etan Cohen,Get Hard,2015,100,USA, 40000000,90411453,111711453,21300000,71711453,1
71355,18.0,"Drama, Sport",A gifted high school football player must learn to embrace his talent and his faith as he battles racial tensions on and off the field.,57.0,"Andrew Erwin, Jon Erwin",Woodlawn,2015,123,USA, 12000000,14394097,14401617,7520,2401617,1
70352,67.0,"Comedy, Drama, Sport",A foul-mouthed former gymnastics bronze medalist with local celebrity status reluctantly trains a rising Olympics aspirant.,44.0,Bryan Buckley,The Bronze,2015,100,USA, 3500000,615816,615816,0,-2884184,0
67834,301.0,"Biography, Drama","In 1947,",60.0,Jay Roach,Trumbo,2015,124,USA, 15000000,7857741,8235661,377920,-6764339,0
71257,55.0,Drama,"After Ray decides to transition from female to male, Ray's mother, Maggie, must come to terms with the decision while tracking down Ray's biological father to get his legal consent.",47.0,Gaby Dellal,3 Generations,2015,92,USA, 5000000,155936,531046,375110,-4468954,0
68106,50.0,"Action, Crime, Drama","A father is without the means to pay for his daughter's medical treatment. As a last resort, he partners with a greedy co-worker to rob a casino. When things go awry they're forced to hijack a city bus.",37.0,Scott Mann,Heist,2015,93,USA, 8900000,50136,3777046,3726910,-5122954,0
67668,106.0,"Comedy, Music, War","A down-on-his-luck music manager discovers a teenage girl with an extraordinary voice while on a music tour in Afghanistan and takes her to Kabul to compete on the popular television show, Afghan Star.",29.0,Barry Levinson,Rock the Kasbah,2015,106,USA, 15000000,3020664,3394174,373510,-11605826,0
67702,178.0,"Comedy, Drama, Romance",A teen artist living in 1970s San Francisco enters into an affair with her mother's boyfriend.,87.0,Marielle Heller,The Diary of a Teenage Girl,2015,102,USA, 2000000,1477002,1775133,298131,-224867,0
70966,422.0,"Horror, Music, Thriller",A punk rock band is forced to fight for survival after witnessing a murder at a neo-Nazi skinhead bar.,79.0,Jeremy Saulnier,Green Room,2015,95,USA, 5000000,3220371,3769214,548843,-1230786,0
70366,48.0,"Crime, Drama, Horror","After breaking up with her boyfriend, a professional woman gets involved with a man who seems almost too good to be true.",36.0,David M. Rosenthal,The Perfect Guy,2015,100,USA, 12000000,57027435,60273173,3245738,48273173,1
70374,43.0,"Action, Comedy, Sci-Fi",Four losers are thrust into the position of saving the world when they stumble upon a UFO crash site and become genetically equipped to the battle suit on board.,42.0,Matt Hullum,Lazer Team,2015,102,USA, 2480421,1186426,1406538,220112,-1073883,0
66417,238.0,"Comedy, Music","After a humiliating command performance at The Kennedy Center, the Barden Bellas enter an international competition that no American group has ever won in order to regain their status and right to perform.",63.0,Elizabeth Banks,Pitch Perfect 2,2015,115,USA, 29000000,184296230,287144079,102847849,258144079,1
67747,270.0,"Horror, Thriller","A woman, separated from her unfaithful husband, falls for a younger man who has moved in next door, but their torrid affair soon takes a dangerous turn.",30.0,Rob Cohen,The Boy Next Door,2015,91,USA, 4000000,35423380,52425855,17002475,48425855,1
68109,54.0,"Drama, Sci-Fi","In near future Brooklyn, an ad executive uses a new Augmented Reality technology to conduct an affair with his best friend's girlfriend...sort of.",58.0,Benjamin Dickinson,Creative Control,2015,97,USA, 1000000,63014,63014,0,-936986,0
66047,124.0,"Drama, Romance","The lives of a young couple intertwine with a much older man, as he reflects back on a past love.",33.0,George Tillman Jr.,The Longest Ride,2015,123,USA, 34000000,37446117,62944815,25498698,28944815,1
66012,287.0,"Action, Crime, Thriller",A furloughed convict and his American and Chinese partners hunt a high-level cybercrime network from Chicago to Los Angeles to Hong Kong to Jakarta.,51.0,Michael Mann,Blackhat,2015,133,USA, 70000000,8005980,19652057,11646077,-50347943,0
70244,42.0,Drama,"A seemingly perfect family looks to fix their problems with the help of Miss Clara, an older, wiser woman.",26.0,Alex Kendrick,War Room,2015,120,USA, 3000000,67790117,73256266,5466149,70256266,1
70317,196.0,"Comedy, Crime, Drama","Life changes for Malcolm, a geek who's surviving life in a tough neighborhood, after a chance invitation to an underground party leads him and his friends into a Los Angeles adventure.",72.0,Rick Famuyiwa,Dope,2015,103,USA, 7000000,17506470,17986781,480311,10986781,1
68751,98.0,"Drama, Fantasy, Mystery",A suicidal American befriends a Japanese man lost in a forest near Mt. Fuji and the two search for a way out.,23.0,Gus Van Sant,The Sea of Trees,2015,110,USA, 25000000,20444,906995,886551,-24093005,0
68750,81.0,"Action, Comedy, Crime","After six years of keeping our malls safe, Paul Blart has earned a well-deserved vacation. He heads to Las Vegas with his teenage daughter before she heads off to college. But safety never takes a holiday and when duty calls, Blart answers.",13.0,Andy Fickman,Paul Blart: Mall Cop 2,2015,94,USA, 30000000,71038190,107588225,36550035,77588225,1
65523,312.0,"Comedy, Drama, Romance","High schooler Greg, who spends most of his time making parodies of classic movies with his co-worker Earl, finds his outlook forever altered after befriending a classmate who has just been diagnosed with cancer.",74.0,Alfonso Gomez-Rejon,Me and Earl and the Dying Girl,2015,105,USA, 8000000,6758416,9074749,2316333,1074749,1
70932,13.0,Drama,"When a pastor is shaken by the visible faith of a street corner preacher, he is reminded that true belief always requires action. His response ignites a journey that impacts everyone it touches in ways that only God could orchestrate.",22.0,Jon Gunn,Do You Believe?,2015,120,USA, 2300000,12985600,14394643,1409043,12094643,1
67273,492.0,"Drama, Sport","The former World Heavyweight Champion Rocky Balboa serves as a trainer and mentor to Adonis Johnson, the son of his late friend and former rival Apollo Creed.",82.0,Ryan Coogler,Creed,2015,133,USA, 35000000,109767581,173567581,63800000,138567581,1
66592,282.0,"Action, Adventure, Sci-Fi",Beatrice Prior must confront her inner demons and continue her fight against a powerful alliance which threatens to tear her society apart with the help from others on her side.,42.0,Robert Schwentke,Insurgent,2015,119,USA, 110000000,130179072,297002527,166823455,187002527,1
67417,14.0,Comedy,"Following an expensive divorce and the cancellation of his TV show, a stand-up comic is forced to go back on the road to provide for his daughter.",50.0,"Adam Carolla, Kevin Hench",Road Hard,2015,98,USA, 1500000,113169,113169,0,-1386831,0
68454,65.0,"Adventure, Drama, Family",A military dog that helped American Marines in Afghanistan returns to the United States and is adopted by his handler's family after suffering a traumatic experience.,47.0,Boaz Yakin,Max,2015,111,USA, 20000000,42656255,43967255,1311000,23967255,1
70320,250.0,"Comedy, Drama, Fantasy",A boy who has a bad Christmas ends up accidentally summoning a festive demon to his family home.,49.0,Michael Dougherty,Krampus,2015,98,USA, 15000000,42725475,61548707,18823232,46548707,1
65744,298.0,Comedy,"Newlywed couple Ted and Tami-Lynn want to have a baby, but in order to qualify to be a parent, Ted will have to prove he's a person in a court of law.",48.0,Seth MacFarlane,Ted 2,2015,115,USA, 68000000,81476385,215863606,134387221,147863606,1
66885,73.0,"Animation, Adventure, Comedy","Through a series of misunderstandings, Alvin, Simon and Theodore come to believe that Dave is going to propose to his new girlfriend in Miami...and dump them. They have three days to get to him and stop the proposal, saving themselves not only from losing Dave but possibly from gaining a terrible stepbrother.",33.0,Walt Becker,Alvin and the Chipmunks: The Road Chip,2015,92,USA, 90000000,85886987,234798636,148911649,144798636,1
66650,164.0,"Horror, Mystery, Sci-Fi",A group of medical researchers discover a way to bring dead patients back to life.,31.0,David Gelb,The Lazarus Effect,2015,83,USA, 3300000,25801570,38356892,12555322,35056892,1
65745,113.0,"Comedy, Mystery, Sci-Fi","When Lou gets killed, Nick and Jacob fire up the hot tub time machine to get back to the past, but they inadvertently land in the future with Adam Jr. Now they have to alter the future in ...",29.0,Steve Pink,Hot Tub Time Machine 2,2015,93,USA, 14000000,12314651,13081651,767000,-918349,0
64904,183.0,"Drama, Mystery, Sci-Fi","A group of teens discover secret plans of a time machine, and construct one. However, things start to get out of control.",47.0,Dean Israelite,Project Almanac,2015,106,USA, 12000000,22348241,33213241,10865000,21213241,1
55503,381.0,"Biography, Drama, History","The group NWA emerges from the mean streets of Compton in Los Angeles, California, in the mid-1980s and revolutionizes Hip Hop culture with their music and tales about life in the hood.",72.0,F. Gary Gray,Straight Outta Compton,2015,147,USA, 28000000,161197785,201634991,40437206,173634991,1
60349,174.0,Comedy,Two sisters decide to throw one last house party before their parents sell their family home.,58.0,Jason Moore,Sisters,2015,118,USA, 30000000,87044645,105011053,17966408,75011053,1
56861,171.0,"Comedy, Family","Brad Whitaker is a radio host trying to get his stepchildren to love him and call him Dad. But his plans turn upside down when their biological father, Dusty Mayron, returns.",42.0,Sean Anders,Daddy's Home,2015,96,USA, 50000000,150357137,242786137,92429000,192786137,1
42553,688.0,"Action, Adventure, Sci-Fi","A new theme park, built on the original site of Jurassic Park, creates a genetically modified hybrid dinosaur, the Indominus Rex, which escapes containment and goes on a killing spree.",59.0,Colin Trevorrow,Jurassic World,2015,124,USA, 150000000,652270625,1670400637,1018130012,1520400637,1
59102,162.0,"Action, Comedy, Horror","Three scouts, on the eve of their last camp-out, discover the true meaning of friendship when they attempt to save their town from a zombie outbreak.",32.0,Christopher Landon,Scouts Guide to the Zombie Apocalypse,2015,93,USA, 15000000,3703046,16137046,12434000,1137046,1
53810,145.0,"Comedy, Drama, Romance",A celebrated military contractor returns to the site of his greatest career triumphs and reconnects with a long-ago love while unexpectedly falling for the hard-charging Air Force watch-dog assigned to him.,40.0,Cameron Crowe,Aloha,2015,105,USA, 37000000,21067116,26250020,5182904,-10749980,0
63521,236.0,"Comedy, Drama, Music","Three years after Mike bowed out of the stripper life at the top of his game, he and the remaining Kings of Tampa hit the road to Myrtle Beach to put on one last blow-out performance.",60.0,Gregory Jacobs,Magic Mike XXL,2015,115,USA, 14800000,66013057,117813057,51800000,103013057,1
51198,284.0,"Horror, Thriller",A family whose suburban home is haunted by evil forces must come together to rescue their youngest daughter after the apparitions take her captive.,47.0,Gil Kenan,Poltergeist,2015,93,USA, 35000000,47425125,95437994,48012869,60437994,1
59159,57.0,"Action, Adventure, Comedy","A teenage special ops agent coveting a ""normal"" adolescence fakes her own death and enrolls in a suburban high school. She quickly learns that surviving the treacherous waters of high school is more challenging than international espionage.",44.0,Kyle Newman,Barely Lethal,2015,96,USA, 15000000,6075,933847,927772,-14066153,0
57585,468.0,"Biography, Comedy, Drama",In 2006-2007 a group of investors bet against the US mortgage market. In their research they discover how flawed and corrupt the market is.,81.0,Adam McKay,The Big Short,2015,130,USA, 28000000,70259870,133440870,63181000,105440870,1
63170,176.0,"Animation, Adventure, Comedy","An alien on the run from his own people makes friends with a girl. He tries to help her on her quest, but can be an interference.",55.0,Tim Johnson,Home,2015,94,USA, 135000000,177397510,386041607,208644097,251041607,1
63004,252.0,"Action, Drama, Thriller","Mobster and hit man Jimmy Conlon has one night to figure out where his loyalties lie: with his estranged son, Mike, whose life is in danger, or his longtime best friend, mob boss Shawn Maguire, who wants Mike to pay for the death of his own son.",59.0,Jaume Collet-Serra,Run All Night,2015,114,USA, 50000000,26461644,71561644,45100000,21561644,1
59647,214.0,"Action, Thriller","In their new overseas house, an American family soon finds themselves caught in the middle of a coup, and they frantically look for a safe escape from an environment where foreigners are being immediately executed.",38.0,John Erick Dowdle,No Escape,2015,103,USA, 16200000,27288872,54418872,27130000,38218872,1
58492,224.0,Comedy,"Movie star Vincent Chase, together with his boys Eric, Turtle, and Johnny, are back - and back in business with super agent-turned-studio head Ari Gold on a risky project that will serve as Vince's directorial debut.",38.0,Doug Ellin,Entourage,2015,104,USA, 30000000,32363404,49263404,16900000,19263404,1
58374,138.0,"Comedy, Romance","A high school senior instigates a social pecking order revolution after finding out that she has been labeled the DUFF - Designated Ugly Fat Friend - by her prettier, more popular counterparts.",56.0,Ari Sandel,The Duff,2015,101,USA, 8500000,34030343,43528634,9498291,35028634,1
62537,190.0,"Action, Mystery, Sci-Fi","A dying real estate mogul transfers his consciousness into a healthy young body, but soon finds that neither the procedure nor the company that performed it are quite what they seem.",34.0,Tarsem Singh,Self/less,2015,117,USA, 26000000,12279691,30523226,18243535,4523226,1
62530,155.0,"Action, Drama, Western",A woman asks her ex-lover for help in order to save her outlaw husband from a gang out to kill him.,49.0,Gavin O'Connor,Jane Got a Gun,2015,98,USA, 25000000,1513793,3067531,1553738,-21932469,0
52934,168.0,"Adventure, Biography, Comedy","After spending two decades in England, Bill Bryson returns to the U.S., where he decides the best way to connect with his homeland is to hike the Appalachian Trail with one of his oldest friends.",51.0,Ken Kwapis,A Walk in the Woods,2015,104,USA, 8000000,29504281,37461274,7956993,29461274,1
58279,145.0,"Biography, Drama, Romance","New Jersey police lieutenant, Laurel Hester, and her registered domestic partner, Stacie Andree, both battle to secure Hester's pension benefits when she is diagnosed with terminal cancer.",50.0,Peter Sollett,Freeheld,2015,103,USA, 7000000,573335,1474471,901136,-5525529,0
62153,73.0,"Action, Comedy, Romance","A girl falls for the ""perfect"" guy, who happens to have a very fatal flaw: he's a hitman on the run from the crime cartels who employ him.",52.0,Paco Cabezas,Mr. Right,2015,95,USA, 8000000,34694,607595,572901,-7392405,0
62458,392.0,"Action, Adventure, Drama","In the aftermath of a massive earthquake in California, a rescue-chopper pilot makes a dangerous journey with his ex-wife across the state in order to rescue his daughter.",43.0,Brad Peyton,San Andreas,2015,114,USA, 110000000,155190832,473990832,318800000,363990832,1
59543,151.0,"Biography, Comedy, Drama",An aging rock star decides to change his life when he discovers a 40-year-old letter written to him by,58.0,Dan Fogelman,Danny Collins,2015,106,USA, 10000000,5637066,10835752,5198686,835752,1
62206,579.0,"Animation, Adventure, Comedy","After young Riley is uprooted from her Midwest life and moved to San Francisco, her emotions - Joy, Fear, Anger, Disgust and Sadness - conflict on how best to navigate a new city, house, and school.",94.0,"Pete Docter, Ronnie Del Carmen",Inside Out,2015,95,USA, 175000000,356461711,857611174,501149463,682611174,1
62208,116.0,"Biography, Drama, Sport",Jim White moves his family after losing his last job as a football coach. He sees that some of the students are worth starting a cross-country team and turns seven students with no hope into one of the best cross-country teams.,60.0,Niki Caro,"McFarland, USA",2015,129,USA, 17000000,44482410,45710059,1227649,28710059,1
63695,333.0,"Animation, Adventure, Comedy","Minions Stuart, Kevin, and Bob are recruited by Scarlet Overkill, a supervillain who, alongside her inventor husband Herb, hatches a plot to take over the world.",56.0,"Kyle Balda, Pierre Coffin",Minions,2015,91,USA, 74000000,336045770,1159398397,823352627,1085398397,1
51053,134.0,"Comedy, Drama","A battle-hardened American political consultant is sent to help re-elect a controversial president in Bolivia, where she must compete with a long-term rival working for another candidate.",53.0,David Gordon Green,Our Brand Is Crisis,2015,107,USA, 28000000,7002261,8527658,1525397,-19472342,0
63600,110.0,"Comedy, Fantasy, Romance",The intertwined stories of four generations of Coopers unfold right before the annual family reunion on Christmas Eve.,31.0,Jessie Nelson,Love the Coopers,2015,107,USA, 17000000,26302731,42426912,16124181,25426912,1
56808,104.0,"Horror, Thriller",A priest and two Vatican exorcists must do battle with an ancient satanic force to save the soul of a young woman.,38.0,Mark Neveldine,The Vatican Tapes,2015,91,USA, 8000000,1784763,13015764,11231001,5015764,1
49780,123.0,Comedy,"Two weeks shy of his wedding, a socially awkward guy enters into a charade by hiring the owner of a company that provides best men for grooms in need.",35.0,Jeremy Garelick,The Wedding Ringer,2015,101,USA, 23000000,64460211,79799880,15339669,56799880,1
60720,518.0,"Biography, Crime, Drama","The true story of how the Boston Globe uncovered the massive scandal of child molestation and cover-up within the local Catholic Archdiocese, shaking the entire Catholic Church to its core.",93.0,Tom McCarthy,Spotlight,2015,129,USA, 20000000,45055776,98275238,53219462,78275238,1
55188,184.0,"Drama, War","A drama based on the experiences of Agu, a child soldier fighting in the civil war of an unnamed African country.",79.0,Cary Joji Fukunaga,Beasts of No Nation,2015,137,USA, 6000000,90777,90777,0,-5909223,0
54978,509.0,"Action, Adventure, Sci-Fi","When John Connor, leader of the human resistance, sends Sgt. Kyle Reese back to 1984 to protect Sarah Connor and safeguard the future, an unexpected turn of events creates a fractured timeline.",38.0,Alan Taylor,Terminator Genisys,2015,126,USA, 155000000,89760956,440603537,350842581,285603537,1
64265,260.0,"Comedy, Drama","Seventy-year-old widower Ben Whittaker has discovered that retirement isn't all it's cracked up to be. Seizing an opportunity to get back in the game, he becomes a senior intern at an online fashion site, founded and run by Jules Ostin.",51.0,Nancy Meyers,The Intern,2015,121,USA, 35000000,75764672,194564672,118800000,159564672,1
61108,422.0,"Action, Adventure, Sci-Fi",Katniss and a team of rebels from District 13 prepare for the final battle that will decide the fate of Panem.,65.0,Francis Lawrence,The Hunger Games: Mockingjay - Part 2,2015,137,USA, 160000000,281723902,653428261,371704359,493428261,1
56809,224.0,"Adventure, Comedy","Rusty Griswold takes his own family on a road trip to ""Walley World"" in order to spice things up with his wife and reconnect with his sons.",34.0,"John Francis Daley, Jonathan Goldstein",Vacation,2015,99,USA, 31000000,58884188,104884188,46000000,73884188,1
64234,97.0,"Comedy, Drama","A hard-working small business owner and his two associates travel to Europe to close the most important deal of their lives. But what began as a routine business trip goes off the rails in every way imaginable, and unimaginable.",32.0,Ken Scott,Unfinished Business,2015,91,USA, 35000000,10219501,14431253,4211752,-20568747,0
64154,128.0,"Comedy, Drama","Down on his luck and facing financial hardship, Gerry teams up with younger charismatic poker player, Curtis, in an attempt to change his luck. The two set off on a road trip through the South with visions of winning back what's been lost.",77.0,"Anna Boden, Ryan Fleck",Mississippi Grind,2015,108,USA, 6000000,130541,422746,292205,-5577254,0
47252,567.0,"Action, Adventure, Comedy","Armed with a super-suit with the astonishing ability to shrink in scale but increase in strength, cat burglar Scott Lang must embrace his inner hero and help his mentor, Dr. Hank Pym, plan and pull off a heist that will save the world.",64.0,Peyton Reed,Ant-Man,2015,117,USA, 130000000,180202163,519311965,339109802,389311965,1
56439,95.0,"Biography, Drama, Music","The story of the country-western singer Hank Williams, who in his brief life created one of the greatest bodies of work in American music. The film chronicles his rise to fame and its tragic effect on his health and personal life.",47.0,Marc Abraham,I Saw the Light,2015,123,USA, 13000000,1646788,1767963,121175,-11232037,0
52841,225.0,"Comedy, Drama","A successful investment banker struggles after losing his wife in a tragic car crash. With the help of a customer service rep and her young son, he starts to rebuild, beginning with the demolition of the life he once knew.",49.0,Jean-Marc Vall√©e,Demolition,2015,101,USA, 10000000,1978592,4366460,2387868,-5633540,0
63812,170.0,"Horror, Mystery, Thriller","20 years after a horrific accident during a small town school play, students at the school resurrect the failed show in a misguided attempt to honor the anniversary of the tragedy - but soon discover that some things are better left alone.",30.0,"Travis Cluff, Chris Lofing",The Gallows,2015,81,USA, 100000,22764410,42964410,20200000,42864410,1
61301,331.0,"Animation, Adventure, Comedy","In a world where dinosaurs and humans live side-by-side, an Apatosaurus named Arlo makes an unlikely human friend.",66.0,Peter Sohn,The Good Dinosaur,2015,93,USA, 200000000,123087120,332207671,209120551,132207671,1
63926,395.0,"Drama, Romance, Thriller","Literature student Anastasia Steele's life changes forever when she meets handsome, yet tormented, billionaire Christian Grey.",46.0,Sam Taylor-Johnson,Fifty Shades of Grey,2015,125,USA, 40000000,166167230,569651467,403484237,529651467,1
56732,59.0,"Horror, Mystery, Sci-Fi","Three young conspiracy theorists attempt to uncover the mysteries of Area 51, the government's secret location rumored to have hosted encounters with alien beings. What they find at this hidden facility exposes unimaginable secrets.",30.0,Oren Peli,Area 51,2015,91,USA, 5000000,7556,7556,0,-4992444,0
68490,480.0,"Action, Adventure, Sci-Fi","In the 1980s the X-Men must defeat an ancient all-powerful mutant, En Sabah Nur, who intends to thrive through bringing destruction to the world.",52.0,Bryan Singer,X-Men: Apocalypse,2016,144,USA, 178000000,155442489,543934105,388491616,365934105,1
68500,220.0,"Horror, Mystery, Thriller","A woman goes into Japan's Suicide Forest to find her twin sister, and confronts supernatural terror.",34.0,Jason Zada,The Forest,2016,93,USA, 10000000,26594261,37608299,11014038,27608299,1
55827,653.0,"Action, Adventure, Comedy","A wisecracking mercenary gets experimented on and becomes immortal but ugly, and sets out to track down the man who ruined his looks.",65.0,Tim Miller,Deadpool,2016,108,USA, 58000000,363070709,782612155,419541446,724612155,1
68604,209.0,"Action, Adventure, Mystery","After the earth-shattering revelations of Insurgent, Tris must escape with Four beyond the wall that encircles Chicago, to finally discover the shocking truth of the world around them.",33.0,Robert Schwentke,Allegiant,2016,120,USA, 110000000,66184051,179246868,113062817,69246868,1
68628,146.0,"Animation, Adventure, Comedy","When Scrat's acorn sends an asteroid to Earth, the Herd must find a way to stop the asteroid from hitting Earth with the help of a returning friend.",34.0,"Mike Thurmeier, Galen T. Chu",Ice Age: Collision Course,2016,94,USA, 105000000,64063008,408579038,344516030,303579038,1
69468,81.0,"Comedy, Drama","As their surrounding community has taken a turn for the worse, the crew at Calvin's Barbershop come together to bring some much needed change to their neighborhood.",67.0,Malcolm D. Lee,Barbershop: The Next Cut,2016,111,USA, 20000000,54030051,55030051,1000000,35030051,1
60592,78.0,"Horror, Thriller","A family unknowingly awakens an ancient supernatural entity on a Grand Canyon vacation, and must fight for survival when it follows them home.",27.0,Greg McLean,The Darkness,2016,92,USA, 4000000,10753574,10898293,144719,6898293,1
69125,241.0,"Adventure, Crime, Drama","A high school senior finds herself immersed in an online game of truth or dare, where her every move starts to become manipulated by an anonymous community of ""watchers.""",58.0,"Henry Joost, Ariel Schulman",Nerve,2016,96,USA, 19000000,38583626,85251425,46667799,66251425,1
70329,13.0,Comedy,"A young Indian man relocates to 1970s Chicago to become an engineer, but when his job falls through, resorts to an elaborate charade with misfit friends in order to woo his childhood sweetheart.",66.0,Lena Khan,The Tiger Hunter,2016,94,USA, 1250000,62398,62398,0,-1187602,0
57865,146.0,"Biography, Drama, Sport",The inspirational story of World Champion Boxer,62.0,Ben Younger,Bleed for This,2016,117,USA, 6000000,5083906,6698679,1614773,698679,1
59803,139.0,"Comedy, Crime, Drama","Fueled by cheap whiskey, greed and hatred, Willie teams up once again with his angry little sidekick, Marcus, to knock off a Chicago charity on Christmas Eve.",38.0,Mark Waters,Bad Santa 2,2016,92,USA, 26000000,17782178,24079268,6297090,-1920732,0
68962,658.0,"Action, Adventure, Sci-Fi",Political involvement in the Avengers' affairs causes a rift between Captain America and Iron Man.,75.0,"Anthony Russo, Joe Russo",Captain America: Civil War,2016,147,USA, 250000000,408084349,1153296293,745211944,903296293,1
69060,384.0,"Animation, Adventure, Comedy","In Ancient Polynesia, when a terrible curse incurred by the Demigod Maui reaches Moana's island, she answers the Ocean's call to seek out the Demigod to set things right.",81.0,"Ron Clements, John Musker",Moana,2016,107,USA, 150000000,248757044,690845539,442088495,540845539,1
69195,184.0,"Biography, Comedy, Drama",A journalist recounts her wartime coverage in Afghanistan.,57.0,"Glenn Ficarra, John Requa",Whiskey Tango Foxtrot,2016,112,USA, 35000000,23083334,24972139,1888805,-10027861,0
70118,441.0,"Action, Comedy, Crime","In 1970s Los Angeles, a mismatched pair of private eyes investigate a missing girl and the mysterious death of a porn star.",70.0,Shane Black,The Nice Guys,2016,116,USA, 50000000,36261763,62788218,26526455,12788218,1
59817,223.0,"Crime, Drama","Kenny Wells, a prospector desperate for a lucky break, teams up with a similarly eager geologist and sets off on a journey to find gold in the uncharted jungle of Indonesia.",49.0,Stephen Gaghan,Gold,2016,120,USA, 20000000,7227038,14880939,7653901,-5119061,0
69955,694.0,"Action, Adventure, Sci-Fi",The daughter of an Imperial scientist joins the Rebel Alliance in a risky move to steal the Death Star plans.,65.0,Gareth Edwards,Rogue One,2016,133,USA, 200000000,532177324,1056057273,523879949,856057273,1
69801,73.0,"Comedy, Drama, Romance",A man returns to his small hometown after learning that his mother has fallen ill and is about to undergo surgery.,53.0,John Krasinski,The Hollars,2016,88,USA, 3800000,1016985,1138609,121624,-2661391,0
69816,179.0,"Action, Adventure, Fantasy","Vampire death dealer, Selene (Kate Beckinsale) fights to end the eternal war between the Lycan clan and the Vampire faction that betrayed her.",23.0,Anna Foerster,Underworld: Blood Wars,2016,91,USA, 35000000,30353973,81093313,50739340,46093313,1
57933,369.0,"Action, Adventure, Sci-Fi","Two decades after the first Independence Day invasion, Earth is faced with a new extra-Solar threat. But will mankind's new space defenses be enough?",32.0,Roland Emmerich,Independence Day: Resurgence,2016,120,USA, 165000000,103144286,389681935,286537649,224681935,1
64525,111.0,"Action, Comedy",A suburban couple becomes embroiled in an international espionage plot when they discover that their seemingly perfect new neighbors are government spies.,34.0,Greg Mottola,Keeping Up with the Joneses,2016,105,USA, 40000000,14904426,29918745,15014319,-10081255,0
72522,139.0,"Animation, Adventure, Comedy","Storks have moved on from delivering babies to packages. But when an order for a baby appears, the best delivery stork must scramble to fix the error by delivering the baby.",56.0,"Nicholas Stoller, Doug Sweetland",Storks,2016,87,USA, 70000000,72679278,183388953,110709675,113388953,1
72608,198.0,Comedy,"When three overworked and under-appreciated moms are pushed beyond their limits, they ditch their conventional responsibilities for a jolt of long overdue freedom, fun and comedic self-indulgence.",60.0,"Jon Lucas, Scott Moore",Bad Moms,2016,100,USA, 20000000,113257297,183936074,70678777,163936074,1
72637,27.0,Comedy,"A comedy about a small New Jersey town on the night of Orson Welles' legendary 1938 ""War of the Worlds"" radio broadcast, which led millions of listeners to believe the U.S. was being invaded by Martians.",45.0,Jody Lambert,Brave New Jersey,2016,86,USA, 5000000,16544,16544,0,-4983456,0
72656,74.0,Comedy,An inexperienced college student meets a wealthy businessman whose sexual practices put a strain on their relationship.,28.0,Michael Tiddes,Fifty Shades of Black,2016,92,USA, 5000000,11686940,22227514,10540574,17227514,1
72710,194.0,"Drama, Romance","Retreating from life after a tragedy, a man questions the universe by writing to Love, Time and Death. Receiving unexpected answers, he begins to see how these things interlock and how even loss can reveal moments of meaning and beauty.",23.0,David Frankel,Collateral Beauty,2016,97,USA, 36000000,31016021,88528280,57512259,52528280,1
72998,69.0,"Biography, Drama, History","Lyndon B. Johnson aligns himself with John F. Kennedy, rises to the Presidency, and deals with the civil rights struggles of the 1960s.",54.0,Rob Reiner,LBJ,2016,98,USA, 26000000,2470979,2510151,39172,-23489849,0
72400,43.0,"Action, Drama, Sci-Fi","A young street magician (Jacob Latimore) is left to care for his little sister after their parents' passing, and turns to illegal activities to keep a roof over their heads. When he gets in...",62.0,J.D. Dillard,Sleight,2016,89,USA, 250000,3986245,3989705,3460,3739705,1
73018,317.0,"Drama, Horror, Mystery","Rebecca must unlock the terror behind her little brother's experiences that once tested her sanity, bringing her face to face with a supernatural spirit attached to their mother.",58.0,David F. Sandberg,Lights Out,2016,81,USA, 4900000,67268835,148868835,81600000,143968835,1
73120,45.0,Drama,"When a high school teacher is asked a question in class about Jesus, her response lands her in deep trouble.",22.0,Harold Cronk,God's Not Dead 2,2016,120,USA, 5000000,20774575,24487848,3713273,19487848,1
73200,418.0,"Biography, Drama, History",The story of a team of female African-American mathematicians who served a vital role in NASA during the early years of the U.S. space program.,74.0,Theodore Melfi,Hidden Figures,2016,127,USA, 25000000,169607287,235956898,66349611,210956898,1
73256,14.0,"Comedy, Romance","A playboy named Charlie, convinced that all his relationships are dead, meets the beautiful and mysterious Eva. Agreeing to a casual affair, Charlie then wants a bit more from their relationship.",41.0,Bille Woodruff,The Perfect Match,2016,96,USA, 5000000,9669521,10414738,745217,5414738,1
73344,16.0,"Comedy, Drama, Family","A washed-up former child star, forced to do community service at a local megachurch, pretends to be a Christian to land the part of Jesus in their annual Passion Play, only to discover that the most important role of his life is far from Hollywood.",36.0,Dallas Jenkins,The Resurrection of Gavin Stone,2016,91,USA, 2000000,2303792,2308355,4563,308355,1
73513,33.0,"Biography, Drama",The true story of,31.0,Brian Baugh,I'm Not Ashamed,2016,112,USA, 1500000,2082980,2082980,0,582980,1
73595,504.0,Drama,"A young African-American man grapples with his identity and sexuality while experiencing the everyday struggles of childhood, adolescence, and burgeoning adulthood.",99.0,Barry Jenkins,Moonlight,2016,111,USA, 4000000,27854932,65046687,37191755,61046687,1
73119,128.0,"Comedy, Drama, Romance",Three generations come together in the week leading up to Mother's Day.,18.0,Garry Marshall,Mother's Day,2016,118,USA, 25000000,32492859,48782670,16289811,23782670,1
72328,453.0,"Drama, Thriller","A wealthy art gallery owner is haunted by her ex-husband's novel, a violent thriller she interprets as a symbolic revenge tale.",67.0,Tom Ford,Nocturnal Animals,2016,116,USA, 22500000,10663357,30311857,19648500,7811857,1
72219,331.0,"Comedy, Drama, Romance","In the 1930s, a Bronx native moves to Hollywood and falls in love with a young woman who is seeing a married man.",64.0,Woody Allen,Caf√© Society,2016,96,USA, 30000000,11103205,43763247,32660042,13763247,1
70873,492.0,Drama,A depressed uncle is asked to take care of his teenage nephew after the boy's father dies.,96.0,Kenneth Lonergan,Manchester by the Sea,2016,137,USA, 9000000,47695371,78988148,31292777,69988148,1
70926,401.0,"Drama, Horror, Thriller","A mere 200 yards from shore, surfer Nancy is attacked by a great white shark, with her short journey to safety becoming the ultimate contest of wills.",59.0,Jaume Collet-Serra,The Shallows,2016,86,USA, 17000000,55124043,119100758,63976715,102100758,1
55529,13.0,"Drama, Fantasy","After his wife dies of cancer, an overworked engineer struggles to care for his son with autism. His son in response to bullying regresses into a fantasy world escape.",47.0,John Asher,A Boy Called Po,2016,95,USA, 1693000,4550,4550,0,-1688450,0
58533,180.0,"Animation, Adventure, Comedy","After the Bergens invade Troll Village, Poppy, the happiest Troll ever born, and the curmudgeonly Branch set off on a journey to rescue her friends.",56.0,"Mike Mitchell, Walt Dohrn",Trolls,2016,92,USA, 125000000,153707064,346864462,193157398,221864462,1
71377,16.0,"Comedy, Horror","As Carl Black gets the opportunity to move his family out of Chicago in hope of a better life, their arrival in Beverly Hills is timed with that city's annual purge, where all crime is legal for twelve hours.",26.0,Deon Taylor,Meet the Blacks,2016,94,USA, 900000,9097072,9097072,0,8197072,1
71397,35.0,"Comedy, Drama","""Mr. Church"" tells the story of a unique friendship that develops when a little girl and her dying mother retain the services of a talented cook - Henry Joseph Church. What begins as a six month arrangement instead spans into fifteen years and creates a family bond that lasts forever.",37.0,Bruce Beresford,Mr. Church,2016,104,USA, 8000000,685780,685780,0,-7314220,0
72244,184.0,"Action, Horror, Sci-Fi",A corporate risk-management consultant must decide whether or not to terminate an artificially created humanoid being.,48.0,Luke Scott,Morgan,2016,92,USA, 8000000,3915251,8809407,4894156,809407,1
71534,27.0,"Adventure, Drama","Brandon is a 15 year old whose dream is a pair of fresh Air Jordans. Soon after he gets his hands on them, they're stolen by a local hood, causing Brandon and his two friends to go on a dangerous mission through Oakland to retrieve them.",69.0,Justin Tipping,Kicks,2016,80,USA, 2000000,150191,150191,0,-1849809,0
71545,96.0,"Biography, Drama, History","The film chronicles the summer 1989 afternoon when the future President of the United States,",74.0,Richard Tanne,Southside with You,2016,84,USA, 1500000,6304223,6512004,207781,5012004,1
58772,309.0,"Animation, Adventure, Comedy",A sausage strives to discover the truth about his existence.,66.0,"Greg Tiernan, Conrad Vernon",Sausage Party,2016,89,USA, 19000000,97685686,140705322,43019636,121705322,1
71590,304.0,"Biography, Drama, History",The story of,66.0,John Lee Hancock,The Founder,2016,115,USA, 25000000,12786053,24121245,11335192,-878755,0
71752,135.0,"Drama, Horror, Romance","In a desert dystopia, a young woman is kidnapped by cannibals.",62.0,Ana Lily Amirpour,The Bad Batch,2016,118,USA, 6000000,180851,201890,21039,-5798110,0
71769,144.0,"Biography, Drama, Sport",A Ugandan girl sees her world rapidly change after being introduced to the game of chess.,73.0,Mira Nair,Queen of Katwe,2016,124,USA, 15000000,8874389,10367161,1492772,-4632839,0
71799,227.0,"Drama, Horror, Mystery","In 1967 Los Angeles, a widowed mother and her daughters add a new stunt to bolster their seance scam business by inviting an evil presence into their home, not realizing how dangerous it is.",65.0,Mike Flanagan,Ouija: Origin of Evil,2016,99,USA, 9000000,35144505,81705746,46561241,72705746,1
71866,217.0,"Comedy, Drama","The story of a teenage boy, his mother, and two other women who help raise him among the love and freedom of Southern California of 1979.",83.0,Mike Mills,20th Century Women,2016,119,USA, 7000000,5664764,7214806,1550042,214806,1
58903,257.0,"Crime, Thriller",A gang of criminals and corrupt cops plan the murder of a police officer in order to pull off their biggest heist yet across town.,52.0,John Hillcoat,Triple 9,2016,115,USA, 20000000,12639297,23119442,10480145,3119442,1
71541,71.0,"Biography, Drama, Family",Based on the incredible true story of the Beam family.,44.0,Patricia Riggen,Miracles from Heaven,2016,109,USA, 13000000,61705123,73883359,12178236,60883359,1
71207,147.0,"Action, Comedy, Crime","When the adorable kitten of an L.A. crime kingpin unexpectedly enters the life of two cousins, they will have to go through tough gangs, pitiless hit-men, and ruthless drug dealers who all claim him, to get him back. How hard can it be?",63.0,Peter Atencio,Keanu,2016,100,USA, 15000000,20591853,20651333,59480,5651333,1
60440,186.0,Comedy,"Right before his wedding, an uptight guy is tricked into driving his grandfather, a lecherous former Army Lieutenant Colonel, to Florida for Spring Break.",21.0,Dan Mazer,Dirty Grandpa,2016,102,USA, 25000000,35593113,94073028,58479915,69073028,1
55425,38.0,"Crime, Drama, Horror",A surrogate mom for a couple becomes dangerously obsessed with the soon-to-be father.,28.0,Jon Cassar,When the Bough Breaks,2016,107,USA, 10000000,29747603,30658387,910784,20658387,1
54389,168.0,"Comedy, Drama, Romance",A group of young adults navigate love and relationships in New York City.,51.0,Christian Ditter,How to Be Single,2016,110,USA, 38000000,46843513,112343513,65500000,74343513,1
64264,295.0,"Action, Crime, Drama","A group of Boston-bred gangsters set up shop in balmy Florida during the Prohibition era, facing off against the competition and the Ku Klux Klan.",49.0,Ben Affleck,Live by Night,2016,129,USA, 108000000,10378555,22678555,12300000,-85321445,0
65012,104.0,"Comedy, Crime",A guard at an armored car company in the Southern U.S. organizes one of the biggest bank heists in American history. Based on the October 1997 Loomis Fargo robbery.,47.0,Jared Hess,Masterminds,2016,95,USA, 25000000,17368022,29674699,12306677,4674699,1
66899,23.0,"Crime, Drama, Thriller",A guy wanted around town by various hitmen hopes to stay alive long enough for his life insurance policy to kick in and pay out for his estranged daughter.,23.0,Peter Billingsley,Term Life,2016,93,USA, 16500000,21256,243793,222537,-16256207,0
66238,241.0,"Action, Adventure, Comedy","The adventures of an orphaned boy named Pete and his best friend Elliot, who just so happens to be a dragon.",71.0,David Lowery,Pete's Dragon,2016,102,USA, 65000000,76233151,143695338,67462187,78695338,1
66887,787.0,"Action, Adventure, Sci-Fi","Fearing that the actions of Superman are left unchecked, Batman takes on the Man of Steel, while the world wrestles with what kind of a hero it really needs.",44.0,Zack Snyder,Batman v Superman: Dawn of Justice,2016,151,USA, 250000000,330360194,873634919,543274725,623634919,1
50899,38.0,"Drama, Fantasy",Tells the story of,33.0,Cyrus Nowrasteh,The Young Messiah,2016,111,USA, 18500000,6490401,7330338,839937,-11169662,0
66792,14.0,"Biography, Family, Sport","The story of Brandon Burlsworth, possibly the greatest walk-on in the history of college football.",35.0,David L. Hunt,Greater,2016,130,USA, 9000000,2000093,2000093,0,-6999907,0
53348,281.0,"Biography, Drama, History","A true-life drama, centering on British explorer Major Percival Fawcett, who disappeared whilst searching for a mysterious city in the Amazon in the 1920s.",78.0,James Gray,The Lost City of Z,2016,141,USA, 30000000,8580410,19263938,10683528,-10736062,0
66770,474.0,"Animation, Adventure, Comedy","In a city of anthropomorphic animals, a rookie bunny cop and a cynical con artist fox must work together to uncover a conspiracy.",78.0,"Byron Howard, Rich Moore",Zootopia,2016,108,USA, 150000000,341268248,1023784195,682515947,873784195,1
66725,272.0,Comedy,"In 1980, a group of college baseball players navigate their way through the freedoms and responsibilities of unsupervised adulthood.",83.0,Richard Linklater,Everybody Wants Some!!,2016,117,USA, 10000000,3400278,4644472,1244194,-5355528,0
61624,202.0,"Drama, History, Thriller",The Coast Guard makes a daring rescue attempt off the coast of Cape Cod after a pair of oil tankers are destroyed during a blizzard in 1952.,58.0,Craig Gillespie,The Finest Hours,2016,117,USA, 80000000,27569558,52099090,24529532,-27900910,0
53334,571.0,"Action, Adventure, Fantasy","While on a journey of physical and spiritual healing, a brilliant neurosurgeon is drawn into the world of the mystic arts.",72.0,Scott Derrickson,Doctor Strange,2016,115,USA, 165000000,232641920,677718395,445076475,512718395,1
52966,514.0,"Drama, Horror, Mystery","After getting in a car accident, a woman is held in a shelter with two men, who claim the outside world is affected by a widespread chemical attack.",76.0,Dan Trachtenberg,10 Cloverfield Lane,2016,103,USA, 15000000,72082998,110216998,38134000,95216998,1
65528,422.0,"Action, Crime, Drama",A divorced father and his ex-con older brother resort to a desperate scheme in order to save their family's ranch in West Texas.,88.0,David Mackenzie,Hell or High Water,2016,102,USA, 12000000,27007844,37879877,10872033,25879877,1
63589,551.0,"Animation, Adventure, Comedy","Friendly but forgetful blue tang Dory begins a search for her long-lost parents, and everyone learns a few things about the real meaning of family along the way.",77.0,"Andrew Stanton, Angus MacLane",Finding Dory,2016,97,USA, 200000000,486295561,1028570889,542275328,828570889,1
66478,128.0,"Action, Comedy, Crime","As his wedding day approaches, Ben heads to Miami with his soon-to-be brother-in-law James to bring down a drug dealer who's supplying the dealers of Atlanta with product.",32.0,Tim Story,Ride Along 2,2016,102,USA, 40000000,91221830,124605297,33383467,84605297,1
63308,330.0,"Crime, Drama, Thriller",Financial TV host Lee Gates and his producer Patty are put in an extreme situation when an irate investor takes them and their crew as hostage.,55.0,Jodie Foster,Money Monster,2016,98,USA, 27000000,41012075,93282604,52270529,66282604,1
65754,224.0,"Action, Adventure, Drama","Judah Ben-Hur, a prince falsely accused of treason by his adopted brother, an officer in the Roman army, returns to his homeland after years at sea to seek revenge, but finds redemption.",38.0,Timur Bekmambetov,Ben-Hur,2016,123,USA, 100000000,26410477,94061311,67650834,-5938689,0
66341,171.0,"Comedy, Romance","Two hard-partying brothers place an online ad to find the perfect dates for their sister's Hawaiian wedding. Hoping for a wild getaway, the boys instead find themselves out-hustled by an uncontrollable duo.",51.0,Jake Szymanski,Mike and Dave Need Wedding Dates,2016,98,USA, 33000000,46009673,77068246,31058573,44068246,1
62543,330.0,"Action, Crime, Drama","As a math savant uncooks the books for a new client, the Treasury Department closes in on his activities, and the body count starts to rise.",51.0,Gavin O'Connor,The Accountant,2016,128,USA, 44000000,86260045,155160045,68900000,111160045,1
65961,177.0,Comedy,"A titan of industry is sent to prison after she's caught insider trading. When she emerges ready to rebrand herself as America's latest sweetheart, not everyone she screwed over is so quick to forgive and forget.",40.0,Ben Falcone,The Boss,2016,99,USA, 29000000,63285885,78844582,15558697,49844582,1
51877,191.0,"Horror, Thriller","In a twisted social experiment, eighty Americans are locked in their high-rise corporate office in Bogot√°, Colombia, and ordered by an unknown voice coming from the company's intercom system to participate in a deadly game of kill or be killed.",44.0,Greg McLean,The Belko Experiment,2016,89,USA, 5000000,10166820,11084630,917810,6084630,1
52317,180.0,"Action, Biography, Drama",A disillusioned Confederate army deserter returns to Mississippi and leads a militia of fellow deserters and women in an uprising against the corrupt local Confederate government.,53.0,Gary Ross,Free State of Jones,2016,139,USA, 50000000,20810036,25035950,4225914,-24964050,0
64301,57.0,"Drama, Horror, Thriller",A mother and her young son release unimaginable horrors from the attic of their rural dream home.,31.0,D.J. Caruso,The Disappointments Room,2016,85,USA, 15000000,2423468,5745040,3321572,-9254960,0
64746,378.0,"Action, Adventure, Western",Seven gunmen from a variety of backgrounds are brought together by a vengeful young widow to protect her town from the private army of a destructive industrialist.,54.0,Antoine Fuqua,The Magnificent Seven,2016,132,USA, 90000000,93432655,162360636,68927981,72360636,1
68065,406.0,"Biography, Drama","The story of Chesley ""Sully"" Sullenberger (Tom Hanks), an American pilot who became a hero after landing his damaged plane on the Hudson River in order to save the flight's passengers and crew.",74.0,Clint Eastwood,Sully,2016,96,USA, 60000000,125070033,240797623,115727590,180797623,1
67898,74.0,"Horror, Thriller","A scientist with the ability to enter the subconscious minds of the possessed must save a young boy from the grips of a demon with powers never seen before, while facing the horrors of his past.",30.0,Brad Peyton,Incarnate,2016,91,USA, 5000000,4799774,6341855,1542081,1341855,1
55206,13.0,"Adventure, Crime, Drama","A young street artist in East Los Angeles is caught between his father's obsession with lowrider car culture, his ex-felon brother and his need for self-expression.",57.0,Ricardo de Montreuil,Lowriders,2016,98,USA, 5000000,6303560,6312033,8473,1312033,1
67950,138.0,"Action, Drama, History","In 33 AD, a Roman Tribune in Judea is tasked to find the missing body of",51.0,Kevin Reynolds,Risen,2016,107,USA, 20000000,36880033,46069568,9189535,26069568,1
61212,77.0,"Comedy, Drama",A look at the life of an aging insult comic named Jack Burke.,40.0,Taylor Hackford,The Comedian,2016,120,USA, 15000000,1659002,1659002,0,-13340998,0
55393,679.0,"Action, Adventure, Fantasy",A secret government agency recruits some of the most dangerous incarcerated super-villains to form a defensive task force. Their first mission: save the world from the apocalypse.,40.0,David Ayer,Suicide Squad,2016,123,USA, 175000000,325100054,746846894,421746840,571846894,1
61252,145.0,"Comedy, Drama, Romance","The unconventional love story of an aspiring actress, her ambitious driver, and their eccentric boss, the legendary billionaire",60.0,Warren Beatty,Rules Don't Apply,2016,127,USA, 25000000,3652206,3885342,233136,-21114658,0
66171,514.0,"Family, Fantasy, Musical","A selfish prince is cursed to become a monster for the rest of his life, unless he learns to fall in love with a beautiful young woman he keeps prisoner.",65.0,Bill Condon,Beauty and the Beast,2017,129,USA, 160000000,504014165,1263521126,759506961,1103521126,1
63692,5.0,"Action, Biography, Crime","Raving through realty on the eve of the economic collapse. A high-velocity journey of an unsuspecting mortgage broker swallowed up in the sex, greed and over indulgence of the mid 2000's Real Estate boom.",25.0,Theo Avgerinos,Americons,2017,89,USA, 1250000,28782,28782,0,-1221218,0
65455,185.0,"Comedy, Crime","Desperate to pay the bills and come through for their loved ones, three lifelong pals risk it all by embarking on a daring bid to knock off the very bank that absconded with their money.",50.0,Zach Braff,Going in Style,2017,96,USA, 25000000,45018541,84918541,39900000,59918541,1
75856,212.0,Drama,"On Coney Island in the 1950s, a lifeguard tells the story of a middle-aged carousel operator, his beleaguered wife, and the visitor who turns their lives upside-down.",45.0,Woody Allen,Wonder Wheel,2017,101,USA, 25000000,1404061,15889124,14485063,-9110876,0
72136,98.0,"Comedy, Crime","After the town takes away their daughter's college scholarship, a couple start an illegal casino in their friend's house to make back the money.",30.0,Andrew Jay Cohen,The House,2017,88,USA, 40000000,25584504,34184504,8600000,-5815496,0
72135,200.0,Drama,"Frank, a single man raising his child prodigy niece Mary, is drawn into a custody battle with his mother.",60.0,Marc Webb,Gifted,2017,101,USA, 7000000,24801212,43069254,18268042,36069254,1
75872,13.0,"Crime, Drama, Mystery","The true story of the infamous prison break of Gary Tison and Randy Greenwalt from the Arizona State prison in Florence, AZ, in the summer of 1978.",50.0,Dwight H. Little,Last Rampage: The Escape of Gary Tison,2017,93,USA, 6000000,6294,12944,6650,-5987056,0
71896,35.0,"Action, Drama, Western","A thrilling and action-packed Western, The Ballad of Lefty Brown is a story about loyalty, friendship, and the relentless pursuit of justice.",64.0,Jared Moshe,The Ballad of Lefty Brown,2017,111,USA, 8000000,7856,7856,0,-7992144,0
62545,72.0,"Biography, Drama, History",The dramatic story of the cutthroat race between electricity titans Thomas Edison and George Westinghouse to determine whose electrical system would power the modern world.,55.0,Alfonso Gomez-Rejon,The Current War,2017,102,USA, 30000000,5834002,10710119,4876117,-19289881,0
75102,37.0,"Biography, Drama, History","A group of journalists covering former President George W. Bush's planned invasion of Iraq in 2003 are skeptical of the President's claim that Saddam Hussein has ""weapons of mass destruction.""",47.0,Rob Reiner,Shock and Awe,2017,90,USA, 18000000,77980,182415,104435,-17817585,0
63400,552.0,"Action, Adventure, Sci-Fi","Peter Parker balances his life as an ordinary high school student in Queens with his superhero alter-ego Spider-Man, and finds himself on the trail of a new menace prowling the skies of New York City.",73.0,Jon Watts,Spider-Man: Homecoming,2017,133,USA, 175000000,334201140,880166924,545965784,705166924,1
72395,118.0,"Crime, Drama, Thriller","With instructions from her genius son's carefully crafted notebook, a single mother sets out to rescue a young girl from the hands of her abusive stepfather.",31.0,Colin Trevorrow,The Book of Henry,2017,105,USA, 10000000,4504974,4596705,91731,-5403295,0
74948,222.0,"Drama, Western","In 1892, a legendary Army Captain reluctantly agrees to escort a Cheyenne chief and his family through dangerous territory.",65.0,Scott Cooper,Hostiles,2017,134,USA, 39000000,29819114,35669017,5849903,-3330983,0
74886,328.0,"Comedy, Drama, Romance","Pakistan-born comedian Kumail Nanjiani and grad student Emily Gardner fall in love but struggle as their cultures clash. When Emily contracts a mysterious illness, Kumail finds himself forced to face her feisty parents, his family's expectations, and his true feelings.",86.0,Michael Showalter,The Big Sick,2017,120,USA, 5000000,42873127,56411585,13538458,51411585,1
74556,287.0,"Horror, Mystery, Thriller","A college student must relive the day of her murder over and over again, in a loop that will end only when she discovers her killer's identity.",58.0,Christopher Landon,Happy Death Day,2017,96,USA, 4800000,55683845,125479266,69795421,120679266,1
63198,165.0,"Action, Adventure, Drama","Stranded after a tragic plane crash, two strangers must forge a connection to survive the extreme elements of a remote snow-covered mountain. When they realize help is not coming, they embark on a perilous journey across the wilderness.",48.0,Hany Abu-Assad,The Mountain Between Us,2017,112,USA, 35000000,30348555,62832209,32483654,27832209,1
74813,388.0,"Horror, Sci-Fi, Thriller",A team of scientists aboard the International Space Station discover a rapidly evolving life form that caused extinction on Mars and now threatens all life on Earth.,54.0,Daniel Espinosa,Life,2017,104,USA, 58000000,30234022,100541806,70307784,42541806,1
76335,63.0,"Comedy, Family",A Heffley family road trip to attend Meemaw's 90th birthday party goes hilariously off course thanks to Greg's newest scheme to get to a video gaming convention.,39.0,David Bowers,Diary of a Wimpy Kid: The Long Haul,2017,91,USA, 22000000,20738724,40140972,19402248,18140972,1
75400,145.0,Comedy,"Having finally gotten used to each other's existence, Brad and Dusty must now deal with their intrusive fathers during the holidays.",30.0,Sean Anders,Daddy's Home 2,2017,100,USA, 69000000,104029443,180613180,76583737,111613180,1
72434,59.0,"Animation, Adventure, Comedy",A small but brave donkey and his animal friends become the unsung heroes of the first Christmas.,42.0,Timothy Reckart,The Star,2017,86,USA, 20000000,40852824,62812974,21960150,42812974,1
73275,154.0,"Animation, Adventure, Comedy","Gene, a multi-expressional emoji, sets out on a journey to become a normal emoji.",12.0,Tony Leondis,The Emoji Movie,2017,86,USA, 50000000,86089513,217776646,131687133,167776646,1
73199,273.0,"Crime, Drama, Thriller","After a botched bank robbery lands his younger brother in prison, Connie Nikas embarks on a twisted odyssey through New York City's underworld to get his brother Nick out of jail.",80.0,"Benny Safdie, Josh Safdie",Good Time,2017,101,USA, 4500000,2026499,3283369,1256870,-1216631,0
48017,207.0,"Drama, Horror, Mystery",A young woman finds herself on the receiving end of a terrifying curse that threatens to take her life in 7 days.,25.0,F. Javier Guti√©rrez,Rings,2017,102,USA, 25000000,27793018,83080890,55287872,58080890,1
74765,312.0,"Crime, Drama, History",Fact-based drama set during the 1967 Detroit riots in which a group of rogue police officers respond to a complaint with retribution rather than justice on their minds.,77.0,Kathryn Bigelow,Detroit,2017,143,USA, 34000000,16790139,23355100,6564961,-10644900,0
73054,175.0,"Comedy, Crime, Thriller",Things go terribly wrong for a group of girlfriends who hire a male stripper for a bachelorette party in Miami.,51.0,Lucia Aniello,Rough Night,2017,101,USA, 20000000,22105643,47347283,25241640,27347283,1
75382,360.0,Drama,"Set over one summer, the film follows precocious six-year-old Moonee as she courts mischief and adventure with her ragtag playmates and bonds with her rebellious but caring mother, all while living in the shadows of Walt Disney World.",92.0,Sean Baker,The Florida Project,2017,111,USA, 2000000,5904366,10971298,5066932,8971298,1
47841,118.0,"Action, Comedy, Crime","A rookie officer is teamed with a hardened pro at the California Highway Patrol, though the newbie soon learns his partner is really an undercover Fed investigating a heist that may involve some crooked cops.",28.0,Dax Shepard,CHIPS,2017,100,USA, 25000000,18600152,26800152,8200000,1800152,1
72948,141.0,"Comedy, Music","Following their win at the world championship, the now separated Bellas reunite for one last singing competition at an overseas USO tour, but face a group who uses both instruments and voices.",40.0,Trish Sie,Pitch Perfect 3,2017,93,USA, 45000000,104897530,185400345,80502815,140400345,1
72758,322.0,"Horror, Mystery","Secure within a desolate home as an unnatural threat terrorizes the world, a man has established a tenuous domestic order with his wife and son. Then a desperate young family arrives seeking refuge.",78.0,Trey Edward Shults,It Comes at Night,2017,91,USA, 5000000,13985117,19280931,5295814,14280931,1
73415,449.0,"Comedy, Drama","In 2002, an artistically inclined seventeen-year-old girl comes of age in Sacramento, California.",94.0,Greta Gerwig,Lady Bird,2017,94,USA, 10000000,48958273,78965611,30007338,68965611,1
64427,159.0,"Biography, Drama",A young girl comes of age in a dysfunctional family of nonconformist nomads with a mother who's an eccentric artist and an alcoholic father who would stir the children's imagination with hope as a distraction to their poverty.,56.0,Destin Daniel Cretton,The Glass Castle,2017,127,USA, 9000000,17273059,22088533,4815474,13088533,1
64453,395.0,"Animation, Adventure, Family","Aspiring musician Miguel, confronted with his family's ancestral ban on music, enters the Land of the Dead to find his great-great-grandfather, a legendary singer.",81.0,"Lee Unkrich, Adrian Molina",Coco,2017,105,USA, 175000000,209726015,807082196,597356181,632082196,1
75381,168.0,"Crime, Drama, Thriller","Two upper-class teenage girls in suburban Connecticut rekindle their unlikely friendship after years of growing apart. Together, they hatch a plan to solve both of their problems-no matter what the cost.",75.0,Cory Finley,Thoroughbreds,2017,92,USA, 6000000,3072605,3187255,114650,-2812745,0
72686,45.0,"Drama, Thriller","A haunted young woman spirals in the wake of profound loss, torn between her fractured emotional state and the reality-altering effects of a potent cannabinoid drug.",39.0,"Kate Mulleavy, Laura Mulleavy",Woodshock,2017,100,USA, 5000000,42603,43682,1079,-4956318,0
73666,100.0,"Drama, Romance",A teenager who's spent her whole life confined to her home falls for the boy next door.,52.0,Stella Meghie,"Everything, Everything",2017,96,USA, 10000000,34121140,61621140,27500000,51621140,1
72646,19.0,Drama,"When a group of Burmese refugees join the congregation, the pastor of a failing Anglican church attempts to aid them by planting crops and enlisting the help of the community.",63.0,Steve Gomer,All Saints,2017,108,USA, 2000000,5802208,5942565,140357,3942565,1
77672,66.0,"Horror, Mystery, Sci-Fi","20 years after three teenagers disappeared in the wake of mysterious lights appearing above Phoenix, Arizona, unseen footage from that night has been discovered, chronicling the final hours of their fateful expedition.",33.0,Justin Barber,Phoenix Forgotten,2017,87,USA, 2800000,3600146,3697729,97583,897729,1
75224,334.0,"Drama, Thriller",The unexpected arrival of a wounded Union soldier at a girls school in Virginia during the American Civil War leads to jealousy and betrayal.,77.0,Sofia Coppola,The Beguiled,2017,93,USA, 10500000,10709995,27397655,16687660,16897655,1
73979,525.0,"Drama, Horror, Mystery","A couple's relationship is tested when uninvited guests arrive at their home, disrupting their tranquil existence.",75.0,Darren Aronofsky,Mother!,2017,121,USA, 30000000,17800004,44516999,26716995,14516999,1
65276,690.0,"Action, Adventure, Fantasy","Rey develops her newly discovered abilities with the guidance of Luke Skywalker, who is unsettled by the strength of her powers. Meanwhile, the Resistance prepares for battle with the First Order.",85.0,Rian Johnson,Star Wars: Episode VIII - The Last Jedi,2017,152,USA, 317000000,620181382,1332539889,712358507,1015539889,1
75592,122.0,"Comedy, Drama, Romance",Life for a single mom in Los Angeles takes an unexpected turn when she allows three young guys to move in with her.,41.0,Hallie Meyers-Shyer,Home Again,2017,97,USA, 12000000,27020284,37270721,10250437,25270721,1
74069,282.0,"Horror, Mystery, Thriller","Twelve years after the tragic death of their little girl, a doll-maker and his wife welcome a nun and several girls from a shuttered orphanage into their home, where they become the target of the doll-maker's possessed creation, Annabelle.",62.0,David F. Sandberg,Annabelle: Creation,2017,109,USA, 15000000,102092201,306515884,204423683,291515884,1
75597,29.0,"Action, Comedy","A two-hander action comedy in the vein of Midnight Run (1988), about an ex-F.B.I. Agent (Tommy Lee Jones) and an ex-mob lawyer in the Witness Protection Program (Morgan Freeman) having to put aside their petty rivalry on the golf course to fend off a mob hit.",21.0,Ron Shelton,Just Getting Started,2017,91,USA, 22000000,6069605,7634022,1564417,-14365978,0
64058,161.0,"Action, Adventure, Comedy","When her boyfriend dumps her before their exotic vacation, a young woman persuades her ultra-cautious mother to travel with her to paradise, with unexpected results.",45.0,Jonathan Levine,Snatched,2017,90,USA, 42000000,45852178,60845711,14993533,18845711,1
58669,153.0,"Drama, Fantasy, Mystery","February 12 is just another day in Sam's charmed life, until it turns out to be her last. Stuck reliving her last day over and over, Sam untangles the mystery around her death and discovers everything she's losing.",58.0,Ry Russo-Young,Before I Fall,2017,98,USA, 5000000,12241122,16373843,4132721,11373843,1
74808,341.0,"Comedy, Crime, Drama",Two brothers attempt to pull off a heist during a NASCAR race in North Carolina.,78.0,Steven Soderbergh,Logan Lucky,2017,118,USA, 29000000,27780977,48453605,20672628,19453605,1
70426,173.0,"Biography, Drama","Stronger is the inspiring real life story of Jeff Bauman, an ordinary man who captured the hearts of his city and the world to become a symbol of hope after surviving the 2013 Boston Marathon bombing.",76.0,David Gordon Green,Stronger,2017,119,USA, 30000000,4211129,8484418,4273289,-21515582,0
61322,181.0,"Action, Sci-Fi, Thriller","When the network of satellites designed to control the global climate starts to attack Earth, it's a race against the clock for its creator to uncover the real threat before a worldwide Geostorm wipes out everything and everyone.",21.0,Dean Devlin,Geostorm,2017,109,USA, 120000000,33700160,221600160,187900000,101600160,1
70402,187.0,"Animation, Adventure, Comedy","A suit-wearing, briefcase-carrying baby pairs up with his 7-year old brother to stop the dastardly plot of the CEO of Puppy Co.",50.0,Tom McGrath,The Boss Baby,2017,97,USA, 125000000,175003033,527965936,352962903,402965936,1
68804,98.0,"Drama, Thriller",A woman sets out to make life a living hell for her ex-husband's new fianc√©e.,45.0,Denise Di Novi,Unforgettable,2017,100,USA, 12000000,11368012,17768012,6400000,5768012,1
68833,259.0,"Animation, Adventure, Comedy","Gru meets his long-lost charming, cheerful, and more successful twin brother Dru who wants to team up with him for one last criminal heist.",49.0,"Kyle Balda, Pierre Coffin",Despicable Me 3,2017,89,USA, 80000000,264624300,1034799409,770175109,954799409,1
77076,308.0,"Drama, Fantasy, Romance","In this singular exploration of legacy, love, loss, and the enormity of existence, a recently deceased, white-sheeted ghost returns to his suburban home to try to reconnect with his bereft wife.",84.0,David Lowery,A Ghost Story,2017,92,USA, 100000,1596371,1951683,355312,1851683,1
59699,66.0,"Crime, Horror, Mystery",Two estranged sisters are forced to rob a bank in order to save their brother. But this is no ordinary bank.,50.0,Dan Bush,The Vault,2017,91,USA, 5000000,5728,346729,341001,-4653271,0
61937,111.0,"Action, Crime, Thriller",A cop with a connection to the criminal underworld scours a nightclub in search of his kidnapped son.,34.0,Baran bo Odar,Sleepless,2017,95,USA, 30000000,20783704,32917353,12133649,2917353,1
59733,402.0,"Action, Adventure, Fantasy",Captain Jack Sparrow (Johnny Depp) searches for the trident of Poseidon while being pursued by an undead sea Captain and his crew.,39.0,"Joachim R√∏nning, Espen Sandberg",Pirates of the Caribbean: Dead Men Tell No Tales,2017,129,USA, 230000000,172558876,794861794,622302918,564861794,1
70227,171.0,"Action, Biography, Drama","Based on the true story of the Granite Mountain Hotshots, a group of elite firefighters who risk everything to protect a town from a historic wildfire.",72.0,Joseph Kosinski,Only the Brave,2017,134,USA, 38000000,18343983,25754775,7410792,-12245225,0
61201,57.0,"Comedy, Drama, Sport","Upon learning that their mother has been lying to them for years about their allegedly deceased father, two fraternal twin brothers hit the road in order to find him.",22.0,Lawrence Sher,Father Figures,2017,113,USA, 25000000,17501244,25601244,8100000,601244,1
68983,509.0,"Action, Adventure, Comedy","Imprisoned on the planet Sakaar, Thor must race against time to return to Asgard and stop Ragnar√∂k, the destruction of his world, at the hands of the powerful and ruthless villain Hela.",74.0,Taika Waititi,Thor: Ragnarok,2017,130,USA, 180000000,315058289,853977126,538918837,673977126,1
69058,371.0,"Biography, Comedy, Drama",When,76.0,James Franco,The Disaster Artist,2017,104,USA, 10000000,21120616,29820616,8700000,19820616,1
53568,28.0,"Biography, Drama","International art dealer Ron Hall must befriend a dangerous homeless man in order to save his struggling marriage to his wife, a woman whose dreams will lead all three of them on the journey of their lives.",47.0,Michael Carney,Same Kind of Different as Me,2017,119,USA, 15000000,6423605,6423605,0,-8576395,0
61373,144.0,"Comedy, Drama",A comedic look at the relationship between a wealthy man with quadriplegia and an unemployed man with a criminal record who's hired to help him.,46.0,Neil Burger,The Upside,2017,126,USA, 37500000,108252517,122752517,14500000,85252517,1
69386,271.0,"Animation, Adventure, Comedy",Lightning McQueen sets out to prove to a new generation of racers that he's still the best race car in the world.,59.0,Brian Fee,Cars 3,2017,102,USA, 175000000,152901115,383930656,231029541,208930656,1
70484,572.0,"Action, Adventure, Comedy","The Guardians struggle to keep together as a team while dealing with their personal family issues, notably Star-Lord's encounter with his father the ambitious celestial being Ego.",67.0,James Gunn,Guardians of the Galaxy Vol. 2,2017,136,USA, 200000000,389813101,863756051,473942950,663756051,1
56390,325.0,"Biography, Drama, Musical",Celebrates the birth of show business and tells of a visionary who rose from nothing to create a spectacle that became a worldwide sensation.,48.0,Michael Gracey,The Greatest Showman,2017,105,USA, 84000000,174340174,434993183,260653009,350993183,1
68573,120.0,Comedy,"When one school teacher unwittingly causes another teacher's dismissal, he is challenged to an after-school fight.",37.0,Richie Keen,Fist Fight,2017,91,USA, 22000000,32187017,41087017,8900000,19087017,1
58360,124.0,"Biography, Drama, Music","Tells the true and untold story of prolific rapper, actor, poet and activist Tupac Shakur.",38.0,Benny Boom,All Eyez on Me,2017,139,USA, 40000000,44922302,55668698,10746396,15668698,1
76629,43.0,"Biography, Drama",An investigative journalist and self-proclaimed atheist sets out to disprove the existence of God after his wife becomes a Christian.,50.0,Jon Gunn,The Case for Christ,2017,112,USA, 5000000,14682684,17644496,2961812,12644496,1
55643,116.0,"Comedy, Drama, Romance","Eloise, having been relieved of maid of honor duties after being unceremoniously dumped by the best man via text, decides to attend the wedding anyway, only to find herself seated with five fellow unwanted guests at the dreaded Table 19.",40.0,Jeffrey Blitz,Table 19,2017,87,USA, 5000000,3614896,5042014,1427118,42014,1
76963,39.0,"Comedy, Drama, Horror","Madea, Bam, and Hattie venture to a haunted campground and the group must run for their lives when monsters, goblins, and the boogeyman are unleashed.",17.0,Tyler Perry,Tyler Perry's Boo 2! A Madea Halloween,2017,101,USA, 25000000,47319572,48333932,1014360,23333932,1
60976,20.0,"Drama, Romance",A novelist blinded in a car crash which killed his wife rediscovers his passion for both life and writing when he embarks on an affair with the neglected wife of an indicted businessman.,36.0,Michael Mailer,Blind,2017,98,USA, 2500000,12522,98280,85758,-2401720,0
66494,99.0,"Drama, Fantasy","A grieving man receives a mysterious, personal invitation to meet with God at a place called ""The Shack.""",32.0,Stuart Hazeldine,The Shack,2017,132,USA, 20000000,57386418,96942115,39555697,76942115,1
58165,344.0,"Action, Adventure, Fantasy",A boy haunted by visions of a dark tower from a parallel reality teams up with the tower's disillusioned guardian to stop an evil warlock known as the Man in Black who plans to use the boy to destroy the tower and open the gates of Hell.,34.0,Nikolaj Arcel,The Dark Tower,2017,95,USA, 60000000,50701325,113231078,62529753,53231078,1
56124,107.0,"Crime, Drama, Thriller",A mother stops at nothing to recover her kidnapped son.,44.0,Luis Prieto,Kidnap,2017,95,USA, 21000000,30971040,34814102,3843062,13814102,1
68250,622.0,"Action, Drama, Sci-Fi","In a future where mutants are nearly extinct, an elderly and weary Logan leads a quiet life. But when Laura, a mutant child pursued by scientists, comes to him for help, he must get her to safety.",77.0,James Mangold,Logan,2017,137,USA, 97000000,226277068,619021436,392744368,522021436,1
61162,219.0,"Action, Thriller","After the death of his girlfriend at the hands of terrorists, Mitch Rapp is drawn into the world of counterterrorism, mentored by tough-as-nails former U.S. Navy S.E.A.L. Stan Hurley.",45.0,Michael Cuesta,American Assassin,2017,112,USA, 33000000,36249674,67234188,30984514,34234188,1
70591,150.0,"Drama, Romance, Sci-Fi","The first human born on Mars travels to Earth for the first time, experiencing the wonders of the planet through fresh eyes. He embarks on an adventure with a street smart girl to discover how he came to be.",33.0,Peter Chelsom,The Space Between Us,2017,120,USA, 30000000,7885294,14793385,6908091,-15206615,0
77776,541.0,"Drama, Horror, Sci-Fi","In a post-apocalyptic world, a family is forced to live in silence while hiding from monsters with ultra-sensitive hearing.",82.0,John Krasinski,A Quiet Place,2018,90,USA, 17000000,188024361,340939361,152915000,323939361,1
77967,203.0,"Horror, Thriller",A harmless game of Truth or Dare among friends turns deadly when someone -- or something -- begins to punish those who tell a lie or refuse the dare.,35.0,Jeff Wadlow,Truth or Dare,2018,100,USA, 3500000,41411015,95330493,53919478,91830493,1
79034,137.0,"Comedy, Drama",A couple find themselves in over their heads when they foster three children.,57.0,Sean Anders,Instant Family,2018,118,USA, 48000000,67363237,120556201,53192964,72556201,1
79470,60.0,"Action, Crime, Thriller","With retirement on his mind, a successful young drug dealer sets up one last big job, while dealing with trigger-happy colleagues and the police.",52.0,Director X.,Superfly,2018,116,USA, 16000000,20545116,20780685,235569,4780685,1
79270,153.0,Drama,A drug addicted teenage boy shows up unexpectedly at his family's home on Christmas Eve.,66.0,Peter Hedges,Ben Is Back,2018,103,USA, 13000000,3703184,10134204,6431020,-2865796,0
74893,515.0,"Action, Adventure, Comedy","Foul-mouthed mutant mercenary Wade Wilson (a.k.a. Deadpool), brings together a team of fellow mutant rogues to protect a young boy with supernatural abilities from the brutal, time-traveling cyborg Cable.",66.0,David Leitch,Deadpool 2,2018,119,USA, 110000000,324591735,785046920,460455185,675046920,1
78995,16.0,Drama,A pair of twin brothers from East L.A. choose to live their lives differently and end up on opposite sides of the law.,46.0,Ben Hernandez Bray,El Chicano,2018,108,USA, 8000000,1400603,1404646,4043,-6595354,0
77984,98.0,Comedy,A group of high school dropouts are forced to attend night school in hope that they'll pass the GED exam to finish high school.,43.0,Malcolm D. Lee,Night School,2018,111,USA, 29000000,77339130,103105878,25766748,74105878,1
77401,76.0,"Action, Crime, Drama","Mary (Taraji P. Henson) is a hit woman working for an organized crime family in Boston, whose life is completely turned around when she meets a young boy whose path she crosses when a professional hit goes bad.",35.0,Babak Najafi,Proud Mary,2018,89,USA, 14000000,20877013,21753365,876352,7753365,1
79013,32.0,"Adventure, Biography, Drama",The story covers Paul going from the most infamous persecutor of Christians to,52.0,Andrew Hyatt,"Paul, Apostle of Christ",2018,108,USA, 5000000,17560475,23039243,5478768,18039243,1
79067,111.0,"Animation, Action, Comedy",A villain's maniacal plan for world domination sidetracks five teenage superheroes who dream of Hollywood stardom.,69.0,"Aaron Horvath, Peter Rida Michail",Teen Titans Go! To the Movies,2018,84,USA, 10000000,29790236,52090236,22300000,42090236,1
75052,166.0,"Adventure, Family, Fantasy",A young girl is transported into a magical world of gingerbread soldiers and an army of mice.,39.0,"Lasse Hallstr√∂m, Joe Johnston",The Nutcracker and the Four Realms,2018,99,USA, 120000000,54858851,173961069,119102218,53961069,1
75191,159.0,"Crime, Drama","Starr witnesses the fatal shooting of her childhood best friend Khalil at the hands of a police officer. Now, facing pressure from all sides of the community, Starr must find her voice and stand up for what's right.",81.0,George Tillman Jr.,The Hate U Give,2018,133,USA, 23000000,29719483,34934009,5214526,11934009,1
75305,128.0,Comedy,"After her husband abruptly asks for a divorce, a middle-aged mother returns to college in order to complete her degree.",46.0,Ben Falcone,Life of the Party,2018,105,USA, 30000000,53059911,65859911,12800000,35859911,1
78978,46.0,"Comedy, Drama, Romance",A group of interconnected people in Los Angeles are brought together by their lovely canine counterparts.,47.0,Ken Marino,Dog Days,2018,113,USA, 10000000,6809080,6819044,9964,-3180956,0
75439,42.0,"Action, Crime, Drama","A couple off for a romantic weekend in the mountains are accosted by a biker gang. Alone in the mountains, Brea and John must defend themselves against the gang, who will stop at nothing to protect their secrets.",37.0,Deon Taylor,Traffik,2018,96,USA, 4000000,9186156,9515914,329758,5515914,1
76371,106.0,"Action, Crime, Drama","Chased by a vengeful criminal, the feds and a gang of otherworldly soldiers, a recently released ex-con, and his adopted teenage brother are forced to go on the run with a weapon of mysterious origin as their only protection.",35.0,"Jonathan Baker, Josh Baker",Kin,2018,102,USA, 30000000,5718096,10313019,4594923,-19686981,0
77259,276.0,"Drama, Sport","Under the tutelage of Rocky Balboa, newly crowned heavyweight champion Adonis Creed faces off against Viktor Drago, the son of Ivan Drago.",66.0,Steven Caple Jr.,Creed II,2018,130,USA, 50000000,115715889,214115889,98400000,164115889,1
76484,33.0,"Drama, Romance, Thriller","A faithful wife, tired of standing by her devious husband, is enraged when it becomes clear she has been betrayed.",32.0,Tyler Perry,Acrimony,2018,120,USA, 20000000,43549096,46403669,2854573,26403669,1
77452,50.0,"Biography, Drama, Family","The inspiring and unknown true story behind MercyMe's beloved, chart topping song that brings ultimate hope to so many is a gripping reminder of the power of true forgiveness.",30.0,"Andrew Erwin, Jon Erwin",I Can Only Imagine,2018,110,USA, 7000000,83482352,85978248,2495896,78978248,1
76684,218.0,"Action, Horror, Sci-Fi","America's third political party, the New Founding Fathers of America, comes to power and conducts an experiment: no laws for 12 hours on Staten Island. No one has to stay on the island, but $5,000 is given to anyone who does.",54.0,Gerard McMurray,The First Purge,2018,98,USA, 13000000,69488745,137056262,67567517,124056262,1
78402,69.0,"Drama, Fantasy, Romance",A shy teenager falls for a spirit who wakes up in the body of a different person every morning.,52.0,Michael Sucsy,Every Day,2018,97,USA, 4900000,6102076,10421847,4319771,5521847,1
77564,16.0,"Drama, War","INDIVISIBLE is the extraordinary true story of Army Chaplain Darren Turner and his wife Heather. When war etches battle scars on their hearts, they face one more battle: the fight to save their marriage. One marriage, one family, under God.",53.0,David G. Evans,Indivisible,2018,119,USA, 2700000,3511417,3589633,78216,889633,1
76830,122.0,"Animation, Adventure, Comedy","A Yeti is convinced that the elusive creatures known as ""humans"" really do exist.",60.0,"Karey Kirkpatrick, Jason Reisig",Smallfoot,2018,96,USA, 80000000,83240103,214040103,130800000,134040103,1
78378,221.0,"Comedy, Drama",An introverted teenage girl tries to survive the last week of her disastrous eighth grade year before leaving to start high school.,89.0,Bo Burnham,Eighth Grade,2018,93,USA, 2000000,13539709,14347433,807724,12347433,1
78299,379.0,"Biography, Comedy, Drama",A working-class Italian-American bouncer becomes the driver of an African-American classical pianist on a tour of venues through the 1960s American South.,69.0,Peter Farrelly,Green Book,2018,130,USA, 23000000,85080171,321752656,236672485,298752656,1
78550,264.0,"Drama, Romance",A young woman embraces her pregnancy while she and her family set out to prove her childhood friend and lover innocent of a crime he didn't commit.,87.0,Barry Jenkins,If Beale Street Could Talk,2018,119,USA, 12000000,14915773,20572691,5656918,8572691,1
78578,211.0,"Action, Crime, Drama",A police detective reconnects with people from an undercover assignment in her distant past in order to make peace.,62.0,Karyn Kusama,Destroyer,2018,121,USA, 9000000,1533324,5580940,4047616,-3419060,0
76892,125.0,"Action, Comedy, Crime","After a malicious data hack exposes the secrets of the perpetually American town of Salem, chaos descents and four girls must fight to survive, while coping with the hack themselves.",56.0,Sam Levinson,Assassination Nation,2018,108,USA, 7000000,2005142,2584988,579846,-4415012,0
75917,268.0,"Animation, Adventure, Comedy","Six years after the events of ""Wreck-It Ralph,"" Ralph and Vanellope, now friends, discover a wi-fi router in their arcade, leading them into a new adventure.",71.0,"Phil Johnston, Rich Moore",Ralph Breaks the Internet,2018,112,USA, 175000000,201091711,529323962,328232251,354323962,1
78599,258.0,"Drama, Horror, Mystery","A young woman is involuntarily committed to a mental institution, where she is confronted by her greatest fear--but is it real or a product of her delusion?",63.0,Steven Soderbergh,Unsane,2018,98,USA, 1500000,7732899,14293601,6560702,12793601,1
78113,140.0,"Comedy, Drama, Romance",Four lifelong friends have their lives forever changed after reading 50 Shades of Grey in their monthly book club.,53.0,Bill Holderman,Book Club,2018,104,USA, 10000000,68566296,104438188,35871892,94438188,1
77440,52.0,"Biography, Drama, Music","A reimagining of the life and times of Blaze Foley, the unsung songwriting legend of the Texas Outlaw Music movement.",75.0,Ethan Hawke,Blaze,2018,129,USA, 1200000,704955,704955,0,-495045,0
75820,257.0,"Horror, Mystery, Thriller",A priest with a haunted past and a novice on the threshold of her final vows are sent by the Vatican to investigate the death of a young nun in Romania and confront a malevolent force in the form of a demonic nun.,46.0,Corin Hardy,The Nun,2018,96,USA, 22000000,117450119,365550119,248100000,343550119,1
78958,423.0,"Biography, Crime, Drama","Ron Stallworth, an African American police officer from Colorado Springs, CO, successfully manages to infiltrate the local Ku Klux Klan branch with the help of a Jewish surrogate who eventually becomes its leader. Based on actual events.",83.0,Spike Lee,BlacKkKlansman,2018,135,USA, 15000000,49275340,93400823,44125483,78400823,1
77766,292.0,"Crime, Drama, Mystery","Early 1970s. Four strangers check in at the El Royale Hotel. The hotel is deserted, staffed by a single desk clerk. Some of the new guests' reasons for being there are less than innocent and some are not who they appear to be.",60.0,Drew Goddard,Bad Times at the El Royale,2018,141,USA, 32000000,17839115,31882724,14043609,-117276,0
79610,450.0,"Drama, Horror, Mystery",A grieving family is haunted by tragic and disturbing occurrences.,87.0,Ari Aster,Hereditary,2018,127,USA, 10000000,44069456,79336821,35267365,69336821,1
79827,235.0,"Crime, Drama, Thriller",A ninety-year-old horticulturist and Korean War veteran turns drug mule for a Mexican cartel.,58.0,Clint Eastwood,The Mule,2018,116,USA, 50000000,103804407,174504407,70700000,124504407,1
78939,20.0,"Biography, Drama, History","The next amazing chapter of Olympian and World War II hero Louis Zamperini's powerful true story of forgiveness, redemption, and amazing grace.",39.0,Harold Cronk,Unbroken: Path to Redemption,2018,98,USA, 6000000,6216897,6216897,0,216897,1
78927,73.0,"Comedy, Sport",An anti-ageist comedy about a man's dream to win the Rucker Classic street ball tournament in Harlem.,57.0,Charles Stone III,Uncle Drew,2018,103,USA, 19000000,42469946,46664414,4194468,27664414,1
78695,49.0,"Comedy, Horror","Fans flock to a festival celebrating the most iconic horror movies, only to discover that the charismatic showman behind the event has a diabolical agenda.",54.0,Owen Egerton,Blood Fest,2018,92,USA, 1200000,82774,122833,40059,-1077167,0
78011,165.0,"Biography, Drama, Thriller",Americans discover a terrorist plot on a Paris-bound train.,45.0,Clint Eastwood,The 15:17 to Paris,2018,94,USA, 30000000,36276286,57076286,20800000,27076286,1
75503,168.0,"Comedy, Crime, Drama","Sam, a disenchanted young man, finds a mysterious woman swimming in his apartment's pool one night. The next morning, she disappears. Sam sets off across LA to find her, and along the way he uncovers a conspiracy far more bizarre.",60.0,David Robert Mitchell,Under the Silver Lake,2018,139,USA, 8500000,46083,2053469,2007386,-6446531,0
75560,25.0,"Action, Adventure, Family","A.X.L. is a top-secret, robotic dog who develops a special friendship with Miles and will go to any length to protect his new companion.",29.0,Oliver Daly,A-X-L,2018,98,USA, 10000000,6501381,8467697,1966316,-1532303,0
80013,36.0,"Comedy, Drama, Romance",A woman is released from prison and reunites with her sister. She soon discovers that her sister is in an online relationship with a man who may not be what he seems.,39.0,Tyler Perry,Nobody's Fool,2018,110,USA, 19000000,31713110,33532593,1819483,14532593,1
75623,113.0,"Horror, Mystery, Thriller","When a cop who is just out of rehab takes the graveyard shift in a city hospital morgue, she faces a series of bizarre, violent events caused by an evil entity in one of the corpses.",37.0,Diederik Van Rooijen,The Possession of Hannah Grace,2018,86,USA, 7700000,14837422,43016528,28179106,35316528,1
77079,310.0,"Biography, Comedy, Drama",The story of,61.0,Adam McKay,Vice,2018,132,USA, 60000000,47836282,76073488,28237206,16073488,1
75496,128.0,"Horror, Mystery, Thriller","In a small town in Massachusetts, a group of friends, fascinated by the internet lore of the Slender Man, attempt to prove that he doesn't actually exist - until one of them mysteriously goes missing.",30.0,Sylvain White,Slender Man,2018,93,USA, 10000000,30569484,51738549,21169065,41738549,1
66444,188.0,Comedy,"A small group of former classmates organize an elaborate, annual game of tag that requires some to travel all over the country.",56.0,Jeff Tomsic,Tag,2018,100,USA, 28000000,54730625,78130625,23400000,50130625,1
56717,458.0,"Drama, Music, Romance",A musician helps a young singer find fame as age and alcoholism send his own career into a downward spiral.,88.0,Bradley Cooper,A Star Is Born,2018,136,USA, 36000000,215288866,434888866,219600000,398888866,1
71242,591.0,"Action, Adventure, Sci-Fi",The Avengers and their allies must be willing to sacrifice all in an attempt to defeat the powerful Thanos before his blitz of devastation and ruin puts an end to the universe.,68.0,"Anthony Russo, Joe Russo",Avengers: Infinity War,2018,149,USA, 321000000,678815482,2048359754,1369544272,1727359754,1
71094,37.0,"Drama, Music, Romance",After being gone for a decade a country star returns home to the love he left behind.,36.0,Bethany Ashton Wolf,Forever My Girl,2018,108,USA, 3500000,16376066,16376066,0,12876066,1
70998,135.0,"Action, Adventure, Drama","Imprisoned by an adult world that now fears everyone under 18, a group of teens form a resistance group to fight back and reclaim control of their future.",39.0,Jennifer Yuh Nelson,The Darkest Minds,2018,104,USA, 34000000,12695691,41142379,28446688,7142379,1
55646,167.0,"Action, Drama, History","12 Strong tells the story of the first Special Forces team deployed to Afghanistan after 9/11; under the leadership of a new captain, the team must work with an Afghan warlord to take down the Taliban.",54.0,Nicolai Fuglsig,12 Strong,2018,130,USA, 35000000,45819713,67450815,21631102,32450815,1
70654,7.0,"Adventure, Drama","When a recent widower consumed with regret seeks absolution in riding his motorcycle cross-country to confront the mistakes of his past, he unexpectedly discovers that life is about moving forward, one mile at a time.",24.0,Carmine Cangialosi,American Dresser,2018,97,USA, 2000000,3895,3895,0,-1996105,0
70577,40.0,"Biography, Drama, Sport","A football player's dreams to play in the NFL are halted when he is wrongly convicted and sent to prison. Years later, he fights to clear his name within an unjust system.",58.0,Tom Shadyac,Brian Banks,2018,99,USA, 10000000,4376819,4376819,0,-5623181,0
70054,529.0,"Action, Adventure, Sci-Fi","During an adventure into the criminal underworld, Han Solo meets his future co-pilot Chewbacca and encounters Lando Calrissian years before joining the Rebellion.",62.0,Ron Howard,Solo: A Star Wars Story,2018,135,USA, 275000000,213767512,392924807,179157295,117924807,1
70011,224.0,"Action, Crime, Thriller","Robert McCall serves an unflinching justice for the exploited and oppressed, but how far will he go when that is someone he loves?",50.0,Antoine Fuqua,The Equalizer 2,2018,121,USA, 62000000,102084362,190400157,88315795,128400157,1
69387,385.0,"Animation, Action, Adventure","The Incredibles hero family takes on a new mission, which involves a change in family roles: Bob Parr (Mr Incredible) must manage the house while his wife Helen (Elastigirl) goes out to save the world.",80.0,Brad Bird,Incredibles 2,2018,118,USA, 200000000,608581744,1242805359,634223615,1042805359,1
71509,145.0,"Adventure, Drama, Family","In the prehistoric past, a young man struggles to return home after being separated from his tribe during a buffalo hunt. He finds a similarly lost wolf companion and starts a friendship that would change humanity.",63.0,Albert Hughes,Alpha,2018,96,USA, 51000000,35857181,98203196,62346015,47203196,1
74720,107.0,"Action, Adventure, Crime",Thieves attempt a massive heist against the U.S. Treasury as a Category 5 hurricane approaches one of its Mint facilities.,35.0,Rob Cohen,The Hurricane Heist,2018,103,USA, 35000000,6115825,32517248,26401423,-2482752,0
67394,239.0,"Comedy, Drama, Romance","This contemporary romantic comedy, based on a global bestseller, follows native New Yorker Rachel Chu to Singapore to meet her boyfriend's family.",74.0,Jon M. Chu,Crazy Rich Asians,2018,120,USA, 30000000,174532921,238532921,64000000,208532921,1
66502,344.0,"Action, Drama, Thriller","Ballerina Dominika Egorova is recruited to 'Sparrow School,' a Russian intelligence service where she is forced to use her body as a weapon. Her first mission, targeting a C.I.A. agent, threatens to unravel the security of both nations.",53.0,Francis Lawrence,Red Sparrow,2018,140,USA, 69000000,46874505,151572634,104698129,82572634,1
61459,118.0,Horror,"A masked serial killer turns a horror-themed amusement park into his own personal playground, terrorizing a group of friends while the rest of the patrons believe that it is all part of the show.",26.0,Gregory Plotkin,Hell Fest,2018,89,USA, 5500000,11107431,18159691,7052260,12659691,1
53523,213.0,"Biography, Drama","Based on the best-selling pair of memoirs from father and son David and Nic Sheff, Beautiful Boy chronicles the heartbreaking and inspiring experience of survival, relapse, and recovery in a family coping with addiction over many years.",62.0,Felix van Groeningen,Beautiful Boy,2018,120,USA, 25000000,7649973,16540848,8890875,-8459152,0
65962,291.0,"Action, Comedy, Crime",A group of friends who meet regularly for game nights find themselves entangled in a real-life mystery when the shady brother of one of them is seemingly kidnapped by dangerous gangsters.,66.0,"John Francis Daley, Jonathan Goldstein",Game Night,2018,100,USA, 37000000,69179066,117679066,48500000,80679066,1
65289,187.0,Comedy,Three parents try to stop their daughters from losing their virginity on prom night.,69.0,Kay Cannon,Blockers,2018,102,USA, 21000000,60311495,94017294,33705799,73017294,1
49520,91.0,"Comedy, Crime, Mystery","When a border dispute arises between the U.S. and Canada, the Super Troopers are tasked with establishing a Highway Patrol station in the disputed area.",41.0,Jay Chandrasekhar,Super Troopers 2,2018,99,USA, 13500000,30617396,31626386,1008990,18126386,1
62459,94.0,"Comedy, Drama, Romance",A big box store worker reinvents her life and her life-story and shows Madison Avenue what street smarts can do.,46.0,Peter Segal,Second Act,2018,103,USA, 16000000,39282227,72282227,33000000,56282227,1
53956,176.0,"Action, Crime, Drama",An elite unit of the LA County Sheriff's Dept. and the state's most successful bank robbery crew clash as the outlaws plan a seemingly impossible heist on the Federal Reserve Bank.,49.0,Christian Gudegast,Den of Thieves,2018,140,USA, 30000000,44947622,80509622,35562000,50509622,1
72129,178.0,"Drama, Romance, Thriller","Anastasia and Christian get married, but Jack Hyde continues to threaten their relationship.",31.0,James Foley,Fifty Shades Freed,2018,105,USA, 55000000,100407760,371985018,271577258,316985018,1
56532,471.0,"Horror, Thriller","Laurie Strode confronts her long-time foe Michael Myers, the masked figure who has haunted her since she narrowly escaped his killing spree on Halloween night four decades ago.",67.0,David Gordon Green,Halloween,2018,106,USA, 10000000,159342015,255485178,96143163,245485178,1
73056,86.0,"Drama, Romance",A 17-year-old girl suffers from a condition that prevents her from being out in the sunlight.,38.0,Scott Speer,Midnight Sun,2018,91,USA, 2800000,9561064,27365467,17804403,24565467,1
74273,44.0,"Action, Drama","Right after winning a fight in Las Vegas, Kurt Sloane is sedated and taken to a prison in Bangkok, where he's forced to fight a 6'10"" giant for freedom and $1M - but this will require some intense training.",54.0,Dimitri Logothetis,Kickboxer: Retaliation,2018,110,USA, 13000000,4537,101690,97153,-12898310,0
74272,92.0,"Biography, Drama, History",A team of secret agents set out to track down the Nazi officer who masterminded the Holocaust.,58.0,Chris Weitz,Operation Finale,2018,122,USA, 24000000,17612099,17612099,0,-6387901,0
74184,40.0,"Biography, Drama, Thriller",A group of wealthy boys in Los Angeles during the early 1980s establish a 'get-rich-quick' scam that turns deadly.,30.0,James Cox,Billionaire Boys Club,2018,108,USA, 15000000,1349,2713955,2712606,-12286045,0
74139,250.0,"Comedy, Drama, Romance","Simon Spier keeps a huge secret from his family, his friends and all of his classmates: he's gay. When that secret is threatened, Simon must face everyone and come to terms with his identity.",72.0,Greg Berlanti,"Love, Simon",2018,110,USA, 17000000,40826341,66316289,25489948,49316289,1
74137,342.0,"Action, Comedy, Crime",Debbie Ocean gathers an all-female crew to attempt an impossible heist at New York City's yearly Met Gala.,61.0,Gary Ross,Ocean's Eight,2018,110,USA, 70000000,140218711,297718711,157500000,227718711,1
73948,426.0,"Action, Adventure, Comedy","As Scott Lang balances being both a superhero and a father, Hope van Dyne and Dr. Hank Pym present an urgent new mission that finds the Ant-Man fighting alongside The Wasp to uncover secrets from their past.",70.0,Peyton Reed,Ant-Man and the Wasp,2018,118,USA, 162000000,216648740,622674139,406025399,460674139,1
73290,470.0,"Action, Adventure, Sci-Fi","When the island's dormant volcano begins roaring to life, Owen and Claire mount a campaign to rescue the remaining dinosaurs from this extinction-level event.",51.0,J.A. Bayona,Jurassic World: Fallen Kingdom,2018,128,USA, 170000000,417719760,1308467944,890748184,1138467944,1
57861,264.0,"Adventure, Family, Fantasy","After the disappearance of her scientist father, three peculiar beings send Meg, her brother, and her friend to space in order to find him.",53.0,Ava DuVernay,A Wrinkle in Time,2018,109,USA, 100000000,100478608,132675864,32197256,32675864,1
72180,197.0,"Action, Sci-Fi, Thriller","Young hero Thomas embarks on a mission to find a cure for a deadly disease known as ""The Flare"".",50.0,Wes Ball,Maze Runner: The Death Cure,2018,143,USA, 62000000,58032443,288175335,230142892,226175335,1
72664,174.0,"Biography, Drama",The true story of,59.0,Mimi Leder,On the Basis of Sex,2018,120,USA, 20000000,24622687,38673750,14051063,18673750,1
72549,379.0,"Animation, Action, Adventure","Teen Miles Morales becomes Spider-Man of his reality, crossing his path with five counterparts from other dimensions to stop a threat for all realities.",87.0,"Bob Persichetti, Peter Ramsey",Spider-Man: Into the Spider-Verse,2018,117,USA, 90000000,190241310,375540831,185299521,285540831,1
63230,318.0,"Action, Adventure, Sci-Fi","When three different animals become infected with a dangerous pathogen, a primatologist and a geneticist team up to stop them from destroying Chicago.",45.0,Brad Peyton,Rampage,2018,107,USA, 120000000,101028233,428028233,327000000,308028233,1
72457,232.0,"Biography, Comedy, Crime","When Lee Israel falls out of step with current tastes, she turns her art form to deception.",87.0,Marielle Heller,Can You Ever Forgive Me?,2018,106,USA, 10000000,8803865,12442161,3638296,2442161,1
57211,77.0,"Comedy, Romance","After a spoiled, wealthy yacht owner is thrown overboard and loses his memory, a mistreated employee convinces him that he is her working-class husband.",42.0,Rob Greenberg,Overboard,2018,112,USA, 12000000,50316123,91244913,40928790,79244913,1
60062,664.0,"Action, Adventure, Sci-Fi","T'Challa, heir to the hidden but advanced kingdom of Wakanda, must step forward to lead his people into a new future and must confront a challenger from his country's past.",88.0,Ryan Coogler,Black Panther,2018,134,USA, 200000000,700059566,1346913161,646853595,1146913161,1
72280,171.0,"Action, Adventure, Thriller",A war-hardened Crusader and his Moorish commander mount an audacious revolt against the corrupt English crown.,32.0,Otto Bathurst,Robin Hood,2018,116,USA, 100000000,30824628,85869850,55045222,-14130150,0
72291,120.0,"Crime, Drama","The story of teenager Richard Wershe Jr., who became an undercover informant for the FBI during the 1980s and was ultimately arrested for drug-trafficking and sentenced to life in prison.",59.0,Yann Demange,White Boy Rick,2018,111,USA, 29000000,24011188,25957482,1946294,-3042518,0
72473,49.0,"Biography, Drama, War","A major league baseball player,",49.0,Ben Lewin,The Catcher Was a Spy,2018,98,USA, 14000000,725223,953953,228730,-13046047,0
78441,22.0,Comedy,"A joyous family reunion becomes a hilarious nightmare as Madea and the crew travel to backwoods Georgia, where they find themselves unexpectedly planning a funeral that might unveil unsavory family secrets.",39.0,Tyler Perry,A Madea Family Funeral,2019,109,USA, 20000000,73257045,74747725,1490680,54747725,1
78480,48.0,"Biography, Drama","When her 14-year-old son drowns in a lake, a faithful mother prays for him to come back from the brink of death and be healed.",46.0,Roxann Dawson,Breakthrough,2019,116,USA, 14000000,40713082,50444358,9731276,36444358,1
62526,224.0,"Comedy, Romance","Journalist Fred Flarsky reunites with his childhood crush, Charlotte Field, now one of the most influential women in the world. As she prepares to make a run for the Presidency, Charlotte hires Fred as her speechwriter and sparks fly.",67.0,Jonathan Levine,Long Shot,2019,125,USA, 40000000,30316271,53410558,23094287,13410558,1
79522,159.0,"Action, Comedy, Crime",A detective recruits his Uber driver into an unexpected night of adventure.,42.0,Michael Dowse,Stuber,2019,93,USA, 16000000,22370452,32390945,10020493,16390945,1
43345,77.0,"Crime, Drama","Set against the backdrop of 1950s New York, Motherless Brooklyn follows Lionel Essrog, a lonely private detective afflicted with Tourette's Syndrome, as he ventures to solve the murder of his mentor and only friend, Frank Minna.",60.0,Edward Norton,Motherless Brooklyn,2019,144,USA, 26000000,8449596,9205026,755430,-16794974,0
80946,16.0,"Comedy, Family",A crew of rugged firefighters meet their match when attempting to rescue three rambunctious kids.,24.0,Andy Fickman,Playing with Fire,2019,96,USA, 29900000,18847824,21788746,2940922,-8111254,0
80858,32.0,"Biography, Drama","All Abby Johnson ever wanted to do was help women. As one of the youngest Planned Parenthood clinic directors in the nation, she believed in a woman's right to choose. Until the day she saw something that changed everything.",10.0,"Chuck Konzelman, Cary Solomon",Unplanned,2019,109,USA, 6000000,19005109,19320481,315372,13320481,1
80277,211.0,"Horror, Mystery, Thriller","While babysitting the daughter of Ed and Lorraine Warren, a teenager and her friend unknowingly awaken an evil spirit trapped in a doll.",53.0,Gary Dauberman,Annabelle Comes Home,2019,106,USA, 27000000,74152591,228552591,154400000,201552591,1
80111,17.0,"Drama, Sport",A high-school basketball coach volunteers to coach a troubled teen in long-distance running.,17.0,Alex Kendrick,Overcomer,2019,119,USA, 5000000,34712782,35721533,1008751,30721533,1
80059,87.0,Horror,Sequel to The Devil's Rejects.,50.0,Rob Zombie,3 from Hell,2019,115,USA, 3000000,2172949,2279214,106265,-720786,0
78949,160.0,"Adventure, Comedy","Three 6th grade boys ditch school and embark on an epic journey while carrying accidentally stolen drugs, being hunted by teenage girls, and trying to make their way home in time for a long-awaited party.",60.0,Gene Stupnitsky,Good Boys,2019,90,USA, 20000000,83083070,110883070,27800000,90883070,1
56430,235.0,Comedy,"On the eve of their high school graduation, two academic superstars and best friends realize they should have worked less and played more. Determined not to fall short of their peers, the girls try to cram four years of fun into one night.",84.0,Olivia Wilde,Booksmart,2019,102,USA, 6000000,22680962,24624917,1943955,18624917,1
56323,70.0,"Comedy, Drama, Romance","Through his bond with his owner, aspiring Formula One race car driver Denny, golden retriever Enzo learns that the techniques needed on the racetrack can also be used to successfully navigate the journey of life.",43.0,Simon Curtis,The Art of Racing in the Rain,2019,109,USA, 20000000,26395642,33766787,7371145,13766787,1
61299,341.0,"Animation, Adventure, Comedy","When a new toy called ""Forky"" joins Woody and the gang, a road trip alongside old and new friends reveals how big the world can be for a toy.",84.0,Josh Cooley,Toy Story 4,2019,100,USA, 200000000,433956983,1073168585,639211602,873168585,1
79017,53.0,"Action, Crime, Drama",A rookie New Orleans police officer is forced to balance her identity as a black woman after she witnesses two corrupt cops committing murder.,53.0,Deon Taylor,Black and Blue,2019,108,USA, 12000000,20073804,20472277,398473,8472277,1
79997,65.0,"Comedy, Fantasy, Romance",A woman is transformed into her younger self at a point in her life when the pressures of adulthood become too much to bear.,49.0,Tina Gordon,Little,2019,109,USA, 20000000,40673960,48800575,8126615,28800575,1
54475,127.0,"Comedy, Crime",Two con women - one low rent and the other high class - team up to take down the men who have wronged them.,35.0,Chris Addison,The Hustle,2019,93,USA, 21000000,35417038,95017038,59600000,74017038,1
79398,83.0,"Comedy, Fantasy, Romance","A woman is boxed out by the male sports agents in her profession, but gains an unexpected edge over them when she develops the ability to hear men's thoughts.",49.0,Adam Shankman,What Men Want,2019,117,USA, 20000000,54611903,72216294,17604391,52216294,1
79555,236.0,"Drama, Horror, Mystery","What if a child from another world crash-landed on Earth, but instead of becoming a hero to mankind, he proved to be something far more sinister?",44.0,David Yarovesky,Brightburn,2019,90,USA, 6000000,17300439,32893421,15592982,26893421,1
77405,63.0,"Drama, Romance",A hopeless romantic ambivalent about his future in medical school falls for a hard-luck young woman who doesn't believe in love.,52.0,Ry Russo-Young,The Sun Is Also a Star,2019,100,USA, 9000000,4950029,6650029,1700000,-2349971,0
63629,248.0,"Action, Adventure, Comedy","The Men in Black have always protected the Earth from the scum of the universe. In this new adventure, they tackle their biggest threat to date: a mole in the Men in Black organization.",38.0,F. Gary Gray,Men in Black: International,2019,114,USA, 110000000,80001807,253890701,173888894,143890701,1
75002,194.0,"Comedy, Crime, Drama","Inspired by the viral New York Magazine article, Hustlers follows a crew of savvy former strip club employees who band together to turn the tables on their Wall Street clients.",79.0,Lorene Scafaria,Hustlers,2019,110,USA, 20000000,104718230,145018230,40300000,125018230,1
73746,47.0,"Action, Adventure, Comedy","When a young systems engineer blows the whistle on a dangerous technology, Charlie's Angels are called into action, putting their lives on the line to protect us all.",51.0,Elizabeth Banks,Charlie's Angels,2019,118,USA, 48000000,3150000,3150000,0,-44850000,0
73596,34.0,"Biography, Drama, Western",The story of a young boy who witnesses Billy the Kid's encounter with Sheriff Pat Garrett.,51.0,Vincent D'Onofrio,The Kid,2019,100,USA, 8000000,1508593,1567501,58908,-6432499,0
73376,204.0,"Horror, Mystery, Thriller","Ignoring the eerie warning of a troubled mother suspected of child endangerment, a social worker and her own small kids are soon drawn into a frightening supernatural realm.",41.0,Michael Chaves,The Curse of La Llorona,2019,93,USA, 9000000,54733739,122133739,67400000,113133739,1
73075,58.0,"Biography, Drama, History","Civil rights activist Ann Atwater faces off against C.P. Ellis, Exalted Cyclops of the Ku Klux Klan, in 1971 Durham, North Carolina over the issue of school integration.",49.0,Robin Bissell,The Best of Enemies,2019,133,USA, 10000000,10205616,10209813,4197,209813,1
72597,68.0,"Action, Biography, Drama","The extraordinary tale of Harriet Tubman's escape from slavery and transformation into one of America's greatest heroes, whose courage, ingenuity, and tenacity freed hundreds of slaves and changed the course of history.",66.0,Kasi Lemmons,Harriet,2019,125,USA, 17000000,28352990,28352990,0,11352990,1
72355,12.0,"Action, Crime, Drama",Follows one memorable night in the life of LAPD officer Ray Mandel while hunting two cop killers on the loose.,45.0,Joel Souza,Crown Vic,2019,110,USA, 3600000,3868,3868,0,-3596132,0
75848,115.0,"Action, Crime, Drama",The wives of New York gangsters in Hell's Kitchen in the 1970s continue to operate their husbands' rackets after they're locked up in prison.,35.0,Andrea Berloff,The Kitchen,2019,102,USA, 38000000,12180032,15880032,3700000,-22119968,0
72076,109.0,"Action, Comedy, Crime","JJ Shaft, a cyber security expert with a degree from MIT, enlists his family's help to uncover the truth behind his best friend's untimely death.",40.0,Tim Story,Shaft,2019,111,USA, 30000000,21360215,21360215,0,-8639785,0
76231,89.0,"Drama, Sci-Fi, Thriller","Set in a Chicago neighborhood nearly a decade after an occupation by an extraterrestrial force, 'Captive State' explores the lives on both sides of the conflict - the collaborators and dissidents.",54.0,Rupert Wyatt,Captive State,2019,109,USA, 25000000,5958315,8765016,2806701,-16234984,0
71243,531.0,"Action, Adventure, Drama",After the devastating events of,78.0,"Anthony Russo, Joe Russo",Avengers: Endgame,2019,181,USA, 356000000,858373000,2797800564,1939427564,2441800564,1
76606,339.0,"Animation, Adventure, Drama","After the murder of his father, a young lion prince flees his kingdom only to learn the true meaning of responsibility and bravery.",55.0,Jon Favreau,The Lion King,2019,118,USA, 260000000,543496835,1655156910,1111660075,1395156910,1
76615,165.0,"Comedy, Drama",A late night talk show host suspects that she may soon lose her long-running show.,70.0,Nisha Ganatra,Late Night,2019,102,USA, 4000000,15499454,22367121,6867667,18367121,1
71170,68.0,"Drama, Romance",A young woman falls for a guy with a dark secret and the two embark on a rocky relationship. Based on the novel by Anna Todd.,30.0,Jenny Gage,After,2019,105,USA, 14000000,12138565,69497587,57359022,55497587,1
45409,337.0,"Action, Adventure, Sci-Fi","A deactivated cyborg is revived, but cannot remember anything of her past life and goes on a quest to find out who she is.",53.0,Robert Rodriguez,Alita: Battle Angel,2019,122,USA, 170000000,85710210,404852543,319142333,234852543,1
76707,322.0,"Adventure, Family, Fantasy",A kind-hearted street urchin and a power-hungry Grand Vizier vie for a magic lamp that has the power to make their deepest wishes come true.,53.0,Guy Ritchie,Aladdin,2019,128,USA, 183000000,355559216,1050693953,695134737,867693953,1
76848,157.0,"Action, Thriller",Mike Banning is framed for the attempted assassination of the President and must evade his own agency and the FBI as he tries to uncover the real threat.,45.0,Ric Roman Waugh,Angel Has Fallen,2019,121,USA, 40000000,69030436,133365452,64335016,93365452,1
70375,118.0,Drama,A boy in New York is taken in by a wealthy Upper East Side family after his mother is killed in a bombing at the Metropolitan Museum of Art.,40.0,John Crowley,The Goldfinch,2019,149,USA, 45000000,5332621,9732621,4400000,-35267379,0
77213,385.0,"Action, Adventure, Sci-Fi",Following the events of,69.0,Jon Watts,Spider-Man: Far from Home,2019,129,USA, 160000000,390532085,1131845802,741313717,971845802,1
77268,130.0,"Animation, Adventure, Comedy","Mr. Link recruits explorer Sir Lionel Frost to help find his long-lost relatives in the fabled valley of Shangri-La. Along with adventurer Adelina Fortnight, this trio of explorers travel the world to help their new friend.",68.0,Chris Butler,Missing Link,2019,93,USA, 100000000,16649539,26249469,9599930,-73750531,0
68429,152.0,"Biography, Drama, War",The formative years of the orphaned author,48.0,Dome Karukoski,Tolkien,2019,112,USA, 20000000,4535154,7776413,3241259,-12223587,0
77499,111.0,"Drama, Romance","A pair of teenagers with cystic fibrosis meet in a hospital and fall in love, though their disease means they must avoid close physical contact.",53.0,Justin Baldoni,Five Feet Apart,2019,116,USA, 7000000,45729221,91528689,45799468,84528689,1
64967,124.0,"Comedy, Fantasy, Romance",A young woman disenchanted with love mysteriously finds herself trapped inside a romantic comedy.,60.0,Todd Strauss-Schulson,Isn't It Romantic,2019,89,USA, 31000000,48791187,48791187,0,17791187,1
64306,83.0,"Comedy, Drama, Mystery",A loving mom becomes compelled to reconnect with her creative passions after years of sacrificing herself for her family. Her leap of faith takes her on an epic adventure that jump-starts her life and leads to her triumphant rediscovery.,51.0,Richard Linklater,"Where'd You Go, Bernadette",2019,109,USA, 20000000,9198356,10073314,874958,-9926686,0
50925,50.0,"Horror, Thriller","When a nurse downloads an app that claims to predict the moment a person will die, it tells her she only has three days to live. With the clock ticking and a figure haunting her, she must find a way to save her life before time runs out.",31.0,Justin Dec,Countdown,2019,90,USA, 6500000,23470249,28890249,5420000,22390249,1
78017,40.0,"Drama, Horror, Mystery","After a man's family dies in what appears to be a murder, he gets a phone call from one of the dead, his niece. He's not sure if she's a ghost or if he's going mad, but as it turns out, he's not.",49.0,Jacob Estes,Don't Let Go,2019,103,USA, 5000000,5215062,5288011,72949,288011,1
78025,279.0,"Action, Adventure",Lawman Luke Hobbs and outcast Deckard Shaw form an unlikely alliance when a cyber-genetically enhanced villain threatens the future of humanity.,60.0,David Leitch,Fast & Furious Presents: Hobbs & Shaw,2019,137,USA, 200000000,173810100,758910100,585100000,558910100,1
78112,491.0,"Horror, Mystery, Thriller",A family's serene beach vacation turns to chaos when their doppelg√§ngers appear and begin to terrorize them.,81.0,Jordan Peele,Us,2019,116,USA, 20000000,175005930,255105930,80100000,235105930,1
76726,346.0,"Action, Crime, Thriller","John Wick is on the run after killing a member of the international assassin's guild, and with a $14 million price tag on his head, he is the target of hit men and women everywhere.",73.0,Chad Stahelski,John Wick: Chapter 3 - Parabellum,2019,131,USA, 75000000,171015687,326667460,155651773,251667460,1
81059,24.0,Comedy,A comedy about what can happen when you love your phone more than anything else in your life.,39.0,"Jon Lucas, Scott Moore",Jexi,2019,84,USA, 5000000,6546159,7257918,711759,2257918,1
